Athlete,Country,Gold,Silver,Bronze,Total,year
Michael Phelps,United States,23,3,2,28,1896 - 2016
Larisa Latynina,Soviet Union,9,5,4,18,1896 - 2016
Larisa Latynina,Ukraine,9,5,4,18,1896 - 2016
Nikolay Andrianov,Soviet Union,7,5,3,15,1896 - 2016
Nikolay Andrianov,Russian Federation,7,5,3,15,1896 - 2016
Takashi Ono,Japan,5,4,4,13,1896 - 2016
Boris Shakhlin,Ukraine,7,4,2,13,1896 - 2016
Edoardo Mangiarotti,Italy,6,5,2,13,1896 - 2016
Boris Shakhlin,Soviet Union,7,4,2,13,1896 - 2016
Isabell Werth,Germany,7,5,0,12,1896 - 2016
Aleksey Nemov,Russian Federation,4,2,6,12,1896 - 2016
Leonidas,Rhodes,12,0,0,12,1896 - 2016
Dara Torres,United States,4,4,4,12,1896 - 2016
Natalie Coughlin,United States,3,4,5,12,1896 - 2016
Birgit Fischer-Schmidt,Germany,8,4,0,12,1896 - 2016
Ryan Lochte,United States,6,3,3,12,1896 - 2016
Birgit Fischer-Schmidt,East Germany,8,4,0,12,1896 - 2016
Sawao Kato,Japan,8,3,1,12,1896 - 2016
Jenny Thompson,United States,8,3,1,12,1896 - 2016
Paavo Nurmi,Finland,9,3,0,12,1896 - 2016
Herodoros,Megara,11,0,0,11,1896 - 2016
Mark Spitz,United States,9,1,1,11,1896 - 2016
Emma McKeon,Australia,3,4,4,11,1896 - 2016
Věra Čáslavská,Czech Republic,7,4,0,11,1896 - 2016
Matt Biondi,United States,8,2,1,11,1896 - 2016
Věra Čáslavská,Czechoslovakia,7,4,0,11,1896 - 2016
Viktor Chukarin,Ukraine,7,3,1,11,1896 - 2016
Carl Osburn,United States,5,4,2,11,1896 - 2016
Viktor Chukarin,Soviet Union,7,3,1,11,1896 - 2016
Vitali Shcherba,Unified Team,6,0,4,10,1896 - 2016
Akinori Nakayama,Japan,6,2,2,10,1896 - 2016
Hubert Van Innis,Belgium,6,4,0,10,1896 - 2016
Aleksandr Dityatin,Russian Federation,3,6,1,10,1896 - 2016
Ágnes Keleti,Hungary,5,3,2,10,1896 - 2016
Polina Astakhova,Ukraine,5,2,3,10,1896 - 2016
"Gary Hall, Jr.",United States,5,3,2,10,1896 - 2016
Vitali Shcherba,Belarus,6,0,4,10,1896 - 2016
Aladár Gerevich,Hungary,7,1,2,10,1896 - 2016
Carl Lewis,United States,9,1,0,10,1896 - 2016
Polina Astakhova,Soviet Union,5,2,3,10,1896 - 2016
Aleksandr Dityatin,Soviet Union,3,6,1,10,1896 - 2016
Ray Ewry,United States,10,0,0,10,1896 - 2016
Lyudmila Turishcheva,Russian Federation,4,3,2,9,1896 - 2016
Aleksandr Popov,Unified Team,4,5,0,9,1896 - 2016
Heikki Savolainen,Finland,2,1,6,9,1896 - 2016
Mitsuo Tsukahara,Japan,5,1,3,9,1896 - 2016
Aleksandr Popov,Russian Federation,4,5,0,9,1896 - 2016
Martin Sheridan,United States,5,3,1,9,1896 - 2016
Lyudmila Turishcheva,Soviet Union,4,3,2,9,1896 - 2016
Eizo Kenmotsu,Japan,3,3,3,9,1896 - 2016
Alf Swahn,Sweden,3,3,3,9,1896 - 2016
Ian Thorpe,Australia,5,3,1,9,1896 - 2016
Mikhail Voronin,Russian Federation,2,6,1,9,1896 - 2016
Nadia Comăneci,Romania,5,3,1,9,1896 - 2016
Chad le Clos,South Africa,2,6,1,9,1896 - 2016
Mikhail Voronin,Soviet Union,2,6,1,9,1896 - 2016
Allyson Felix,United States,6,3,0,9,1896 - 2016
Valentina Vezzali,Italy,6,1,2,9,1896 - 2016
Anky van Grunsven,Netherlands,3,5,1,9,1896 - 2016
Zoltán Halmay,Hungary,3,5,1,9,1896 - 2016
Giulio Gaudini,Italy,3,4,2,9,1896 - 2016
Leisel Jones,Australia,3,5,1,9,1896 - 2016
Allison Schmitt,United States,4,2,3,9,1896 - 2016
Dawn Fraser,Australia,4,4,0,8,1896 - 2016
Petria Thomas,Australia,3,4,1,8,1896 - 2016
Dmitry Sautin,Unified Team,2,2,4,8,1896 - 2016
Henry Taylor,Great Britain,4,1,3,8,1896 - 2016
Giovanna Trillini,Italy,4,1,3,8,1896 - 2016
Sofya Muratova,Soviet Union,2,2,4,8,1896 - 2016
Otto Olsen,Norway,4,3,1,8,1896 - 2016
Philippe Cattiau,France,3,4,1,8,1896 - 2016
Vilhelm Carlberg,Sweden,3,4,1,8,1896 - 2016
Jason Lezak,United States,4,2,2,8,1896 - 2016
Roger Ducret,France,3,4,1,8,1896 - 2016
Kornelia Ender,East Germany,4,4,0,8,1896 - 2016
Roland Matthes,East Germany,4,2,2,8,1896 - 2016
Georges Miez,Switzerland,4,3,1,8,1896 - 2016
Katalin Kovács,Hungary,3,5,0,8,1896 - 2016
Inge de Bruijn,Netherlands,4,2,2,8,1896 - 2016
Veronica Campbell-Brown,Jamaica,3,3,2,8,1896 - 2016
Charlie Daniels,United States,5,1,2,8,1896 - 2016
Susie O'Neill,Australia,2,4,2,8,1896 - 2016
Margit Korondi,Hungary,2,2,4,8,1896 - 2016
Dmitry Sautin,Russian Federation,2,2,4,8,1896 - 2016
Shirley Babashoff,United States,2,6,0,8,1896 - 2016
Reiner Klimke,Germany,6,0,2,8,1896 - 2016
Ville Ritola,Finland,5,3,0,8,1896 - 2016
Elisabeta Oleniuc-Lipă,Romania,5,2,1,8,1896 - 2016
Eugen Mack,Switzerland,2,4,2,8,1896 - 2016
Bradley Wiggins,Great Britain,5,1,2,8,1896 - 2016
Nathan Adrian,United States,5,1,2,8,1896 - 2016
Sofya Muratova,Russian Federation,2,2,4,8,1896 - 2016
Gert Fredriksson,Sweden,6,1,1,8,1896 - 2016
Reiner Klimke,West Germany,6,0,2,8,1896 - 2016
Titus Flavius Hermogenes,Xanthos,8,0,0,8,1896 - 2016
Usain Bolt,Jamaica,8,0,0,8,1896 - 2016
Svetlana Khorkina,Russian Federation,2,4,1,7,1896 - 2016
Albert Helgerud,Norway,2,4,1,7,1896 - 2016
Amanda Beard,United States,2,4,1,7,1896 - 2016
Mariya Gorokhovskaya,Soviet Union,2,5,0,7,1896 - 2016
Mariya Gorokhovskaya,Ukraine,2,5,0,7,1896 - 2016
Kirsty Coventry,Zimbabwe,2,4,1,7,1896 - 2016
Ildikó Rejtő-Ujlaky-Sági,Hungary,2,3,2,7,1896 - 2016
Gustavo Marzi,Italy,2,5,0,7,1896 - 2016
Shirley Strickland de la Hunty,Australia,3,1,3,7,1896 - 2016
Pavel Lednyov,Russian Federation,2,2,3,7,1896 - 2016
Shannon Miller,United States,2,2,3,7,1896 - 2016
Simona Amânar,Romania,3,1,3,7,1896 - 2016
Léon Moreaux,France,2,2,3,7,1896 - 2016
Aliya Mustafina,Russian Federation,2,2,3,7,1896 - 2016
Eric Lemming,Sweden,4,0,3,7,1896 - 2016
Astylos,Siracusa,7,0,0,7,1896 - 2016
Kliment Kolesnikov,Russian Olympic Committee,6,1,0,7,1896 - 2016
Andrey Minakov,Russian Olympic Committee,6,1,0,7,1896 - 2016
Kohei Uchimura,Japan,3,4,0,7,1896 - 2016
Hans Günter Winkler,West Germany,5,1,1,7,1896 - 2016
Nikita Nagorny,Russian Olympic Committee,4,2,1,7,1896 - 2016
Grant Hackett,Australia,3,3,1,7,1896 - 2016
Agneta Andersson,Sweden,3,2,2,7,1896 - 2016
Pieter van den Hoogenband,Netherlands,3,2,2,7,1896 - 2016
Irena Kirszenstein-Szewińska,Poland,3,2,2,7,1896 - 2016
Pavel Lednyov,Soviet Union,2,2,3,7,1896 - 2016
Karin Janz,East Germany,2,3,2,7,1896 - 2016
Yukio Endo,Japan,5,2,0,7,1896 - 2016
Ivan Patzaichin,Romania,4,3,0,7,1896 - 2016
Takeru Kitazono,Japan,5,2,0,7,1896 - 2016
Aaron Peirsol,United States,5,2,0,7,1896 - 2016
Kosuke Kitajima,Japan,4,1,2,7,1896 - 2016
Lloyd Spooner,United States,4,1,2,7,1896 - 2016
Libby Lenton-Trickett,Australia,4,1,2,7,1896 - 2016
Hans Günter Winkler,Germany,5,1,1,7,1896 - 2016
Willis Lee,United States,5,1,1,7,1896 - 2016
Krisztina Egerszegi,Hungary,5,1,1,7,1896 - 2016
Tom Jager,United States,5,1,1,7,1896 - 2016
Dana Vollmer,United States,5,1,1,7,1896 - 2016
Wu Minxia,People's Republic of China,5,1,1,7,1896 - 2016
Nikita Nagorny,Russian Federation,4,2,1,7,1896 - 2016
Einar Liberg,Norway,4,2,1,7,1896 - 2016
Kliment Kolesnikov,Russian Federation,6,1,0,7,1896 - 2016
Astylos,Kroton,7,0,0,7,1896 - 2016
Milon,Kroton,7,0,0,7,1896 - 2016
Nikokles,Lakonia (Akrion),7,0,0,7,1896 - 2016
"Nero, Emperor of Roma",Roma,7,0,0,7,1896 - 2016
Tang Yi,People's Republic of China,6,0,1,7,1896 - 2016
Pál Kovács,Hungary,6,0,1,7,1896 - 2016
Andrey Minakov,Russian Federation,6,1,0,7,1896 - 2016
Jason Kenny,Great Britain,6,1,0,7,1896 - 2016
Chris Hoy,Great Britain,6,1,0,7,1896 - 2016
Cate Campbell,Australia,3,1,2,6,1896 - 2016
Viktor Sidyak,Soviet Union,4,1,1,6,1896 - 2016
John Jarvis,Great Britain,3,1,2,6,1896 - 2016
Jackie Joyner-Kersee,United States,3,1,2,6,1896 - 2016
Brendan Hansen,United States,3,1,2,6,1896 - 2016
Natasa Dusev-Janics,Serbia and Montenegro,3,2,1,6,1896 - 2016
Alfred Schwarzmann,West Germany,3,1,2,6,1896 - 2016
Charlotte Dujardin,Great Britain,3,1,2,6,1896 - 2016
Polina Yegorova,Russian Federation,3,1,2,6,1896 - 2016
Georgeta Damian-Andrunache,Romania,5,0,1,6,1896 - 2016
Oscar Swahn,Sweden,3,1,2,6,1896 - 2016
Vladimir Nazlymov,Soviet Union,3,2,1,6,1896 - 2016
Rita Kőbán,Hungary,2,3,1,6,1896 - 2016
Leon Štukelj,Yugoslavia,3,1,2,6,1896 - 2016
Kim Rhode,United States,3,1,2,6,1896 - 2016
Max Décugis,France,4,1,1,6,1896 - 2016
Leon Štukelj,Slovenia,3,1,2,6,1896 - 2016
Alfred Schwarzmann,Germany,3,1,2,6,1896 - 2016
Liu Lan,People's Republic of China,5,0,1,6,1896 - 2016
Knut Holmann,Norway,3,2,1,6,1896 - 2016
Vladimir Nazlymov,Russian Federation,3,2,1,6,1896 - 2016
Daniela Silivaș,Romania,3,2,1,6,1896 - 2016
Li Ning,People's Republic of China,3,2,1,6,1896 - 2016
Hermann Weingärtner,Germany,3,2,1,6,1896 - 2016
George Eyser,United States,3,2,1,6,1896 - 2016
Michael Groß,West Germany,3,2,1,6,1896 - 2016
Renate Stecher,East Germany,3,2,1,6,1896 - 2016
Ralph Rose,United States,3,2,1,6,1896 - 2016
Natasa Dusev-Janics,Hungary,3,2,1,6,1896 - 2016
Sun Yang,People's Republic of China,3,2,1,6,1896 - 2016
Viktoriya Komova,Russian Federation,3,2,1,6,1896 - 2016
Aly Raisman,United States,3,2,1,6,1896 - 2016
Madi Wilson,Australia,3,2,1,6,1896 - 2016
Missy Franklin,United States,5,0,1,6,1896 - 2016
Olga Korbut,Soviet Union,4,2,0,6,1896 - 2016
Zou Kai,People's Republic of China,5,0,1,6,1896 - 2016
Konrad Frey,Germany,3,1,2,6,1896 - 2016
Yelena Novikova-Belova,Soviet Union,4,1,1,6,1896 - 2016
Nelli Kim,Belarus,5,1,0,6,1896 - 2016
Johnny Weissmuller,United States,5,0,1,6,1896 - 2016
Wang Yifu,People's Republic of China,2,3,1,6,1896 - 2016
Hipposthenes,Sparta,6,0,0,6,1896 - 2016
Dikon,Siracusa,6,0,0,6,1896 - 2016
Shen Duo,People's Republic of China,6,0,0,6,1896 - 2016
Amy Van Dyken,United States,6,0,0,6,1896 - 2016
Kristin Otto,East Germany,6,0,0,6,1896 - 2016
Shelly-Ann Fraser-Pryce,Jamaica,2,3,1,6,1896 - 2016
Michael Klim,Australia,2,3,1,6,1896 - 2016
Hübner von Holst,Sweden,2,3,1,6,1896 - 2016
Veronica Cogeanu-Cochela,Romania,2,3,1,6,1896 - 2016
Josef Neckermann,Germany,2,2,2,6,1896 - 2016
Shuji Tsurumi,Japan,2,3,1,6,1896 - 2016
Li Xiaoshuang,People's Republic of China,2,3,1,6,1896 - 2016
Tamara Manina,Russian Federation,2,3,1,6,1896 - 2016
Géo Buchard,France,2,3,1,6,1896 - 2016
Burton Downing,United States,2,3,1,6,1896 - 2016
Nedo Nadi,Italy,6,0,0,6,1896 - 2016
Rudolf Kárpáti,Hungary,6,0,0,6,1896 - 2016
J. Michael Plumb,United States,2,4,0,6,1896 - 2016
Khionis,Sparta,6,0,0,6,1896 - 2016
Philippe Riboud,France,2,2,2,6,1896 - 2016
Al Lane,United States,5,0,1,6,1896 - 2016
Rebecca Soni,United States,3,3,0,6,1896 - 2016
Steven Redgrave,Great Britain,5,0,1,6,1896 - 2016
Nelli Kim,Soviet Union,5,1,0,6,1896 - 2016
Katie Ledecky,United States,5,1,0,6,1896 - 2016
Danuta Kozák,Hungary,5,1,0,6,1896 - 2016
Don Schollander,United States,5,1,0,6,1896 - 2016
Kim Su-Nyeong,Republic of Korea,4,1,1,6,1896 - 2016
Ole Lilloe-Olsen,Norway,5,1,0,6,1896 - 2016
Anton Heida,United States,5,1,0,6,1896 - 2016
Rüdiger Helm,East Germany,3,0,3,6,1896 - 2016
Bob Garrett,United States,2,2,2,6,1896 - 2016
Angel Martino,United States,3,0,3,6,1896 - 2016
Tirunesh Dibaba,Ethiopia,3,0,3,6,1896 - 2016
Anton Chupkov,Russian Federation,2,1,3,6,1896 - 2016
Anna Meares,Australia,2,1,3,6,1896 - 2016
Daniela Hunger,East Germany,2,1,3,6,1896 - 2016
Lavinia Miloșovici,Romania,2,1,3,6,1896 - 2016
Mark Todd,New Zealand,2,1,3,6,1896 - 2016
Yang Junxuan,People's Republic of China,2,2,2,6,1896 - 2016
Daniil Markov,Russian Federation,3,3,0,6,1896 - 2016
Louis Richardet,Switzerland,5,1,0,6,1896 - 2016
Andrea Pollack,East Germany,3,3,0,6,1896 - 2016
Giuseppe Delfino,Italy,4,2,0,6,1896 - 2016
Győző Kulcsár,Hungary,4,0,2,6,1896 - 2016
Daniela Hunger,Germany,2,1,3,6,1896 - 2016
Josef Neckermann,West Germany,2,2,2,6,1896 - 2016
Zhang Yufei,People's Republic of China,4,2,0,6,1896 - 2016
Tamara Manina,Soviet Union,2,3,1,6,1896 - 2016
Anton Chupkov,Russian Olympic Committee,2,1,3,6,1896 - 2016
Jin Jong-O,Republic of Korea,4,2,0,6,1896 - 2016
Jim Lightbody,United States,4,2,0,6,1896 - 2016
Guo Jingjing,People's Republic of China,4,2,0,6,1896 - 2016
Olga Korbut,Belarus,4,2,0,6,1896 - 2016
Matt Grevers,United States,4,2,0,6,1896 - 2016
Lucien Gaudin,France,4,2,0,6,1896 - 2016
Murray Rose,Australia,4,1,1,6,1896 - 2016
Christian d'Oriola,France,4,2,0,6,1896 - 2016
Yelena Novikova-Belova,Belarus,4,1,1,6,1896 - 2016
Viktor Sidyak,Belarus,4,1,1,6,1896 - 2016
Doina Ignat,Romania,4,1,1,6,1896 - 2016
Konrad Stäheli,Switzerland,4,1,1,6,1896 - 2016
Leontien Zijlaard-van Moorsel,Netherlands,4,1,1,6,1896 - 2016
Qiu Yuhan,People's Republic of China,4,1,1,6,1896 - 2016
Katrin Wagner-Augustin,Germany,4,1,1,6,1896 - 2016
Giorgio Zampori,Italy,4,0,1,5,1896 - 2016
Kathrin Boron,Germany,4,0,1,5,1896 - 2016
Marina Dobrancheva-Logvinenko,Russian Federation,2,1,2,5,1896 - 2016
Katsiaryna Khadatovich-Karsten,Belarus,2,1,2,5,1896 - 2016
Walter Tewksbury,United States,2,2,1,5,1896 - 2016
Koji Gushiken,Japan,2,1,2,5,1896 - 2016
Albertson Van Zo Post,United States,2,1,2,5,1896 - 2016
Mel Schlanger,Australia,2,2,1,5,1896 - 2016
Simone Manuel,United States,2,2,1,5,1896 - 2016
Jean-François Lamour,France,2,1,2,5,1896 - 2016
Stanislav Pozdnyakov,Russian Federation,4,0,1,5,1896 - 2016
Laura Flessel-Colovic,France,2,1,2,5,1896 - 2016
Torben Grael,Brazil,2,1,2,5,1896 - 2016
Sanya Richards-Ross,United States,4,0,1,5,1896 - 2016
Li Xiaopeng,People's Republic of China,4,0,1,5,1896 - 2016
Jon Olsen,United States,4,0,1,5,1896 - 2016
Viorica Susanu,Romania,4,0,1,5,1896 - 2016
Larry Nuesslein,United States,2,1,2,5,1896 - 2016
Qin Kai,People's Republic of China,2,1,2,5,1896 - 2016
Heike Drechsler,East Germany,2,1,2,5,1896 - 2016
Giarnni Regini-Moran,Great Britain,3,0,2,5,1896 - 2016
Marina Dobrancheva-Logvinenko,Unified Team,2,1,2,5,1896 - 2016
Simone Biles,United States,4,0,1,5,1896 - 2016
Jens Fiedler,Germany,3,0,2,5,1896 - 2016
Tibor Berczelly,Hungary,3,0,2,5,1896 - 2016
Paavo Aaltonen,Finland,3,0,2,5,1896 - 2016
Eskild Ebbesen,Denmark,3,0,2,5,1896 - 2016
Dennis Fenton,United States,3,0,2,5,1896 - 2016
Max Whitlock,Great Britain,2,0,3,5,1896 - 2016
Valery Borzov,Soviet Union,2,1,2,5,1896 - 2016
Hugo Johansson,Sweden,2,0,3,5,1896 - 2016
Mariya Grozdeva,Bulgaria,2,0,3,5,1896 - 2016
Chen Ruolin,People's Republic of China,5,0,0,5,1896 - 2016
Ines Diers,East Germany,2,2,1,5,1896 - 2016
Nick Schafer,Australia,2,1,2,5,1896 - 2016
Jess Fox,Australia,2,1,2,5,1896 - 2016
Klete Keller,United States,2,1,2,5,1896 - 2016
Robert Scheidt,Brazil,2,2,1,5,1896 - 2016
Ludger Beerbaum,Germany,4,0,1,5,1896 - 2016
Lars Jørgen Madsen,Denmark,2,2,1,5,1896 - 2016
Wang Hao,People's Republic of China,2,3,0,5,1896 - 2016
Eric Carlberg,Sweden,2,3,0,5,1896 - 2016
Earl Thomson,United States,2,3,0,5,1896 - 2016
Evelyn Ashford,United States,4,1,0,5,1896 - 2016
Emil Zátopek,Czech Republic,4,1,0,5,1896 - 2016
Hannes Kolehmainen,Finland,4,1,0,5,1896 - 2016
Ben Ainslie,Great Britain,4,1,0,5,1896 - 2016
John Naber,United States,4,1,0,5,1896 - 2016
Greg Louganis,United States,4,1,0,5,1896 - 2016
Janet Evans,United States,4,1,0,5,1896 - 2016
Fu Mingxia,People's Republic of China,4,1,0,5,1896 - 2016
Valentin Muratov,Russian Federation,4,1,0,5,1896 - 2016
Vladimir Artyomov,Russian Federation,4,1,0,5,1896 - 2016
Ecaterina Szabo,Romania,4,1,0,5,1896 - 2016
Oreste Puliti,Italy,4,1,0,5,1896 - 2016
Ramón Fonst,Cuba,4,1,0,5,1896 - 2016
Charles Pahud de Mortanges,Netherlands,4,1,0,5,1896 - 2016
Ian Ferguson,New Zealand,4,1,0,5,1896 - 2016
Irv Baxter,United States,2,3,0,5,1896 - 2016
Emily Seebohm,Australia,2,3,0,5,1896 - 2016
Ryoko Tamura-Tani,Japan,2,2,1,5,1896 - 2016
Brittany Elmslie,Australia,2,3,0,5,1896 - 2016
Lou Yun,People's Republic of China,2,2,1,5,1896 - 2016
Manlio Di Rosa,Italy,2,2,1,5,1896 - 2016
Alexandre Lippmann,France,2,2,1,5,1896 - 2016
Paul Anspach,Belgium,2,2,1,5,1896 - 2016
André Jousseaumé,France,2,2,1,5,1896 - 2016
Liselott Linsenhoff,Germany,2,2,1,5,1896 - 2016
Michal Martikán,Slovakia,2,2,1,5,1896 - 2016
Marcus Hurley,United States,4,0,1,5,1896 - 2016
Svetlana Romashina,Russian Olympic Committee,5,0,0,5,1896 - 2016
Teresa Edwards,United States,4,0,1,5,1896 - 2016
Yu Hexin,People's Republic of China,4,1,0,5,1896 - 2016
Bai Anqi,People's Republic of China,4,1,0,5,1896 - 2016
Venus Williams,United States,4,1,0,5,1896 - 2016
Wang Nan,People's Republic of China,4,1,0,5,1896 - 2016
Yana Klochkova,Ukraine,4,1,0,5,1896 - 2016
Mel Sheppard,United States,4,1,0,5,1896 - 2016
Meyer Prinstein,United States,4,1,0,5,1896 - 2016
Sviatlana Bahinskaya,Unified Team,3,1,1,5,1896 - 2016
Galina Gorokhova,Russian Federation,3,1,1,5,1896 - 2016
Sviatlana Bahinskaya,Soviet Union,3,1,1,5,1896 - 2016
Liselott Linsenhoff,West Germany,2,2,1,5,1896 - 2016
Andreas Dittmer,Germany,3,1,1,5,1896 - 2016
Antonio Rossi,Italy,3,1,1,5,1896 - 2016
Paul MacDonald,New Zealand,3,1,1,5,1896 - 2016
Daniel Morelon,France,3,1,1,5,1896 - 2016
Giancarlo Cornaggia-Medici,Italy,3,1,1,5,1896 - 2016
Sviatlana Bahinskaya,Belarus,3,1,1,5,1896 - 2016
Veikko Huhtanen,Finland,3,1,1,5,1896 - 2016
Constanța Pipotă-Burcică,Romania,3,1,1,5,1896 - 2016
Elena Georgescu,Romania,3,1,1,5,1896 - 2016
Harald Natvig,Norway,3,1,1,5,1896 - 2016
Shane Gould,Australia,3,1,1,5,1896 - 2016
Xiong Ni,People's Republic of China,3,1,1,5,1896 - 2016
Mary T. Meagher,United States,3,1,1,5,1896 - 2016
John Hencken,United States,3,1,1,5,1896 - 2016
Dezső Gyarmati,Hungary,3,1,1,5,1896 - 2016
Gwen Torrence,United States,3,1,1,5,1896 - 2016
Mal Whitfield,United States,3,1,1,5,1896 - 2016
Katsiaryna Khadatovich-Karsten,Unified Team,2,1,2,5,1896 - 2016
Cătălina Ponor,Romania,3,1,1,5,1896 - 2016
Yevgeny Rylov,Russian Federation,3,1,1,5,1896 - 2016
Anastasiya Makarova,Russian Federation,3,1,1,5,1896 - 2016
Darya Vaskina,Russian Federation,3,1,1,5,1896 - 2016
Ramona Portwich,Germany,3,2,0,5,1896 - 2016
Ralf Schumann,Germany,3,2,0,5,1896 - 2016
Kay Bluhm,Germany,3,1,1,5,1896 - 2016
Galina Gorokhova,Soviet Union,3,1,1,5,1896 - 2016
Yevgeny Rylov,Russian Olympic Committee,3,1,1,5,1896 - 2016
Kay Bluhm,East Germany,3,1,1,5,1896 - 2016
Ian Crocker,United States,3,1,1,5,1896 - 2016
Yang Wei,People's Republic of China,3,2,0,5,1896 - 2016
András Balczó,Hungary,3,2,0,5,1896 - 2016
Pablo Morales,United States,3,2,0,5,1896 - 2016
Duke Kahanamoku,United States,3,2,0,5,1896 - 2016
Josh Davis,United States,3,2,0,5,1896 - 2016
Klaus Dibiasi,Italy,3,2,0,5,1896 - 2016
Ralf Schumann,East Germany,3,2,0,5,1896 - 2016
Jack Beresford,Great Britain,3,2,0,5,1896 - 2016
Alberto Braglia,Italy,3,2,0,5,1896 - 2016
Valery Borzov,Ukraine,2,1,2,5,1896 - 2016
Titus Aelius Granianus,Sikyon,5,0,0,5,1896 - 2016
Hetoimokles,Sparta,5,0,0,5,1896 - 2016
Diogenes,Ephesus,5,0,0,5,1896 - 2016
Demetrios,Salamis,5,0,0,5,1896 - 2016
Svetlana Romashina,Russian Federation,5,0,0,5,1896 - 2016
(…),Argos,5,0,0,5,1896 - 2016
Florence Griffith Joyner,United States,3,2,0,5,1896 - 2016
Ramona Portwich,East Germany,3,2,0,5,1896 - 2016
Heike Drechsler,Germany,2,1,2,5,1896 - 2016
Nataliya Ishchenko,Russian Federation,5,0,0,5,1896 - 2016
Vladimir Artyomov,Soviet Union,4,1,0,5,1896 - 2016
Valentin Muratov,Soviet Union,4,1,0,5,1896 - 2016
Emil Zátopek,Czechoslovakia,4,1,0,5,1896 - 2016
Ludger Beerbaum,West Germany,4,0,1,5,1896 - 2016
Stanislav Pozdnyakov,Unified Team,4,0,1,5,1896 - 2016
Bud Fisher,United States,5,0,0,5,1896 - 2016
Marina Dobrancheva-Logvinenko,Soviet Union,2,1,2,5,1896 - 2016
Anastasiya Davydova,Russian Federation,5,0,0,5,1896 - 2016
Rudolf Svensson,Sweden,2,2,0,4,1896 - 2016
Arthur Wint,Jamaica,2,2,0,4,1896 - 2016
Annegret Richter,West Germany,2,2,0,4,1896 - 2016
Marlies Oelsner-Göhr,East Germany,2,2,0,4,1896 - 2016
Seb Coe,Great Britain,2,2,0,4,1896 - 2016
Sergey Koplyakov,Belarus,2,2,0,4,1896 - 2016
Inna Ryskal,Azerbaijan,2,2,0,4,1896 - 2016
Ford Konno,United States,2,2,0,4,1896 - 2016
Sue Pedersen,United States,2,2,0,4,1896 - 2016
Charley Paddock,United States,2,2,0,4,1896 - 2016
Kieren Perkins,Australia,2,2,0,4,1896 - 2016
Lorraine Crapp,Australia,2,2,0,4,1896 - 2016
Kip Keino,Kenya,2,2,0,4,1896 - 2016
Seda Tutkhalyan,Russian Federation,2,2,0,4,1896 - 2016
Serginho,Brazil,2,2,0,4,1896 - 2016
Cullen Jones,United States,2,2,0,4,1896 - 2016
Yohan Blake,Jamaica,2,2,0,4,1896 - 2016
Oleq Stepko,Azerbaijan,2,2,0,4,1896 - 2016
Jan Železný,Czechoslovakia,3,1,0,4,1896 - 2016
Olga Bryzgina,Ukraine,3,1,0,4,1896 - 2016
Tamara Press,Soviet Union,3,1,0,4,1896 - 2016
Viktor Saneyev,Soviet Union,3,1,0,4,1896 - 2016
Lyudmila Khvedosyuk-Pinayeva,Soviet Union,3,0,1,4,1896 - 2016
Tan Sixin,People's Republic of China,2,2,0,4,1896 - 2016
Sun Jiajun,People's Republic of China,2,2,0,4,1896 - 2016
Hrant Shahinyan,Armenia,2,2,0,4,1896 - 2016
Igor Novikov,Armenia,2,2,0,4,1896 - 2016
Gustav Casmir,Germany,2,2,0,4,1896 - 2016
Valery Lyukin,Kazakhstan,2,2,0,4,1896 - 2016
Nobuyuki Aihara,Japan,2,2,0,4,1896 - 2016
Mikhail Burtsev,Soviet Union,2,2,0,4,1896 - 2016
Mark Rakita,Soviet Union,2,2,0,4,1896 - 2016
Yury Sisikin,Soviet Union,2,2,0,4,1896 - 2016
Nina Bocharova,Ukraine,2,2,0,4,1896 - 2016
Valery Lyukin,Soviet Union,2,2,0,4,1896 - 2016
Hrant Shahinyan,Soviet Union,2,2,0,4,1896 - 2016
Igor Novikov,Soviet Union,2,2,0,4,1896 - 2016
Sergey Koplyakov,Soviet Union,2,2,0,4,1896 - 2016
Valentin Mankin,Ukraine,3,1,0,4,1896 - 2016
Andrey Lavrov,Soviet Union,3,0,1,4,1896 - 2016
Louis Van De Perck,Belgium,2,2,0,4,1896 - 2016
Pedro Luis Lazo,Cuba,2,2,0,4,1896 - 2016
Zsolt Gyulay,Hungary,2,2,0,4,1896 - 2016
Harry Boldt,Germany,2,2,0,4,1896 - 2016
Bruce Davidson,United States,2,2,0,4,1896 - 2016
Pierre Jonquères d'Oriola,France,2,2,0,4,1896 - 2016
Jens Lehmann,Germany,2,2,0,4,1896 - 2016
Joan Llaneras,Spain,2,2,0,4,1896 - 2016
Teun de Nooijer,Netherlands,2,2,0,4,1896 - 2016
André Labatut,France,2,2,0,4,1896 - 2016
Harry Boldt,West Germany,2,2,0,4,1896 - 2016
Alexander Pusch,West Germany,2,2,0,4,1896 - 2016
Bence Szabó,Hungary,2,2,0,4,1896 - 2016
Alberto Pellegrino,Italy,2,2,0,4,1896 - 2016
Mikhail Burtsev,Russian Federation,2,2,0,4,1896 - 2016
Mark Rakita,Russian Federation,2,2,0,4,1896 - 2016
Dmitry Bilozerchev,Soviet Union,3,0,1,4,1896 - 2016
Nina Bocharova,Soviet Union,2,2,0,4,1896 - 2016
István Pelle,Hungary,2,2,0,4,1896 - 2016
Jochen Schümann,Germany,3,1,0,4,1896 - 2016
Alwin Schockemöhle,West Germany,2,1,1,4,1896 - 2016
Aleksandr Karelin,Soviet Union,3,1,0,4,1896 - 2016
Ingrid Gulbin-Engel-Krämer,Germany,3,1,0,4,1896 - 2016
Søren Jensen,Denmark,2,0,2,4,1896 - 2016
Mihály Mayer,Hungary,2,0,2,4,1896 - 2016
Budd Goodwin,United States,2,0,2,4,1896 - 2016
Jill Sterkel,United States,2,0,2,4,1896 - 2016
Kathy Ellis,United States,2,0,2,4,1896 - 2016
Manuela Stellmach,East Germany,2,0,2,4,1896 - 2016
Conn Findlay,United States,2,0,2,4,1896 - 2016
August Güttinger,Switzerland,2,0,2,4,1896 - 2016
Nataliya Shaposhnikova,Russian Federation,2,0,2,4,1896 - 2016
Tamara Lyukhina-Zamotaylova,Russian Federation,2,0,2,4,1896 - 2016
Nataliya Kuchinskaya,Russian Federation,2,0,2,4,1896 - 2016
Pierre Trentin,France,2,0,2,4,1896 - 2016
Fritz Thiedemann,Germany,2,0,2,4,1896 - 2016
Greg Barton,United States,2,0,2,4,1896 - 2016
György Kolonics,Hungary,2,0,2,4,1896 - 2016
Nicole Uphoff-Becker,West Germany,4,0,0,4,1896 - 2016
Viktor Krovopuskov,Soviet Union,4,0,0,4,1896 - 2016
Vladimir Salnikov,Soviet Union,4,0,0,4,1896 - 2016
Yelizaveta Klevanovich,Russian Federation,2,1,1,4,1896 - 2016
Emily Selig,Australia,2,1,1,4,1896 - 2016
Maya DiRado,United States,2,1,1,4,1896 - 2016
Cao Yuan,People's Republic of China,2,1,1,4,1896 - 2016
Saúl Craviotto,Spain,2,1,1,4,1896 - 2016
Tore Holm,Sweden,2,0,2,4,1896 - 2016
Wang Liqin,People's Republic of China,2,0,2,4,1896 - 2016
Jess Schipper,Australia,2,0,2,4,1896 - 2016
Manuela Stellmach,Germany,2,0,2,4,1896 - 2016
Anja Fichtel-Mauritz,West Germany,2,1,1,4,1896 - 2016
Zita Funkenhauser,West Germany,2,1,1,4,1896 - 2016
Tatyana Gutsu,Unified Team,2,1,1,4,1896 - 2016
Yelena Shushunova,Soviet Union,2,1,1,4,1896 - 2016
Vladimir Golubnichy,Ukraine,2,1,1,4,1896 - 2016
Yelizaveta Klevanovich,Russian Olympic Committee,2,1,1,4,1896 - 2016
Fritz Thiedemann,West Germany,2,0,2,4,1896 - 2016
Nataliya Kuchinskaya,Soviet Union,2,0,2,4,1896 - 2016
Tamara Lyukhina-Zamotaylova,Soviet Union,2,0,2,4,1896 - 2016
Nataliya Shaposhnikova,Soviet Union,2,0,2,4,1896 - 2016
Matija Ljubek,Yugoslavia,2,1,1,4,1896 - 2016
Peter Vanderkaay,United States,2,0,2,4,1896 - 2016
Aleksandr Karelin,Unified Team,3,1,0,4,1896 - 2016
Olga Bryzgina,Unified Team,3,1,0,4,1896 - 2016
Wang Yan,People's Republic of China,2,0,2,4,1896 - 2016
Kim Jeong-Hwan,Republic of Korea,2,0,2,4,1896 - 2016
Sandra Izbașa,Romania,2,0,2,4,1896 - 2016
Becky Adlington,Great Britain,2,0,2,4,1896 - 2016
Pang Wei,People's Republic of China,2,0,2,4,1896 - 2016
Andrey Lavrov,Unified Team,3,0,1,4,1896 - 2016
Guo Yue,People's Republic of China,2,0,2,4,1896 - 2016
Mariel Zagunis,United States,2,0,2,4,1896 - 2016
Alain Bernard,France,2,1,1,4,1896 - 2016
Beezie Madden,United States,2,1,1,4,1896 - 2016
Du Li,People's Republic of China,2,1,1,4,1896 - 2016
Ivan Kizimov,Russian Federation,2,1,1,4,1896 - 2016
Yelena Shushunova,Russian Federation,2,1,1,4,1896 - 2016
Tatyana Gutsu,Ukraine,2,1,1,4,1896 - 2016
Sergey Sharikov,Russian Federation,2,1,1,4,1896 - 2016
Witold Woyda,Poland,2,1,1,4,1896 - 2016
Marcello Bertinetti,Italy,2,1,1,4,1896 - 2016
Ödön Tersztyánszky,Hungary,2,1,1,4,1896 - 2016
Éric Srecki,France,2,1,1,4,1896 - 2016
Zita Funkenhauser,Germany,2,1,1,4,1896 - 2016
Anja Fichtel-Mauritz,Germany,2,1,1,4,1896 - 2016
Alwin Schockemöhle,Germany,2,1,1,4,1896 - 2016
"Gustaf Adolf Boltenstern, Jr.",Sweden,2,1,1,4,1896 - 2016
Mike McKay,Australia,2,1,1,4,1896 - 2016
Matija Ljubek,Croatia,2,1,1,4,1896 - 2016
Bernd Olbricht,East Germany,2,1,1,4,1896 - 2016
Liu Guoliang,People's Republic of China,2,1,1,4,1896 - 2016
Qiao Hong,People's Republic of China,2,1,1,4,1896 - 2016
Oleq Stepko,Ukraine,2,2,0,4,1896 - 2016
Inna Ryskal,Soviet Union,2,2,0,4,1896 - 2016
Ivan Kizimov,Soviet Union,2,1,1,4,1896 - 2016
Anke Nothnagel-von Seck,Germany,3,1,0,4,1896 - 2016
Tatyana Petrenko-Samusenko,Soviet Union,3,1,0,4,1896 - 2016
Albert Azaryan,Soviet Union,3,1,0,4,1896 - 2016
Hermann Hänggi,Switzerland,2,1,1,4,1896 - 2016
Olaf Tufte,Norway,2,1,1,4,1896 - 2016
Neil Walker,United States,2,1,1,4,1896 - 2016
Dave Berkoff,United States,2,1,1,4,1896 - 2016
Yelena Zamolodchikova,Russian Federation,2,1,1,4,1896 - 2016
Ulla Salzgeber,Germany,2,1,1,4,1896 - 2016
Eirik Verås Larsen,Norway,2,1,1,4,1896 - 2016
Gao Ling,People's Republic of China,2,1,1,4,1896 - 2016
Maurice Greene,United States,2,1,1,4,1896 - 2016
Vladimir Golubnichy,Soviet Union,2,1,1,4,1896 - 2016
Volmari Iso-Hollo,Finland,2,1,1,4,1896 - 2016
Bruce Baumgartner,United States,2,1,1,4,1896 - 2016
László Jeney,Hungary,2,1,1,4,1896 - 2016
Jerry Heidenreich,United States,2,1,1,4,1896 - 2016
Mary Wayte,United States,2,1,1,4,1896 - 2016
Olga Homeghi-Bularda,Romania,2,1,1,4,1896 - 2016
Summer Sanders,United States,2,1,1,4,1896 - 2016
Dorothy Poynton-Hill,United States,2,1,1,4,1896 - 2016
Jan Henne,United States,2,1,1,4,1896 - 2016
Eleanor Garatti-Saville,United States,2,1,1,4,1896 - 2016
Emil Rausch,Germany,2,1,1,4,1896 - 2016
Tian Liang,People's Republic of China,2,1,1,4,1896 - 2016
Mike Wenden,Australia,2,1,1,4,1896 - 2016
John Devitt,Australia,2,1,1,4,1896 - 2016
Paul Colas,France,2,1,1,4,1896 - 2016
Rodica Arba-Pușcatu,Romania,2,1,1,4,1896 - 2016
Boglárka Kapás,Hungary,2,1,1,4,1896 - 2016
Yury Sisikin,Russian Federation,2,2,0,4,1896 - 2016
Laura Trott-Kenny,Great Britain,4,0,0,4,1896 - 2016
Mo Farah,Great Britain,4,0,0,4,1896 - 2016
John Flanagan,United States,3,1,0,4,1896 - 2016
Harry Hillman,United States,3,1,0,4,1896 - 2016
Steve Lewis,United States,3,1,0,4,1896 - 2016
Angelo Taylor,United States,3,1,0,4,1896 - 2016
Stratonikos,Alexandria,4,0,0,4,1896 - 2016
Philinos,Kos,4,0,0,4,1896 - 2016
Marcus Aurelius Asklepiades,Alexandria,4,0,0,4,1896 - 2016
Khairon,Pellene,4,0,0,4,1896 - 2016
Demosthenes,Miletus,4,0,0,4,1896 - 2016
Bilistikhe,Macedonia,4,0,0,4,1896 - 2016
Aurelius Helix,Phoenicia,4,0,0,4,1896 - 2016
Apollonios,Epidauros,4,0,0,4,1896 - 2016
Yana Yegoryan,Russian Federation,4,0,0,4,1896 - 2016
Christie Pearce-Rampone,United States,3,1,0,4,1896 - 2016
Anastasiya Yermakova,Russian Federation,4,0,0,4,1896 - 2016
Carl Schuhmann,Germany,4,0,0,4,1896 - 2016
Kaori Icho,Japan,4,0,0,4,1896 - 2016
Zhang Yining,People's Republic of China,4,0,0,4,1896 - 2016
Diana Taurasi,United States,4,0,0,4,1896 - 2016
Tamika Catchings,United States,4,0,0,4,1896 - 2016
Sue Bird,United States,4,0,0,4,1896 - 2016
Serena Williams,United States,4,0,0,4,1896 - 2016
Lenny Krayzelburg,United States,4,0,0,4,1896 - 2016
Jesse Owens,United States,4,0,0,4,1896 - 2016
Al Oerter,United States,4,0,0,4,1896 - 2016
Al Kraenzlein,United States,4,0,0,4,1896 - 2016
Michael Johnson,United States,4,0,0,4,1896 - 2016
Archie Hahn,United States,4,0,0,4,1896 - 2016
Harrison Dillard,United States,4,0,0,4,1896 - 2016
Robert Korzeniowski,Poland,4,0,0,4,1896 - 2016
Wyomia Tyus,United States,3,1,0,4,1896 - 2016
Valerie Brisco-Hooks,United States,3,1,0,4,1896 - 2016
Viktor Saneyev,Georgia,3,1,0,4,1896 - 2016
Tamara Press,Russian Federation,3,1,0,4,1896 - 2016
Mike Heath,United States,3,1,0,4,1896 - 2016
Chris von Saltza,United States,3,1,0,4,1896 - 2016
Sharon Stouder,United States,3,1,0,4,1896 - 2016
Nancy Hogshead,United States,3,1,0,4,1896 - 2016
Rie Mastenbroek,Netherlands,3,1,0,4,1896 - 2016
Caren Metschuck,East Germany,3,1,0,4,1896 - 2016
Ingrid Gulbin-Engel-Krämer,East Germany,3,1,0,4,1896 - 2016
Drew Ginn,Australia,3,1,0,4,1896 - 2016
Albert Azaryan,Armenia,3,1,0,4,1896 - 2016
Romeo Neri,Italy,3,1,0,4,1896 - 2016
Alfred Flatow,Germany,3,1,0,4,1896 - 2016
Franco Riccardi,Italy,3,1,0,4,1896 - 2016
Aldo Nadi,Italy,3,1,0,4,1896 - 2016
Tatyana Petrenko-Samusenko,Belarus,3,1,0,4,1896 - 2016
Udham Singh,India,3,1,0,4,1896 - 2016
Leslie Claudius,India,3,1,0,4,1896 - 2016
Florian Rousseau,France,3,1,0,4,1896 - 2016
Andrew Hoy,Australia,3,1,0,4,1896 - 2016
Zoltán Kammerer,Hungary,3,1,0,4,1896 - 2016
Torsten Gutsche,Germany,3,1,0,4,1896 - 2016
Anke Nothnagel-von Seck,East Germany,3,1,0,4,1896 - 2016
Laura Berg,United States,3,1,0,4,1896 - 2016
Valerius Eklektus,Sinope,4,0,0,4,1896 - 2016
Jeff Rouse,United States,3,1,0,4,1896 - 2016
Aleksandr Karelin,Russian Federation,3,1,0,4,1896 - 2016
Valentin Mankin,Soviet Union,3,1,0,4,1896 - 2016
Jochen Schümann,East Germany,3,1,0,4,1896 - 2016
Jan Železný,Czech Republic,3,1,0,4,1896 - 2016
Olga Bryzgina,Soviet Union,3,1,0,4,1896 - 2016
Fanny Blankers-Koen,Netherlands,4,0,0,4,1896 - 2016
Bärbel Eckert-Wöckel,East Germany,4,0,0,4,1896 - 2016
Jimmy McLane,United States,3,1,0,4,1896 - 2016
Wilma Rudolph,United States,3,0,1,4,1896 - 2016
Lasse Virén,Finland,4,0,0,4,1896 - 2016
Lyudmila Khvedosyuk-Pinayeva,Russian Federation,3,0,1,4,1896 - 2016
Endre Kabos,Hungary,3,0,1,4,1896 - 2016
Dmitry Bilozerchev,Russian Federation,3,0,1,4,1896 - 2016
Andrey Lavrov,Russian Federation,3,0,1,4,1896 - 2016
James Tomkins,Australia,3,0,1,4,1896 - 2016
Kathleen Heddle,Canada,3,0,1,4,1896 - 2016
Marnie McBean,Canada,3,0,1,4,1896 - 2016
Michelle Smith,Ireland,3,0,1,4,1896 - 2016
Jim Montgomery,United States,3,0,1,4,1896 - 2016
György Kárpáti,Hungary,3,0,1,4,1896 - 2016
Pyrros Dimas,Greece,3,0,1,4,1896 - 2016
Ugo Frigerio,Italy,3,0,1,4,1896 - 2016
Pavol Hochschorner,Slovakia,3,0,1,4,1896 - 2016
Vladislav Gerasimenko,Russian Federation,3,1,0,4,1896 - 2016
Peter Hochschorner,Slovakia,3,0,1,4,1896 - 2016
Kerri Walsh Jennings,United States,3,0,1,4,1896 - 2016
Carmelo Anthony,United States,3,0,1,4,1896 - 2016
Ed Clancy,Great Britain,3,0,1,4,1896 - 2016
LaShawn Merritt,United States,3,0,1,4,1896 - 2016
Áron Szilágyi,Hungary,3,0,1,4,1896 - 2016
Jenő Fuchs,Hungary,4,0,0,4,1896 - 2016
Henri Saint Cyr,Sweden,4,0,0,4,1896 - 2016
Nicole Uphoff-Becker,Germany,4,0,0,4,1896 - 2016
Lisa Leslie,United States,4,0,0,4,1896 - 2016
Gi Bo-Bae,Republic of Korea,3,0,1,4,1896 - 2016
Deng Yaping,People's Republic of China,4,0,0,4,1896 - 2016
Li Guangyuan,People's Republic of China,3,0,1,4,1896 - 2016
Giorgia Villa,Italy,3,1,0,4,1896 - 2016
Reggie Doherty,Great Britain,3,0,1,4,1896 - 2016
Carlo Pavesi,Italy,4,0,0,4,1896 - 2016
Niccolò Campriani,Italy,3,1,0,4,1896 - 2016
Betty Cuthbert,Australia,4,0,0,4,1896 - 2016
Paul Elvstrøm,Denmark,4,0,0,4,1896 - 2016
Paul Radmilovic,Great Britain,4,0,0,4,1896 - 2016
Pat McCormick,United States,4,0,0,4,1896 - 2016
Anthony Ervin,United States,3,1,0,4,1896 - 2016
Park Seong-Hyeon,Republic of Korea,3,1,0,4,1896 - 2016
Katinka Hosszú,Hungary,3,1,0,4,1896 - 2016
Jeremy Wariner,United States,3,1,0,4,1896 - 2016
Kenenisa Bekele,Ethiopia,3,1,0,4,1896 - 2016
Saori Yoshida,Japan,3,1,0,4,1896 - 2016
Chen Yibing,People's Republic of China,3,1,0,4,1896 - 2016
Viktor Krovopuskov,Russian Federation,4,0,0,4,1896 - 2016
Gabriella Szabó,Hungary,3,1,0,4,1896 - 2016
Ranomi Kromowidjojo,Netherlands,3,1,0,4,1896 - 2016
Zhang Jike,People's Republic of China,3,1,0,4,1896 - 2016
Michael Jung,Germany,3,1,0,4,1896 - 2016
Matthew Pinsent,Great Britain,4,0,0,4,1896 - 2016
Tamás Darnyi,Hungary,4,0,0,4,1896 - 2016
Vladimir Salnikov,Russian Federation,4,0,0,4,1896 - 2016
Li Xiaoxia,People's Republic of China,3,1,0,4,1896 - 2016
He Yun,People's Republic of China,3,1,0,4,1896 - 2016
Kristóf Milák,Hungary,3,1,0,4,1896 - 2016
He Jianbin,People's Republic of China,3,1,0,4,1896 - 2016
Ding Ning,People's Republic of China,3,1,0,4,1896 - 2016
Charlie Hickcox,United States,3,1,0,4,1896 - 2016
Vasily Kudinov,Russian Federation,2,0,1,3,1896 - 2016
Larisa Karlova,Soviet Union,2,0,1,3,1896 - 2016
Zinaida Turchina,Soviet Union,2,0,1,3,1896 - 2016
Venio Losert,Croatia,2,0,1,3,1896 - 2016
Miroslav Cerar,Slovenia,2,0,1,3,1896 - 2016
Rustam Sharipov,Ukraine,2,0,1,3,1896 - 2016
Axel Norling,Sweden,2,0,1,3,1896 - 2016
Tisandros,Naxos,3,0,0,3,1896 - 2016
Aleksandr Tuchkin,Russian Federation,2,0,1,3,1896 - 2016
Silke Hörner,East Germany,2,0,1,3,1896 - 2016
Penny Heyns,South Africa,2,0,1,3,1896 - 2016
Jane Barkman,United States,2,0,1,3,1896 - 2016
Kaye Hall,United States,2,0,1,3,1896 - 2016
Doug Gjertsen,United States,2,0,1,3,1896 - 2016
Joe Hudepohl,United States,2,0,1,3,1896 - 2016
Sammy Lee,United States,2,0,1,3,1896 - 2016
Mel Stewart,United States,2,0,1,3,1896 - 2016
Ana Ivis Fernández,Cuba,2,0,1,3,1896 - 2016
Yumilka Ruiz,Cuba,2,0,1,3,1896 - 2016
Yury Poyarkov,Soviet Union,2,0,1,3,1896 - 2016
Steve Timmons,United States,2,0,1,3,1896 - 2016
Ottó Boros,Hungary,2,0,1,3,1896 - 2016
Tivadar Kanizsa,Hungary,2,0,1,3,1896 - 2016
Kálmán Markovits,Hungary,2,0,1,3,1896 - 2016
Arkady Vorobyov,Russian Federation,2,0,1,3,1896 - 2016
Katrin Meißner,East Germany,2,0,1,3,1896 - 2016
Renata Mauer-Różańska,Poland,2,0,1,3,1896 - 2016
David Douillet,France,2,0,1,3,1896 - 2016
Tanyu Kiryakov,Bulgaria,2,0,1,3,1896 - 2016
János Martinek,Hungary,2,0,1,3,1896 - 2016
Ferenc Török,Hungary,2,0,1,3,1896 - 2016
Andy Holmes,Great Britain,2,0,1,3,1896 - 2016
Bernd Landvoigt,East Germany,2,0,1,3,1896 - 2016
Jörg Landvoigt,East Germany,2,0,1,3,1896 - 2016
Manuela Lutze,Germany,2,0,1,3,1896 - 2016
Katrin Rutschow-Stomporowski,Germany,2,0,1,3,1896 - 2016
Andreas Hajek,Germany,2,0,1,3,1896 - 2016
Thomas Lange,East Germany,2,0,1,3,1896 - 2016
Stephan Volkert,Germany,2,0,1,3,1896 - 2016
André Willms,Germany,2,0,1,3,1896 - 2016
Nico Rienks,Netherlands,2,0,1,3,1896 - 2016
Mario Lertora,Italy,2,0,1,3,1896 - 2016
Simon Dickie,New Zealand,2,0,1,3,1896 - 2016
Hans Walter,Switzerland,2,0,1,3,1896 - 2016
Oswald Holmberg,Sweden,2,0,1,3,1896 - 2016
Angelo Mazzoni,Italy,2,0,1,3,1896 - 2016
Zoltán Magyar,Hungary,2,0,1,3,1896 - 2016
Klaus Balkenhol,Germany,2,0,1,3,1896 - 2016
Leon Rotman,Romania,2,0,1,3,1896 - 2016
Nikolay Bukhalov,Bulgaria,2,0,1,3,1896 - 2016
Boris Lagutin,Russian Federation,2,0,1,3,1896 - 2016
Oleg Saitov,Russian Federation,2,0,1,3,1896 - 2016
David Robinson,United States,2,0,1,3,1896 - 2016
Katrina McClain,United States,2,0,1,3,1896 - 2016
Mary Joe Fernandez,United States,2,0,1,3,1896 - 2016
Charles Winslow,South Africa,2,0,1,3,1896 - 2016
Suzanne Lenglen,France,2,0,1,3,1896 - 2016
Phil Bryant,United States,2,0,1,3,1896 - 2016
Kim Dong-Mun,Republic of Korea,2,0,1,3,1896 - 2016
Teddy Flack,Australia,2,0,1,3,1896 - 2016
Joseph Hermans,Belgium,2,0,1,3,1896 - 2016
Firmin Flamand,Belgium,2,0,1,3,1896 - 2016
Laurie Doherty,Great Britain,2,0,1,3,1896 - 2016
Edmond Cloetens,Belgium,3,0,0,3,1896 - 2016
Wu Shengping,People's Republic of China,2,1,0,3,1896 - 2016
Andrey Ushakov,Russian Federation,2,1,0,3,1896 - 2016
Sun Bowei,People's Republic of China,2,1,0,3,1896 - 2016
Antonina Seredina,Russian Federation,2,0,1,3,1896 - 2016
Phillip Dutton,Australia,2,0,1,3,1896 - 2016
Aleksanteri Saarvala,Finland,2,0,1,3,1896 - 2016
Xavier Lesage,France,2,0,1,3,1896 - 2016
Larisa Petrik,Belarus,2,0,1,3,1896 - 2016
Tatyana Lysenko,Ukraine,2,0,1,3,1896 - 2016
Lidiya Kalinina-Ivanova,Russian Federation,2,0,1,3,1896 - 2016
Mariya Filatova,Russian Federation,2,0,1,3,1896 - 2016
Simona Păuca,Romania,2,0,1,3,1896 - 2016
Dezső Novák,Hungary,2,0,1,3,1896 - 2016
Umyar Mavlikhanov,Russian Federation,2,0,1,3,1896 - 2016
Jesper Bank,Denmark,2,0,1,3,1896 - 2016
Stefano Cerioni,Italy,2,0,1,3,1896 - 2016
Péter Tóth,Hungary,2,0,1,3,1896 - 2016
Karina Aznavuryan,Russian Federation,2,0,1,3,1896 - 2016
Pascale Trinquet-Hachin,France,2,0,1,3,1896 - 2016
Ronald Jansen,Netherlands,2,0,1,3,1896 - 2016
Jacques Brinkman,Netherlands,2,0,1,3,1896 - 2016
Guido Fulst,Germany,2,0,1,3,1896 - 2016
Hans von Rosen,Sweden,2,0,1,3,1896 - 2016
Franke Sloothaak,Germany,2,0,1,3,1896 - 2016
Heinz Pollay,Germany,2,0,1,3,1896 - 2016
Humberto Mariles,Mexico,2,0,1,3,1896 - 2016
Armen Nazaryan,Armenia,2,0,1,3,1896 - 2016
Conor Dwyer,United States,2,0,1,3,1896 - 2016
Marcelo Ferreira,Brazil,2,0,1,3,1896 - 2016
German Sveshnikov,Soviet Union,2,1,0,3,1896 - 2016
Aleksey Barkalov,Ukraine,2,1,0,3,1896 - 2016
Perica Bukić,Yugoslavia,2,1,0,3,1896 - 2016
Nina Smoleyeva,Soviet Union,2,1,0,3,1896 - 2016
Lyudmila Buldakova,Soviet Union,2,1,0,3,1896 - 2016
Denis Pankratov,Unified Team,2,1,0,3,1896 - 2016
Yury Tyukalov,Soviet Union,2,1,0,3,1896 - 2016
Anatoly Starostin,Soviet Union,2,1,0,3,1896 - 2016
Aleksandr Tkachov,Soviet Union,2,1,0,3,1896 - 2016
Julius Lenhart,United States,2,1,0,3,1896 - 2016
Yekaterina Kalinchuk,Soviet Union,2,1,0,3,1896 - 2016
Yelena Davydova,Russian Federation,2,1,0,3,1896 - 2016
Eduard Vinokurov,Soviet Union,2,1,0,3,1896 - 2016
Arnd Schmitt,West Germany,2,1,0,3,1896 - 2016
Boris Lagutin,Soviet Union,2,0,1,3,1896 - 2016
Elmar Borrmann,West Germany,2,1,0,3,1896 - 2016
Nicolae Juravschi,Romania,2,1,0,3,1896 - 2016
Aleksandr Shaparenko,Ukraine,2,1,0,3,1896 - 2016
Victor Reneischi,Soviet Union,2,1,0,3,1896 - 2016
Jan Brzák-Felix,Czechoslovakia,2,1,0,3,1896 - 2016
Tatyana Kazankina,Soviet Union,3,0,0,3,1896 - 2016
Aliaksandr Miadved,Soviet Union,3,0,0,3,1896 - 2016
Akakios Kakiasvili,Greece,3,0,0,3,1896 - 2016
Yevgeny Sadovy,Unified Team,3,0,0,3,1896 - 2016
Vyacheslav Ivanov,Soviet Union,3,0,0,3,1896 - 2016
Sergey Kharkov,Soviet Union,3,0,0,3,1896 - 2016
Viktor Zhdanovich,Soviet Union,3,0,0,3,1896 - 2016
Makharbek Khadartsev,Soviet Union,2,1,0,3,1896 - 2016
Antonina Seredina,Soviet Union,2,0,1,3,1896 - 2016
Randhir Singh Gentle,Uganda,3,0,0,3,1896 - 2016
Thomas Lange,Germany,2,0,1,3,1896 - 2016
Olga Nazarova,Unified Team,2,0,1,3,1896 - 2016
Makharbek Khadartsev,Unified Team,2,1,0,3,1896 - 2016
Anatoly Starostin,Unified Team,2,1,0,3,1896 - 2016
Yelena Davydova,Soviet Union,2,1,0,3,1896 - 2016
Nicolae Juravschi,Soviet Union,2,1,0,3,1896 - 2016
Akakios Kakiasvili,Unified Team,3,0,0,3,1896 - 2016
Nina Romashkova-Ponomaryova,Soviet Union,2,0,1,3,1896 - 2016
Olga Nazarova,Soviet Union,2,0,1,3,1896 - 2016
Armen Nazaryan,Bulgaria,2,0,1,3,1896 - 2016
Arkady Vorobyov,Soviet Union,2,0,1,3,1896 - 2016
Yury Poyarkov,Ukraine,2,0,1,3,1896 - 2016
Katrin Meißner,Germany,2,0,1,3,1896 - 2016
Aleksandr Tuchkin,Soviet Union,2,0,1,3,1896 - 2016
Phillip Dutton,United States,2,0,1,3,1896 - 2016
Zinaida Turchina,Ukraine,2,0,1,3,1896 - 2016
Larisa Karlova,Ukraine,2,0,1,3,1896 - 2016
Vasily Kudinov,Unified Team,2,0,1,3,1896 - 2016
Miroslav Cerar,Yugoslavia,2,0,1,3,1896 - 2016
Rustam Sharipov,Unified Team,2,0,1,3,1896 - 2016
Larisa Petrik,Soviet Union,2,0,1,3,1896 - 2016
Tatyana Lysenko,Unified Team,2,0,1,3,1896 - 2016
Lidiya Kalinina-Ivanova,Soviet Union,2,0,1,3,1896 - 2016
Mariya Filatova,Soviet Union,2,0,1,3,1896 - 2016
Umyar Mavlikhanov,Soviet Union,2,0,1,3,1896 - 2016
Franke Sloothaak,West Germany,2,0,1,3,1896 - 2016
Heinz Pollay,West Germany,2,0,1,3,1896 - 2016
Aleksandra Zabelina,Soviet Union,3,0,0,3,1896 - 2016
Vyacheslav Yekimov,Soviet Union,3,0,0,3,1896 - 2016
Derartu Tulu,Ethiopia,2,0,1,3,1896 - 2016
Thomas Ebert,Denmark,2,0,1,3,1896 - 2016
Barbora Špotáková,Czech Republic,2,0,1,3,1896 - 2016
Zou Shiming,People's Republic of China,2,0,1,3,1896 - 2016
Andrea Cassarà,Italy,2,0,1,3,1896 - 2016
Yuriy Cheban,Ukraine,2,0,1,3,1896 - 2016
DeeDee Trotter,United States,2,0,1,3,1896 - 2016
Mahé Drysdale,New Zealand,2,0,1,3,1896 - 2016
Alice Mills,Australia,2,0,1,3,1896 - 2016
Im Dong-Hyeon,Republic of Korea,2,0,1,3,1896 - 2016
Steven Lopez,United States,2,0,1,3,1896 - 2016
Hadi Saei,Islamic Republic of Iran,2,0,1,3,1896 - 2016
Oussama Mellouli,Tunisia,2,0,1,3,1896 - 2016
Britta Steffen,Germany,2,0,1,3,1896 - 2016
Matthias Witthaus,Germany,2,0,1,3,1896 - 2016
Hwang Gyeong-Seon,Republic of Korea,2,0,1,3,1896 - 2016
Tatyana Logunova,Russian Federation,2,0,1,3,1896 - 2016
Yelena Isinbayeva,Russian Federation,2,0,1,3,1896 - 2016
Bob Richards,United States,2,0,1,3,1896 - 2016
Edwin Moses,United States,2,0,1,3,1896 - 2016
Antonio McKay,United States,2,0,1,3,1896 - 2016
Nina Romashkova-Ponomaryova,Russian Federation,2,0,1,3,1896 - 2016
Olga Nazarova,Russian Federation,2,0,1,3,1896 - 2016
Virgilijus Alekna,Lithuania,2,0,1,3,1896 - 2016
Kelly Holmes,Great Britain,2,0,1,3,1896 - 2016
Micheline Ostermeyer,France,2,0,1,3,1896 - 2016
Heikki Liimatainen,Finland,2,0,1,3,1896 - 2016
Miruts Yifter,Ethiopia,2,0,1,3,1896 - 2016
Heike Kemmer,Germany,2,0,1,3,1896 - 2016
LeBron James,United States,2,0,1,3,1896 - 2016
Monica Theodorescu,West Germany,3,0,0,3,1896 - 2016
Zhao Yunlei,People's Republic of China,2,0,1,3,1896 - 2016
Sergey Chukhray,Ukraine,3,0,0,3,1896 - 2016
Vladimir Parfenovich,Soviet Union,3,0,0,3,1896 - 2016
Vladimir Morozov,Ukraine,3,0,0,3,1896 - 2016
Lin Xintong,People's Republic of China,2,0,1,3,1896 - 2016
Hifumi Abe,Japan,2,0,1,3,1896 - 2016
Yang Haoran,People's Republic of China,2,0,1,3,1896 - 2016
Panipak Wongpattanakit,Thailand,2,0,1,3,1896 - 2016
Barbora Seemanová,Czech Republic,2,0,1,3,1896 - 2016
Tiberius Claudius Patrobius,Syria (Antocheia),3,0,0,3,1896 - 2016
Lisa Carrington,New Zealand,2,0,1,3,1896 - 2016
Kristina Vogel,Germany,2,0,1,3,1896 - 2016
Oh Jin-Hyeok,Republic of Korea,2,0,1,3,1896 - 2016
Zhang Nan,People's Republic of China,2,0,1,3,1896 - 2016
Timo Weß,Germany,2,0,1,3,1896 - 2016
Oliver Korn,Germany,2,0,1,3,1896 - 2016
Moritz Fürste,Germany,2,0,1,3,1896 - 2016
Tobias Hauke,Germany,2,0,1,3,1896 - 2016
Steven Burke,Great Britain,2,0,1,3,1896 - 2016
Teddy Riner,France,2,0,1,3,1896 - 2016
Linn-Kristin Riegelhuth Koren,Norway,2,0,1,3,1896 - 2016
Marit Malm Frafjord,Norway,2,0,1,3,1896 - 2016
Katrine Lunde-Haraldsen,Norway,2,0,1,3,1896 - 2016
Kari Aalvik Grimsbø,Norway,2,0,1,3,1896 - 2016
Eri Yamada,Japan,2,0,1,3,1896 - 2016
Yukiko Ueno,Japan,2,0,1,3,1896 - 2016
Christopher Zeller,Germany,2,0,1,3,1896 - 2016
Marco Fichera,Italy,2,1,0,3,1896 - 2016
Chen Aisen,People's Republic of China,2,1,0,3,1896 - 2016
Rozaliya Nasretdinova,Russian Federation,2,1,0,3,1896 - 2016
Liliana Gafencu,Romania,3,0,0,3,1896 - 2016
Rica Reinisch,East Germany,3,0,0,3,1896 - 2016
Barbara Krause,East Germany,3,0,0,3,1896 - 2016
Ollie Schriver,United States,3,0,0,3,1896 - 2016
Joe Jackson,United States,3,0,0,3,1896 - 2016
Karl Frederick,United States,3,0,0,3,1896 - 2016
"Jack Kelly, Sr.",United States,3,0,0,3,1896 - 2016
Paul Costello,United States,3,0,0,3,1896 - 2016
Vyacheslav Ivanov,Russian Federation,3,0,0,3,1896 - 2016
Agostino Abbagnale,Italy,3,0,0,3,1896 - 2016
Elaine Thompson,Jamaica,2,1,0,3,1896 - 2016
Siegfried Brietzke,East Germany,3,0,0,3,1896 - 2016
Pertti Karppinen,Finland,3,0,0,3,1896 - 2016
Tadahiro Nomura,Japan,3,0,0,3,1896 - 2016
Daniel Norling,Sweden,3,0,0,3,1896 - 2016
Sergey Kharkov,Russian Federation,3,0,0,3,1896 - 2016
Luigi Maiocco,Italy,3,0,0,3,1896 - 2016
Viktor Zhdanovich,Russian Federation,3,0,0,3,1896 - 2016
László Rajcsányi,Hungary,3,0,0,3,1896 - 2016
Ulrike Richter,East Germany,3,0,0,3,1896 - 2016
Olga Brusnikina,Russian Federation,3,0,0,3,1896 - 2016
Mariya Kiselyova,Russian Federation,3,0,0,3,1896 - 2016
Yevgeny Sadovy,Russian Federation,3,0,0,3,1896 - 2016
Regla Bell,Cuba,3,0,0,3,1896 - 2016
Norman Ross,United States,3,0,0,3,1896 - 2016
Rowdy Gaines,United States,3,0,0,3,1896 - 2016
Steve Clark,United States,3,0,0,3,1896 - 2016
Rick Carey,United States,3,0,0,3,1896 - 2016
Mike Burton,United States,3,0,0,3,1896 - 2016
Ashley Tappin,United States,3,0,0,3,1896 - 2016
Carrie Steinseifer,United States,3,0,0,3,1896 - 2016
Martha Norelius,United States,3,0,0,3,1896 - 2016
Sandy Neilson,United States,3,0,0,3,1896 - 2016
Debbie Meyer,United States,3,0,0,3,1896 - 2016
Helene Madison,United States,3,0,0,3,1896 - 2016
Nicole Haislett,United States,3,0,0,3,1896 - 2016
Tracy Caulkins,United States,3,0,0,3,1896 - 2016
Ethelda Bleibtrey,United States,3,0,0,3,1896 - 2016
Brooke Bennett,United States,3,0,0,3,1896 - 2016
Melissa Belote,United States,3,0,0,3,1896 - 2016
Csaba Fenyvesi,Hungary,3,0,0,3,1896 - 2016
"Gabriel, Count de la Falaise",France,3,0,0,3,1896 - 2016
Jéhan de Buhan,France,3,0,0,3,1896 - 2016
László Papp,Hungary,3,0,0,3,1896 - 2016
Teófilo Stevenson,Cuba,3,0,0,3,1896 - 2016
Félix Savón,Cuba,3,0,0,3,1896 - 2016
Leah O'Brien-Amico,United States,3,0,0,3,1896 - 2016
Lori Harrigan,United States,3,0,0,3,1896 - 2016
Lisa Fernandez,United States,3,0,0,3,1896 - 2016
Edmond Van Moer,Belgium,3,0,0,3,1896 - 2016
Maurice Germot,France,2,1,0,3,1896 - 2016
Alphonse Allaert,Belgium,2,1,0,3,1896 - 2016
Edmond De Knibber,Belgium,2,1,0,3,1896 - 2016
Jérôme De Mayer,Belgium,2,1,0,3,1896 - 2016
Louis Delcon,Belgium,2,1,0,3,1896 - 2016
Louis Fierens,Belgium,2,1,0,3,1896 - 2016
Louis Van Beeck,Belgium,2,1,0,3,1896 - 2016
Pierre Van Thielt,Belgium,2,1,0,3,1896 - 2016
Omar Ajete,Cuba,2,1,0,3,1896 - 2016
Orestes Kindelán,Cuba,2,1,0,3,1896 - 2016
Omar Linares,Cuba,2,1,0,3,1896 - 2016
Lida Howell,United States,3,0,0,3,1896 - 2016
Dawn Staley,United States,3,0,0,3,1896 - 2016
Aleksandra Zabelina,Russian Federation,3,0,0,3,1896 - 2016
Sheryl Swoopes,United States,3,0,0,3,1896 - 2016
Randhir Singh Gentle,India,3,0,0,3,1896 - 2016
"Balbir Singh, Sr.",India,3,0,0,3,1896 - 2016
Ranganathan Francis,India,3,0,0,3,1896 - 2016
Dhyan Chand,India,3,0,0,3,1896 - 2016
Richard Allen,India,3,0,0,3,1896 - 2016
Rechelle Hawkes,Australia,3,0,0,3,1896 - 2016
Paul Masson,France,3,0,0,3,1896 - 2016
Vyacheslav Yekimov,Russian Federation,3,0,0,3,1896 - 2016
Robert Charpentier,France,3,0,0,3,1896 - 2016
Félicia Ballanger,France,3,0,0,3,1896 - 2016
Adolf van der Voort van Zijp,Netherlands,3,0,0,3,1896 - 2016
Matt Ryan,Australia,3,0,0,3,1896 - 2016
Richard Meade,Great Britain,3,0,0,3,1896 - 2016
Monica Theodorescu,Germany,3,0,0,3,1896 - 2016
Sergey Chukhray,Soviet Union,3,0,0,3,1896 - 2016
Vladimir Parfenovich,Belarus,3,0,0,3,1896 - 2016
Vladimir Morozov,Soviet Union,3,0,0,3,1896 - 2016
Marlenis Costa,Cuba,3,0,0,3,1896 - 2016
Mireya Luis,Cuba,3,0,0,3,1896 - 2016
Regla Torres,Cuba,3,0,0,3,1896 - 2016
"(…), aka Graos",Bithynia (Nikaia),3,0,0,3,1896 - 2016
Ryan Murphy,United States,3,0,0,3,1896 - 2016
Li Zhuhao,People's Republic of China,3,0,0,3,1896 - 2016
Ajna Késely,Hungary,3,0,0,3,1896 - 2016
Shi Tingmao,People's Republic of China,3,0,0,3,1896 - 2016
Gabby Douglas,United States,3,0,0,3,1896 - 2016
Tianna Madison-Bartoletta,United States,3,0,0,3,1896 - 2016
Sebastian Brendel,Germany,3,0,0,3,1896 - 2016
Robeisy Ramírez,Cuba,3,0,0,3,1896 - 2016
Jade Jones,Great Britain,3,0,0,3,1896 - 2016
Ma Long,People's Republic of China,3,0,0,3,1896 - 2016
Rūta Meilutytė,Lithuania,3,0,0,3,1896 - 2016
Elle Logan,United States,3,0,0,3,1896 - 2016
Vincent Hancock,United States,3,0,0,3,1896 - 2016
Pete Reed,Great Britain,3,0,0,3,1896 - 2016
Steph Rice,Australia,3,0,0,3,1896 - 2016
Seimone Augustus,United States,3,0,0,3,1896 - 2016
Sylvia Fowles,United States,3,0,0,3,1896 - 2016
Lin Shan,People's Republic of China,3,0,0,3,1896 - 2016
Arrikhion,Phigaleia,3,0,0,3,1896 - 2016
Mariya Gromova,Russian Federation,3,0,0,3,1896 - 2016
Astyanax,Miletus,3,0,0,3,1896 - 2016
Sostratos,Sikyon,3,0,0,3,1896 - 2016
Politeos,Keramos,3,0,0,3,1896 - 2016
Philombrotos,Sparta,3,0,0,3,1896 - 2016
"Philip II, King of Macedonia",Macedonia,3,0,0,3,1896 - 2016
Phanas,Pellene,3,0,0,3,1896 - 2016
Pantakles,Athens,3,0,0,3,1896 - 2016
Krison,Himera,3,0,0,3,1896 - 2016
Kallias II,Athens,3,0,0,3,1896 - 2016
"Hieron, Tyrant of Siracusa",Siracusa,3,0,0,3,1896 - 2016
Hekatomnos,Miletus,3,0,0,3,1896 - 2016
Gorgos,Elis,3,0,0,3,1896 - 2016
Euthymos,Unknown city in Lokria,3,0,0,3,1896 - 2016
Euagoras,Sparta,3,0,0,3,1896 - 2016
Dorieus,Rhodes,3,0,0,3,1896 - 2016
Dionysios,Seleukeia on the Tigris,3,0,0,3,1896 - 2016
Demokrates,Magnesia on the Maiandros,3,0,0,3,1896 - 2016
Athenodoros,Aigion,3,0,0,3,1896 - 2016
Elvira Khasyanova,Russian Federation,3,0,0,3,1896 - 2016
Mijaín López,Cuba,3,0,0,3,1896 - 2016
Karch Kiraly,United States,3,0,0,3,1896 - 2016
Frank Wykoff,United States,3,0,0,3,1896 - 2016
Bobby Joe Morrow,United States,3,0,0,3,1896 - 2016
Bud Houser,United States,3,0,0,3,1896 - 2016
Glenn Davis,United States,3,0,0,3,1896 - 2016
Gail Devers,United States,3,0,0,3,1896 - 2016
Tatyana Kazankina,Russian Federation,3,0,0,3,1896 - 2016
Peter Snell,New Zealand,3,0,0,3,1896 - 2016
Marie-José Pérec,France,3,0,0,3,1896 - 2016
Aliaksandr Miadved,Belarus,3,0,0,3,1896 - 2016
Carl Westergren,Sweden,3,0,0,3,1896 - 2016
Ivar Johansson,Sweden,3,0,0,3,1896 - 2016
Buvaysar Saytiyev,Russian Federation,3,0,0,3,1896 - 2016
Naim Süleymanoğlu,Turkey,3,0,0,3,1896 - 2016
Halil Mutlu,Turkey,3,0,0,3,1896 - 2016
Akakios Kakiasvili,Georgia,3,0,0,3,1896 - 2016
Tamás Kásás,Hungary,3,0,0,3,1896 - 2016
Tibor Benedek,Hungary,3,0,0,3,1896 - 2016
Charles Smith,Great Britain,3,0,0,3,1896 - 2016
Paul Pilgrim,United States,3,0,0,3,1896 - 2016
Francesco Verri,Italy,3,0,0,3,1896 - 2016
Ma Lin,People's Republic of China,3,0,0,3,1896 - 2016
Enrico Bruna,Italy,3,0,0,3,1896 - 2016
Andy Triggs Hodge,Great Britain,3,0,0,3,1896 - 2016
Kristin Armstrong,United States,3,0,0,3,1896 - 2016
Jodie Henry,Australia,3,0,0,3,1896 - 2016
Heather O'Reilly,United States,3,0,0,3,1896 - 2016
Heather Mitts,United States,3,0,0,3,1896 - 2016
Shannon Boxx,United States,3,0,0,3,1896 - 2016
Zoltán Szécsi,Hungary,3,0,0,3,1896 - 2016
Tamás Molnár,Hungary,3,0,0,3,1896 - 2016
Gergő Kiss,Hungary,3,0,0,3,1896 - 2016
Péter Biros,Hungary,3,0,0,3,1896 - 2016
Misty May-Treanor,United States,3,0,0,3,1896 - 2016
Botond Storcz,Hungary,3,0,0,3,1896 - 2016
Tony Estanguet,France,3,0,0,3,1896 - 2016
Katie Smith,United States,3,0,0,3,1896 - 2016
Yun Mi-Jin,Republic of Korea,3,0,0,3,1896 - 2016
Emilio Fontanella,Italy,3,0,0,3,1896 - 2016
Giorgio Cesana,Italy,3,0,0,3,1896 - 2016
Antonio Pacheco,Cuba,2,1,0,3,1896 - 2016
Eduardo Paret,Cuba,2,1,0,3,1896 - 2016
Antonio Scull,Cuba,2,1,0,3,1896 - 2016
Albert Hill,Great Britain,2,1,0,3,1896 - 2016
Hicham El Guerrouj,Morocco,2,1,0,3,1896 - 2016
Yury Sedykh,Soviet Union,2,1,0,3,1896 - 2016
Alice Brown,United States,2,1,0,3,1896 - 2016
Chandra Cheeseborough,United States,2,1,0,3,1896 - 2016
Babe Didrikson,United States,2,1,0,3,1896 - 2016
Jearl Miles-Clark,United States,2,1,0,3,1896 - 2016
Betty Robinson,United States,2,1,0,3,1896 - 2016
George Bonhag,United States,2,1,0,3,1896 - 2016
Morris Kirksey,United States,2,1,0,3,1896 - 2016
Mike Marsh,United States,2,1,0,3,1896 - 2016
Pat McDonald,United States,2,1,0,3,1896 - 2016
Parry O'Brien,United States,2,1,0,3,1896 - 2016
Jackson Scholz,United States,2,1,0,3,1896 - 2016
Andy Stanfield,United States,2,1,0,3,1896 - 2016
Gábor Horváth,Hungary,2,1,0,3,1896 - 2016
Ingrid Klimke,Germany,2,1,0,3,1896 - 2016
Julien Pillet,France,2,1,0,3,1896 - 2016
Heide Rosendahl,West Germany,2,1,0,3,1896 - 2016
Charles Bennett,Great Britain,2,1,0,3,1896 - 2016
Gervasio Deferr,Spain,2,1,0,3,1896 - 2016
Armas Taipale,Finland,2,1,0,3,1896 - 2016
Nina Smoleyeva,Kazakhstan,2,1,0,3,1896 - 2016
Perica Bukić,Croatia,2,1,0,3,1896 - 2016
Olivér Halassy,Hungary,2,1,0,3,1896 - 2016
Márton Homonnai,Hungary,2,1,0,3,1896 - 2016
"István Szívós, Sr.",Hungary,2,1,0,3,1896 - 2016
Aleksey Barkalov,Soviet Union,2,1,0,3,1896 - 2016
Louis Hostin,France,2,1,0,3,1896 - 2016
Yoshinobu Miyake,Japan,2,1,0,3,1896 - 2016
Tommy Kono,United States,2,1,0,3,1896 - 2016
Kustaa Pihlajamäki,Finland,2,1,0,3,1896 - 2016
Verner Weckman,Finland,2,1,0,3,1896 - 2016
Vincenzo Maenza,Italy,2,1,0,3,1896 - 2016
Makharbek Khadartsev,Russian Federation,2,1,0,3,1896 - 2016
Magnus Konow,Norway,2,1,0,3,1896 - 2016
Rodney Pattisson,Great Britain,2,1,0,3,1896 - 2016
Mark Reynolds,United States,2,1,0,3,1896 - 2016
Pauline Davis-Thompson,The Bahamas,2,1,0,3,1896 - 2016
Kate Sobrero-Markgraf,United States,2,1,0,3,1896 - 2016
Iain Percy,Great Britain,2,1,0,3,1896 - 2016
Ken Walsh,United States,2,1,0,3,1896 - 2016
Daniel Narcisse,France,2,1,0,3,1896 - 2016
Luc Abalo,France,2,1,0,3,1896 - 2016
Maartje Paumen,Netherlands,2,1,0,3,1896 - 2016
Naomi van As,Netherlands,2,1,0,3,1896 - 2016
Ellen Hoog,Netherlands,2,1,0,3,1896 - 2016
Lidewij Welten,Netherlands,2,1,0,3,1896 - 2016
Eva de Goede,Netherlands,2,1,0,3,1896 - 2016
Kami Craig,United States,2,1,0,3,1896 - 2016
Kerron Clement,United States,2,1,0,3,1896 - 2016
Ricky Berens,United States,2,1,0,3,1896 - 2016
Andy Murray,Great Britain,2,1,0,3,1896 - 2016
He Kexin,People's Republic of China,2,1,0,3,1896 - 2016
Koki Niwa,Japan,2,1,0,3,1896 - 2016
Luguelín Santos,Dominican Republic,2,1,0,3,1896 - 2016
Qiu Bo,People's Republic of China,2,1,0,3,1896 - 2016
Elisa Di Francisca,Italy,2,1,0,3,1896 - 2016
Dorothee Schneider,Germany,2,1,0,3,1896 - 2016
Yannick Agnel,France,2,1,0,3,1896 - 2016
Thierry Omeyer,France,2,1,0,3,1896 - 2016
Nikola Karabatic,France,2,1,0,3,1896 - 2016
Crystl Bustos,United States,2,1,0,3,1896 - 2016
Michaël Guigou,France,2,1,0,3,1896 - 2016
Stacey Nuveman,United States,2,1,0,3,1896 - 2016
Todd Pearson,Australia,2,1,0,3,1896 - 2016
Lindsay Benko,United States,2,1,0,3,1896 - 2016
Megan Quann-Jendrick,United States,2,1,0,3,1896 - 2016
Ioana Olteanu,Romania,2,1,0,3,1896 - 2016
Lee Seong-Jin,Republic of Korea,2,1,0,3,1896 - 2016
Marco Galiazzo,Italy,2,1,0,3,1896 - 2016
Park Gyeong-Mo,Republic of Korea,2,1,0,3,1896 - 2016
Fabian Cancellara,Switzerland,2,1,0,3,1896 - 2016
Valerie Adams-Vili,New Zealand,2,1,0,3,1896 - 2016
Caryn Davies,United States,2,1,0,3,1896 - 2016
Mary Whipple,United States,2,1,0,3,1896 - 2016
Meseret Defar,Ethiopia,2,1,0,3,1896 - 2016
Fu Haifeng,People's Republic of China,2,1,0,3,1896 - 2016
Fabrice Jeannet,France,2,1,0,3,1896 - 2016
Vicki Pendleton,Great Britain,2,1,0,3,1896 - 2016
McLain Ward,United States,2,1,0,3,1896 - 2016
Lyudmila Buldakova,Russian Federation,2,1,0,3,1896 - 2016
Chris Jacobs,United States,2,1,0,3,1896 - 2016
Luis Ulacia,Cuba,2,1,0,3,1896 - 2016
James Shepherd,Great Britain,2,1,0,3,1896 - 2016
Jeroen Delmeé,Netherlands,2,1,0,3,1896 - 2016
Erik Jazet,Netherlands,2,1,0,3,1896 - 2016
Guus Vogels,Netherlands,2,1,0,3,1896 - 2016
Ilona Elek-Schacherer,Hungary,2,1,0,3,1896 - 2016
Francesca Bortolozzi-Borella,Italy,2,1,0,3,1896 - 2016
Philippe Boisse,France,2,1,0,3,1896 - 2016
René Bougnol,France,2,1,0,3,1896 - 2016
"Georges, Baron Dillon-Kavanagh",France,2,1,0,3,1896 - 2016
Jacques Lataste,France,2,1,0,3,1896 - 2016
Elmar Borrmann,Germany,2,1,0,3,1896 - 2016
Arnd Schmitt,Germany,2,1,0,3,1896 - 2016
Ioannis Georgiadis,Greece,2,1,0,3,1896 - 2016
Attila Petschauer,Hungary,2,1,0,3,1896 - 2016
Gioacchino Guaragna,Italy,2,1,0,3,1896 - 2016
Abelardo Olivier,Italy,2,1,0,3,1896 - 2016
German Sveshnikov,Russian Federation,2,1,0,3,1896 - 2016
Eduard Vinokurov,Russian Federation,2,1,0,3,1896 - 2016
Shankar Laxman,India,2,1,0,3,1896 - 2016
Edwin Mills,Great Britain,2,1,0,3,1896 - 2016
Joy Fawcett,United States,2,1,0,3,1896 - 2016
Frederick Humphreys,Great Britain,2,1,0,3,1896 - 2016
Jang Yong-Ho,Republic of Korea,2,1,0,3,1896 - 2016
Darrell Pace,United States,2,1,0,3,1896 - 2016
Kong Linghui,People's Republic of China,2,1,0,3,1896 - 2016
Vinnie Richards,United States,2,1,0,3,1896 - 2016
Kurt Wires,Finland,2,1,0,3,1896 - 2016
Toma Simionov,Romania,2,1,0,3,1896 - 2016
Jan Brzák-Felix,Czech Republic,2,1,0,3,1896 - 2016
Victor Reneischi,Republic of Moldova,2,1,0,3,1896 - 2016
Aleksandr Shaparenko,Soviet Union,2,1,0,3,1896 - 2016
Nicolae Juravschi,Republic of Moldova,2,1,0,3,1896 - 2016
Gerard de Kruijff,Netherlands,2,1,0,3,1896 - 2016
Joe Fargis,United States,2,1,0,3,1896 - 2016
Åge Lundström,Sweden,2,1,0,3,1896 - 2016
Sergio Bianchetto,Italy,2,1,0,3,1896 - 2016
Henry Hansen,Denmark,2,1,0,3,1896 - 2016
Ben Jones,Great Britain,2,1,0,3,1896 - 2016
Guy Lapébie,France,2,1,0,3,1896 - 2016
Brandi Chastain,United States,2,1,0,3,1896 - 2016
Julie Foudy,United States,2,1,0,3,1896 - 2016
Tom Dolan,United States,2,1,0,3,1896 - 2016
Emil Kellenberger,Switzerland,2,1,0,3,1896 - 2016
Lones Wigger,United States,2,1,0,3,1896 - 2016
Walter Winans,United States,2,1,0,3,1896 - 2016
David Theile,Australia,2,1,0,3,1896 - 2016
Carolyn Waldo,Canada,2,1,0,3,1896 - 2016
Heike Friedrich,East Germany,2,1,0,3,1896 - 2016
Alfréd Hajós,Hungary,2,1,0,3,1896 - 2016
Masanori Yusa,Japan,2,1,0,3,1896 - 2016
Danyon Loader,New Zealand,2,1,0,3,1896 - 2016
Denis Pankratov,Russian Federation,2,1,0,3,1896 - 2016
Erik Adlerz,Sweden,2,1,0,3,1896 - 2016
Crissy Ahmann-Leighton,United States,2,1,0,3,1896 - 2016
Betty Becker-Pinkston,United States,2,1,0,3,1896 - 2016
Ann Curtis,United States,2,1,0,3,1896 - 2016
Jenna Johnson,United States,2,1,0,3,1896 - 2016
Claudia Kolb,United States,2,1,0,3,1896 - 2016
Tracie Ruiz-Conforto,United States,2,1,0,3,1896 - 2016
Pete Desjardins,United States,2,1,0,3,1896 - 2016
Åke Lundeberg,Sweden,2,1,0,3,1896 - 2016
Georgios Orfanidis,Greece,2,1,0,3,1896 - 2016
Mia Hamm,United States,2,1,0,3,1896 - 2016
William Pimm,Great Britain,2,1,0,3,1896 - 2016
Kristine Lilly,United States,2,1,0,3,1896 - 2016
Cindy Parlow,United States,2,1,0,3,1896 - 2016
Liliya Podkopaieva,Ukraine,2,1,0,3,1896 - 2016
Yelena Davydova,Canada,2,1,0,3,1896 - 2016
Yekaterina Kalinchuk,Russian Federation,2,1,0,3,1896 - 2016
Julius Lenhart,Austria,2,1,0,3,1896 - 2016
Aleksandr Tkachov,Russian Federation,2,1,0,3,1896 - 2016
Peter Vidmar,United States,2,1,0,3,1896 - 2016
Daniele Masala,Italy,2,1,0,3,1896 - 2016
Lars Hall,Sweden,2,1,0,3,1896 - 2016
Anatoly Starostin,Russian Federation,2,1,0,3,1896 - 2016
Jessica Monroe,Canada,2,1,0,3,1896 - 2016
Carmine Abbagnale,Italy,2,1,0,3,1896 - 2016
Giuseppe Abbagnale,Italy,2,1,0,3,1896 - 2016
Giuseppe Di Capua,Italy,2,1,0,3,1896 - 2016
Yury Tyukalov,Russian Federation,2,1,0,3,1896 - 2016
Pentti Linnosvuo,Finland,2,1,0,3,1896 - 2016
Makharbek Khadartsev,Uzbekistan,2,1,0,3,1896 - 2016
Carl Schuhmann,Germany,4,0,0,4,1896
Hermann Weingärtner,Germany,3,2,1,6,1896
Alfred Flatow,Germany,3,1,0,4,1896
Paul Masson,France,3,0,0,3,1896
Bob Garrett,United States,2,2,0,4,1896
Teddy Flack,Australia,2,0,1,3,1896
John Pius Boland,Great Britain,2,0,0,2,1896
Conrad Böcker,Germany,2,0,0,2,1896
Georg Hillmar,Germany,2,0,0,2,1896
Fritz Manteuffel,Germany,2,0,0,2,1896
Karl Neukirch,Germany,2,0,0,2,1896
Richard Röstel,Germany,2,0,0,2,1896
Gustav Schuft,Germany,2,0,0,2,1896
Alfréd Hajós,Hungary,2,0,0,2,1896
Gustav Flatow,Germany,2,0,0,2,1896
Tom Burke,United States,2,0,0,2,1896
Ellery Clark,United States,2,0,0,2,1896
Louis Zutter,Switzerland,1,2,0,3,1896
Léon Flameng,France,1,1,1,3,1896
Viggo Jensen,Denmark,1,1,1,3,1896
Ioannis Frangoudis,Greece,1,1,1,3,1896
James B. Connolly,United States,1,1,1,3,1896
Nikolaos Andriakopoulos,Greece,1,1,0,2,1896
Georgios Orfanidis,Greece,1,1,0,2,1896
Sumner Paine,United States,1,1,0,2,1896
Launceston Elliot,Great Britain,1,1,0,2,1896
Adolf Schmal,Austria,1,0,2,3,1896
Ioannis Mitropoulos,Greece,1,0,1,2,1896
Fritz Traun,Germany,1,0,0,1,1896
Aristidis Konstantinidis,Greece,1,0,0,1,1896
Eugène Henry Gravelotte,France,1,0,0,1,1896
Ioannis Georgiadis,Greece,1,0,0,1,1896
Leon Pyrgos,Greece,1,0,0,1,1896
Pantelis Karasevdas,Greece,1,0,0,1,1896
John Paine,United States,1,0,0,1,1896
Paul Neumann,Austria,1,0,0,1,1896
Ioannis Malokinis,Greece,1,0,0,1,1896
Spyros Louis,Greece,1,0,0,1,1896
Tom Curtis,United States,1,0,0,1,1896
Bill Hoyt,United States,1,0,0,1,1896
Demetrius Casdagli,Greece,0,2,0,2,1896
Stamatios Nikolopoulos,Greece,0,2,0,2,1896
Thomas Xenakis,Greece,0,2,0,2,1896
Holger Nielsen,Denmark,0,1,2,3,1896
Fritz Hofmann,Germany,0,1,1,2,1896
Petros Persakis,Greece,0,1,1,2,1896
Dimitrios Petrokokkinos,Greece,0,1,0,1,1896
Anton Gödrich,Germany,0,1,0,1,1896
Frederick Keeping,Great Britain,0,1,0,1,1896
Georgios Koletis,Greece,0,1,0,1,1896
Otto Herschmann,Austria,0,1,0,1,1896
Henri Callot,France,0,1,0,1,1896
Joanni Perronet,France,0,1,0,1,1896
Tilemakhos Karakalos,Greece,0,1,0,1,1896
Pavlos Pavlidis,Greece,0,1,0,1,1896
Ioannis Andreou,Greece,0,1,0,1,1896
Spyros Khazapis,Greece,0,1,0,1,1896
Antonios Pepanos,Greece,0,1,0,1,1896
Georgios Tsitas,Greece,0,1,0,1,1896
Alexandre Tuffèri,France,0,1,0,1,1896
Grantley Goulding,Great Britain,0,1,0,1,1896
Miltiadis Gouskos,Greece,0,1,0,1,1896
Panagiotis Paraskevopoulos,Greece,0,1,0,1,1896
Kharilaos Vasilakos,Greece,0,1,0,1,1896
Nándor Dáni,Hungary,0,1,0,1,1896
Arthur C. Blake,United States,0,1,0,1,1896
Herbert Jamison,United States,0,1,0,1,1896
Albert Tyler,United States,0,1,0,1,1896
Sotirios Versis,Greece,0,0,2,2,1896
Konstantinos Paspatis,Greece,0,0,1,1,1896
Momcsilló Tapavicza,Hungary,0,0,1,1,1896
Edward Battel,Great Britain,0,0,1,1,1896
Periklis Pierrakos-Mavromikhalis,Greece,0,0,1,1,1896
Athanasios Vouros,Greece,0,0,1,1,1896
Filippos Karvelas,Greece,0,0,1,1,1896
Dimitrios Loundras,Greece,0,0,1,1,1896
Albin Lermusiaux,France,0,0,1,1,1896
Nikolaos Dorakis,Greece,0,0,1,1,1896
Nikolaos Trikoupis,Greece,0,0,1,1,1896
Dimitrios Drivas,Greece,0,0,1,1,1896
Efstathios Khorafas,Greece,0,0,1,1,1896
Alexandros Nikolopoulos,Greece,0,0,1,1,1896
Stefanos Khristopoulos,Greece,0,0,1,1,1896
Charles Gmelin,Great Britain,0,0,1,1,1896
George Stuart Robertson,Great Britain,0,0,1,1,1896
Evangelos Damaskos,Greece,0,0,1,1,1896
Dimitrios Golemis,Greece,0,0,1,1,1896
Georgios Papasideris,Greece,0,0,1,1,1896
Ioannis Persakis,Greece,0,0,1,1,1896
Ioannis Theodoropoulos,Greece,0,0,1,1,1896
Gyula Kellner,Hungary,0,0,1,1,1896
Alajos Szokoly,Hungary,0,0,1,1,1896
Frank Lane,United States,0,0,1,1,1896
Al Kraenzlein,United States,4,0,0,4,1900
Konrad Stäheli,Switzerland,3,0,1,4,1900
John Jarvis,Great Britain,3,0,0,3,1900
Ray Ewry,United States,3,0,0,3,1900
Irv Baxter,United States,2,3,0,5,1900
Walter Tewksbury,United States,2,2,1,5,1900
Hubert Van Innis,Belgium,2,2,0,4,1900
Emil Kellenberger,Switzerland,2,1,0,3,1900
Charles Bennett,Great Britain,2,1,0,3,1900
Laurie Doherty,Great Britain,2,0,1,3,1900
Reggie Doherty,Great Britain,2,0,1,3,1900
Charlotte Cooper,Great Britain,2,0,0,2,1900
Henri Hérouin,France,2,0,0,2,1900
Gaston Aumoitte,France,2,0,0,2,1900
Albert Ayat,France,2,0,0,2,1900
Louis Richardet,Switzerland,2,0,0,2,1900
Conrad Karl Röderer,Switzerland,2,0,0,2,1900
Fred Lane,Australia,2,0,0,2,1900
Ernst Hoppenberg,Germany,2,0,0,2,1900
Frédéric Blanchy,France,2,0,0,2,1900
Lorne Currie,Great Britain,2,0,0,2,1900
William Exshaw,France,2,0,0,2,1900
"John Gretton, Jr.",Great Britain,2,0,0,2,1900
Jacques le Lavasseur,France,2,0,0,2,1900
Algernon Maudslay,Great Britain,2,0,0,2,1900
Jack Rimmer,Great Britain,2,0,0,2,1900
Alfred Tysoe,Great Britain,2,0,0,2,1900
Achille Paroche,France,1,2,1,4,1900
Hermanus Brockmann,Netherlands,1,1,1,3,1900
Sidney Robinson,Great Britain,1,1,1,3,1900
"Giangiorgio, Count Trissino",Italy,1,1,0,2,1900
Georges Johin,France,1,1,0,2,1900
Jean Collas,France,1,1,0,2,1900
Charles Gondouin,France,1,1,0,2,1900
Émile Sarrade,France,1,1,0,2,1900
Ramón Fonst,Cuba,1,1,0,2,1900
"Bernard, Count de Pourtalès",Switzerland,1,1,0,2,1900
"Hermann, Count de Pourtalès",Switzerland,1,1,0,2,1900
"Hélène, Countess de Pourtalès",Switzerland,1,1,0,2,1900
Georg Naue,Germany,1,1,0,2,1900
Heinrich Peters,Germany,1,1,0,2,1900
Ottokar Weise,Germany,1,1,0,2,1900
Paul Wiesner,Germany,1,1,0,2,1900
Meyer Prinstein,United States,1,1,0,2,1900
Stan Rowley,Australia,1,0,3,4,1900
Chrétien Waydelich,France,1,0,1,2,1900
François Brandt,Netherlands,1,0,1,2,1900
Roelof Klein,Netherlands,1,0,1,2,1900
Peter Kemp,Great Britain,1,0,1,2,1900
Pierre Gervais,France,1,0,1,2,1900
Edward Hore,Great Britain,1,0,1,2,1900
George Orton,Canada,1,0,1,2,1900
Dick Sheldon,United States,1,0,1,2,1900
Emmanuel Foulon,Belgium,1,0,0,1,1900
Émile Grumiaux,France,1,0,0,1,1900
Eugène Mougin,France,1,0,0,1,1900
Charles Sands,France,1,0,0,1,1900
Dominique Gardères,France,1,0,0,1,1900
Aimé Haegeman,Belgium,1,0,0,1,1900
Louis Napoléon Murat,France,1,0,0,1,1900
Georges Nagelmackers,Belgium,1,0,0,1,1900
Constant Van Langhendonck,Belgium,1,0,0,1,1900
Enrico Brusoni,Italy,1,0,0,1,1900
Albert Taillandier,France,1,0,0,1,1900
Edgar Aabye,Denmark,1,0,0,1,1900
John Beresford,Great Britain,1,0,0,1,1900
A. Albert,France,1,0,0,1,1900
Vladimir Aïtoff,France,1,0,0,1,1900
Léon Binoche,France,1,0,0,1,1900
Jean-Guy Gautier,France,1,0,0,1,1900
Auguste Giroux,France,1,0,0,1,1900
Constantin Henriquez,France,1,0,0,1,1900
Jean Hervé,France,1,0,0,1,1900
Victor Lardanchet,France,1,0,0,1,1900
Hubert Lefèbvre,France,1,0,0,1,1900
Joseph Olivier,France,1,0,0,1,1900
Alexandre Pharamond,France,1,0,0,1,1900
André Rischmann,France,1,0,0,1,1900
André Roosevelt,France,1,0,0,1,1900
Charles Beachcroft,Great Britain,1,0,0,1,1900
Arthur Birkett,Great Britain,1,0,0,1,1900
Alfred Bowerman,Great Britain,1,0,0,1,1900
George Buckley,Great Britain,1,0,0,1,1900
Francis Burchell,Great Britain,1,0,0,1,1900
Frederick Christian,Great Britain,1,0,0,1,1900
Harry Corner,Great Britain,1,0,0,1,1900
Frederick Cuming,Great Britain,1,0,0,1,1900
William Donne,Great Britain,1,0,0,1,1900
Alfred Powlesland,Great Britain,1,0,0,1,1900
John Symes,Great Britain,1,0,0,1,1900
Montagu Toller,Great Britain,1,0,0,1,1900
Denis Daly,Great Britain,1,0,0,1,1900
Foxhall Keene,Great Britain,1,0,0,1,1900
Frank Mackey,Great Britain,1,0,0,1,1900
Toby Rawlinson,Great Britain,1,0,0,1,1900
Margaret Abbott,United States,1,0,0,1,1900
Louis Bastien,France,1,0,0,1,1900
Émile Coste,France,1,0,0,1,1900
"Gabriel, Count de la Falaise",France,1,0,0,1,1900
Lucien Mérignac,France,1,0,0,1,1900
Antonio Conte,Italy,1,0,0,1,1900
Tom Burridge,Great Britain,1,0,0,1,1900
Claude Buckenham,Great Britain,1,0,0,1,1900
Alfred Chalk,Great Britain,1,0,0,1,1900
William Gosling,Great Britain,1,0,0,1,1900
Henry Haslam,Great Britain,1,0,0,1,1900
James Jones,Great Britain,1,0,0,1,1900
John Nicholas,Great Britain,1,0,0,1,1900
Bill Quash,Great Britain,1,0,0,1,1900
Fred Spackman,Great Britain,1,0,0,1,1900
Richard Turner,Great Britain,1,0,0,1,1900
Jack Zealley,Great Britain,1,0,0,1,1900
Gustave Sandras,France,1,0,0,1,1900
Hermann Barrelet,France,1,0,0,1,1900
Henri Bouckaert,France,1,0,0,1,1900
Jean Cau,France,1,0,0,1,1900
Charlot,France,1,0,0,1,1900
Émile Delchambre,France,1,0,0,1,1900
Henri Hazebrouck,France,1,0,0,1,1900
Carl Heinrich Goßler,Germany,1,0,0,1,1900
Gustav Goßler,Germany,1,0,0,1,1900
Oscar Goßler,Germany,1,0,0,1,1900
Walther Katzenstein,Germany,1,0,0,1,1900
Waldemar Tietgens,Germany,1,0,0,1,1900
Lou Abell,United States,1,0,0,1,1900
Bill Carr,United States,1,0,0,1,1900
Harry DeBaecke,United States,1,0,0,1,1900
"John Exley, Jr.",United States,1,0,0,1,1900
John Geiger,United States,1,0,0,1,1900
Ed Hedley,United States,1,0,0,1,1900
Jim Juvenal,United States,1,0,0,1,1900
Roscoe Lockwood,United States,1,0,0,1,1900
Ed Marsh,United States,1,0,0,1,1900
Lars Jørgen Madsen,Denmark,1,0,0,1,1900
Roger de Barbarin,France,1,0,0,1,1900
Franz Böckli,Switzerland,1,0,0,1,1900
Alfred Grütter,Switzerland,1,0,0,1,1900
Friedrich Lüthi,Switzerland,1,0,0,1,1900
Paul Probst,Switzerland,1,0,0,1,1900
Robert Crawshaw,Great Britain,1,0,0,1,1900
William Henry,Great Britain,1,0,0,1,1900
Frederick Stapleton,Great Britain,1,0,0,1,1900
Max Hainle,Germany,1,0,0,1,1900
Charles Devendeville,France,1,0,0,1,1900
Tom Coe,Great Britain,1,0,0,1,1900
Émile Billard,France,1,0,0,1,1900
Louis Auguste-Dormeuil,France,1,0,0,1,1900
Henri Gilardoni,France,1,0,0,1,1900
Harry Jefferson,Great Britain,1,0,0,1,1900
Paul Perquer,France,1,0,0,1,1900
Cecil Quentin,Great Britain,1,0,0,1,1900
Émile Sacré,France,1,0,0,1,1900
Howard Taylor,Great Britain,1,0,0,1,1900
Eugen Schmidt,Denmark,1,0,0,1,1900
Charles Winckler,Denmark,1,0,0,1,1900
Frantz Reichel,France,1,0,0,1,1900
Michel Théato,France,1,0,0,1,1900
Rudolf Bauer,Hungary,1,0,0,1,1900
August Nilsson,Sweden,1,0,0,1,1900
Karl Gustaf Staaf,Sweden,1,0,0,1,1900
Gustaf Söderström,Sweden,1,0,0,1,1900
John Flanagan,United States,1,0,0,1,1900
Frank Jarvis,United States,1,0,0,1,1900
Maxey Long,United States,1,0,0,1,1900
Ernst Lührsen,Germany,1,0,0,1,1900
Gustav Lexau,Germany,1,0,0,1,1900
Francisco Villota,Spain,1,0,0,1,1900
José de Amézola,Spain,1,0,0,1,1900
Victor Lindberg,Great Britain,1,0,0,1,1900
Anders Peter Nielsen,Denmark,0,3,0,3,1900
Ole Østmo,Norway,0,2,2,4,1900
Harold Mahony,Great Britain,0,2,1,3,1900
Zoltán Halmay,Hungary,0,2,1,3,1900
Auguste Serrurier,France,0,2,0,2,1900
Victor Thibault,France,0,2,0,2,1900
Yvonne Prévost,France,0,2,0,2,1900
Otto Wahle,Austria,0,2,0,2,1900
Jean-Baptiste Charcot,France,0,2,0,2,1900
Jacques Doucet,France,0,2,0,2,1900
Auguste Godinet,France,0,2,0,2,1900
Robert Linzeler,France,0,2,0,2,1900
Léon Susse,France,0,2,0,2,1900
Texier I,France,0,2,0,2,1900
Texier II,France,0,2,0,2,1900
Henry Deloge,France,0,2,0,2,1900
Norman Pritchard,India,0,2,0,2,1900
Henri Mialaret,France,0,2,0,2,1900
Jacques Baudrier,France,0,1,2,3,1900
Émile Michelet,France,0,1,2,3,1900
Georges Van Der Poele,Belgium,0,1,1,2,1900
Maurice Lecoq,France,0,1,1,2,1900
Léon Moreaux,France,0,1,1,2,1900
Karl Ruberl,Austria,0,1,1,2,1900
Auguste Albert,France,0,1,1,2,1900
A. Dubois,France,0,1,1,2,1900
J. Dubois,France,0,1,1,2,1900
Albert Duval,France,0,1,1,2,1900
Maurice Gufflet,France,0,1,1,2,1900
Robert Gufflet,France,0,1,1,2,1900
Charles Guiraist,France,0,1,1,2,1900
Charles Hugo,France,0,1,1,2,1900
Jean Le Bret,France,0,1,1,2,1900
Félix Marcotte,France,0,1,1,2,1900
William Martin,France,0,1,1,2,1900
Marcel Meran,France,0,1,1,2,1900
Jules Valton,France,0,1,1,2,1900
François Vilamitjana,France,0,1,1,2,1900
Jean Chastanié,France,0,1,1,2,1900
Pat Leahy,Great Britain,0,1,1,2,1900
Josiah McCracken,United States,0,1,1,2,1900
Max Décugis,France,0,1,0,1,1900
"Druart, Jr.",Belgium,0,1,0,1,1900
Henri Helle,France,0,1,0,1,1900
Spalding de Garmendia,United States,0,1,0,1,1900
Victor Archenoul,France,0,1,0,1,1900
Karl Duill,Germany,0,1,0,1,1900
Lloyd Hildebrand,Great Britain,0,1,0,1,1900
Fernand Sanz,France,0,1,0,1,1900
William Anderson,France,0,1,0,1,1900
Willie Attrill,France,0,1,0,1,1900
John Braid,France,0,1,0,1,1900
W. Browning,France,0,1,0,1,1900
Robert Horne,France,0,1,0,1,1900
Timothée Jordan,France,0,1,0,1,1900
Arthur MacEvoy,France,0,1,0,1,1900
Douglas Robinson,France,0,1,0,1,1900
Alfred Schneidau,France,0,1,0,1,1900
H. F. Roques,France,0,1,0,1,1900
Henry Terry,France,0,1,0,1,1900
Philip Tomalin,France,0,1,0,1,1900
Maurice Vignerot,France,0,1,0,1,1900
Raymond Basset,France,0,1,0,1,1900
Joseph Roffo,France,0,1,0,1,1900
Walter Rutherford,Great Britain,0,1,0,1,1900
Walter Buckmaster,Great Britain,0,1,0,1,1900
Jean De Madre,France,0,1,0,1,1900
Freddie Freake,Great Britain,0,1,0,1,1900
Walter McCreery,Great Britain,0,1,0,1,1900
Frank Bayliss,Great Britain,0,1,0,1,1900
Henry Birtles,Great Britain,0,1,0,1,1900
James Cantion,Great Britain,0,1,0,1,1900
Arthur Darby,Great Britain,0,1,0,1,1900
Clement Deykin,Great Britain,0,1,0,1,1900
L. Hood,Great Britain,0,1,0,1,1900
M. L. Logan,Great Britain,0,1,0,1,1900
Herbert Loveitt,Great Britain,0,1,0,1,1900
Herbert Nicol,Great Britain,0,1,0,1,1900
Valentine Smith,Great Britain,0,1,0,1,1900
M. W. Talbott,Great Britain,0,1,0,1,1900
Joseph Wallis,Great Britain,0,1,0,1,1900
Claud Whittindale,Great Britain,0,1,0,1,1900
Raymond Whittindale,Great Britain,0,1,0,1,1900
Frank Wilson,Great Britain,0,1,0,1,1900
Albert Amrhein,Germany,0,1,0,1,1900
Hugo Betting,Germany,0,1,0,1,1900
Jacob Hermann,Germany,0,1,0,1,1900
Willy Hofmeister,Germany,0,1,0,1,1900
Hermann Kreuzer,Germany,0,1,0,1,1900
Arnold Landvoigt,Germany,0,1,0,1,1900
Hans Latscha,Germany,0,1,0,1,1900
Erich Ludwig,Germany,0,1,0,1,1900
Richard Ludwig,Germany,0,1,0,1,1900
Fritz Müller,Germany,0,1,0,1,1900
Eduard Poppe,Germany,0,1,0,1,1900
Heinrich Reitz,Germany,0,1,0,1,1900
August Schmierer,Germany,0,1,0,1,1900
Adolf Stockhausen,Germany,0,1,0,1,1900
Georg Wenderoth,Germany,0,1,0,1,1900
Polly Whittier,Switzerland,0,1,0,1,1900
Gilbert Bougnol,France,0,1,0,1,1900
Alphonse Kirchhoffer,France,0,1,0,1,1900
Henri Masson,France,0,1,0,1,1900
Louis Perrée,France,0,1,0,1,1900
Léon Thiébaut,France,0,1,0,1,1900
Italo Santelli,Italy,0,1,0,1,1900
Pierre Allemane,France,0,1,0,1,1900
Louis Bach,France,0,1,0,1,1900
Fernand Canelle,France,0,1,0,1,1900
R. Duparc,France,0,1,0,1,1900
Eugène Fraysse,France,0,1,0,1,1900
Virgile Gaillard,France,0,1,0,1,1900
Georges Garnier,France,0,1,0,1,1900
René Grandjean,France,0,1,0,1,1900
Lucien Huteau,France,0,1,0,1,1900
Marcel Lambert,France,0,1,0,1,1900
Maurice Macaire,France,0,1,0,1,1900
Gaston Peltier,France,0,1,0,1,1900
Noël Bas,France,0,1,0,1,1900
Prospère Bruggeman,Belgium,0,1,0,1,1900
Jules De Bisschop,Belgium,0,1,0,1,1900
Oscar De Cock,Belgium,0,1,0,1,1900
Oscar de Somville,Belgium,0,1,0,1,1900
Maurice Hemelsoet,Belgium,0,1,0,1,1900
Frank Odberg,Belgium,0,1,0,1,1900
Marcel Van Crombrugge,Belgium,0,1,0,1,1900
Alfred Van Landeghem,Belgium,0,1,0,1,1900
Maurice Verdonck,Belgium,0,1,0,1,1900
André Gaudin,France,0,1,0,1,1900
Georges Lumpp,France,0,1,0,1,1900
Lucien Martinet,France,0,1,0,1,1900
Charles Perrin,France,0,1,0,1,1900
Daniel Soubeyran,France,0,1,0,1,1900
René Waleff,France,0,1,0,1,1900
Émile Wegelin,France,0,1,0,1,1900
Coenraad Hiebendaal,Netherlands,0,1,0,1,1900
Geert Lotsij,Netherlands,0,1,0,1,1900
Paul Lotsij,Netherlands,0,1,0,1,1900
Johannes Terwogt,Netherlands,0,1,0,1,1900
Louis Dutfoy,France,0,1,0,1,1900
René Guyot,Belgium,0,1,0,1,1900
Jules Trinité,France,0,1,0,1,1900
Olaf Frydenlund,Norway,0,1,0,1,1900
Helmer Hermansen,Norway,0,1,0,1,1900
Ole Sæther,Norway,0,1,0,1,1900
Tom Seeberg,Norway,0,1,0,1,1900
Fernand Feyaerts,Belgium,0,1,0,1,1900
Victor Hochepied,France,0,1,0,1,1900
André Six,France,0,1,0,1,1900
Henri Cohen,Belgium,0,1,0,1,1900
Jean De Backer,Belgium,0,1,0,1,1900
Victor De Behr,Belgium,0,1,0,1,1900
Oscar Grégoire,Belgium,0,1,0,1,1900
Albert Michant,Belgium,0,1,0,1,1900
Victor Sonnemans,Belgium,0,1,0,1,1900
Joseph Bertrand,France,0,1,0,1,1900
Victor Cadet,France,0,1,0,1,1900
Maurice Hochepied,France,0,1,0,1,1900
Jules Verbecke,France,0,1,0,1,1900
Selwin Calverley,Great Britain,0,1,0,1,1900
"Jean, Duke Decazes",France,0,1,0,1,1900
Chris Hooijkaas,Netherlands,0,1,0,1,1900
Henri Smulders,Netherlands,0,1,0,1,1900
Arie van der Velden,Netherlands,0,1,0,1,1900
André Castanet,France,0,1,0,1,1900
Émile Champion,France,0,1,0,1,1900
Albert Champoudry,France,0,1,0,1,1900
Gaston Ragueneau,France,0,1,0,1,1900
Henri Tauzin,France,0,1,0,1,1900
František Janda-Suk,Bohemia,0,1,0,1,1900
Meredith Colket,United States,0,1,0,1,1900
James B. Connolly,United States,0,1,0,1,1900
John Cregan,United States,0,1,0,1,1900
Truxtun Hare,United States,0,1,0,1,1900
Bill Holland,United States,0,1,0,1,1900
John McLean,United States,0,1,0,1,1900
Léon Thome,France,0,1,0,1,1900
Alfred Bloch,France,0,1,0,1,1900
Guillaume Séron,Belgium,0,1,0,1,1900
Georges Romas,Belgium,0,1,0,1,1900
A. R. Upton,Belgium,0,1,0,1,1900
Francis Henríquez de Zubiria,Colombia,0,1,0,1,1900
Louis Martin,France,0,0,3,3,1900
Arthur Norris,Great Britain,0,0,2,2,1900
Frédèric Petit,France,0,0,2,2,1900
Hedwig Rosenbaum,Bohemia,0,0,2,2,1900
Marion Jones,United States,0,0,2,2,1900
Léon Sée,France,0,0,2,2,1900
Désiré Mérchez,France,0,0,2,2,1900
Bob Garrett,United States,0,0,2,2,1900
Lewis Sheldon,United States,0,0,2,2,1900
Guy de la Chapelle,France,0,0,1,1,1900
André Prévost,France,0,0,1,1,1900
Archibald Warden,France,0,0,1,1,1900
Émile Fisseux,France,0,0,1,1,1900
Louis Glineur,Belgium,0,0,1,1,1900
Émile Mercier,France,0,0,1,1,1900
Jacques de Prunelé,France,0,0,1,1,1900
Louis de Champsavin,France,0,0,1,1,1900
Robert de Montesquiou-Fézensac,France,0,0,1,1,1900
"Jean, Baron de Neuflize",France,0,0,1,1,1900
Auguste Daumain,France,0,0,1,1,1900
John Lake,United States,0,0,1,1,1900
Manuel Escandón,Mexico,0,0,1,1,1900
Eustaquio Escandón,Mexico,0,0,1,1,1900
Pablo Escandón,Mexico,0,0,1,1,1900
William Wright,United States,0,0,1,1,1900
Jacques Sautereau,France,0,0,1,1,1900
Robert Fournier-Sarlovèze,France,0,0,1,1,1900
Maurice Raoul-Duval,France,0,0,1,1,1900
Édouard de Rothschild,France,0,0,1,1,1900
David Robertson,Great Britain,0,0,1,1,1900
Abbie Pratt,France,0,0,1,1,1900
Fritz Flesch,Austria,0,0,1,1,1900
Milan Neralić,Austria,0,0,1,1,1900
Marcel Boulenger,France,0,0,1,1,1900
Henri Laurent,France,0,0,1,1,1900
Jean-Baptiste Mimiague,France,0,0,1,1,1900
Marius Delbecque,Belgium,0,0,1,1,1900
Raul Kelecom,Belgium,0,0,1,1,1900
Marcel Leboutte,Belgium,0,0,1,1,1900
Lucien Londot,Belgium,0,0,1,1,1900
Ernest Moreau de Melen,Belgium,0,0,1,1,1900
Eugène Neefs,Belgium,0,0,1,1,1900
Gustave Pelgrims,Belgium,0,0,1,1,1900
Alphonse Renier,Belgium,0,0,1,1,1900
Hilaire Spanoghe,Belgium,0,0,1,1,1900
Eric Thornton,Belgium,0,0,1,1,1900
Henk van Heuckelum,Belgium,0,0,1,1,1900
Lucien Démanet,France,0,0,1,1,1900
Carlos Deltour,France,0,0,1,1,1900
Paoli,France,0,0,1,1,1900
Antoine Védrenne,France,0,0,1,1,1900
St George Ashe,Great Britain,0,0,1,1,1900
Max Ammermann,Germany,0,0,1,1,1900
Wilhelm Carstens,Germany,0,0,1,1,1900
Ernst Felle,Germany,0,0,1,1,1900
Otto Fickeisen,Germany,0,0,1,1,1900
Franz Kröwerath,Germany,0,0,1,1,1900
Julius Körner,Germany,0,0,1,1,1900
Karl Lehle,Germany,0,0,1,1,1900
Adolf Möller,Germany,0,0,1,1,1900
Hugo Rüster,Germany,0,0,1,1,1900
Hermann Wilker,Germany,0,0,1,1,1900
Ruurd Leegstra,Netherlands,0,0,1,1,1900
Walter Meijer Timmerman Thijssen,Netherlands,0,0,1,1,1900
Walter Middelberg,Netherlands,0,0,1,1,1900
Hendrik Offerhaus,Netherlands,0,0,1,1,1900
Henricus Tromp,Netherlands,0,0,1,1,1900
Johannes van Dijk,Netherlands,0,0,1,1,1900
Charles Paumier du Vergier,Belgium,0,0,1,1,1900
Paul Van Asbroeck,Belgium,0,0,1,1,1900
Auguste Cavadini,France,0,0,1,1,1900
"Justinien, Count Clary",France,0,0,1,1,1900
René Thomas,France,0,0,1,1,1900
Antoine Bouwens,Netherlands,0,0,1,1,1900
Henrik Sillem,Netherlands,0,0,1,1,1900
Anthony Sweijs,Netherlands,0,0,1,1,1900
Solko van den Bergh,Netherlands,0,0,1,1,1900
Peder Lykkeberg,Denmark,0,0,1,1,1900
Bill Burgess,France,0,0,1,1,1900
Johannes Drost,Netherlands,0,0,1,1,1900
Auguste Camelin,France,0,0,1,1,1900
Jules Clévenot,France,0,0,1,1,1900
Eugène Coulon,France,0,0,1,1,1900
Alphonse Decuyper,France,0,0,1,1,1900
Fardel,France,0,0,1,1,1900
Pierre Gellé,France,0,0,1,1,1900
Louis Laufray,France,0,0,1,1,1900
Georges Leuillieux,France,0,0,1,1,1900
Louis Marc,France,0,0,1,1,1900
Henri Peslier,France,0,0,1,1,1900
Auguste Pesloy,France,0,0,1,1,1900
René Tartara,France,0,0,1,1,1900
Paul Vasseur,France,0,0,1,1,1900
Lucien Baudrier,France,0,0,1,1,1900
Gaston Cailleux,France,0,0,1,1,1900
de Cottignon,France,0,0,1,1,1900
Auguste Donny,France,0,0,1,1,1900
Dubosq,France,0,0,1,1,1900
Émile Jean-Fontaine,France,0,0,1,1,1900
H. MacHenry,United States,0,0,1,1,1900
Édouard Mantois,France,0,0,1,1,1900
Henri Monnot,France,0,0,1,1,1900
Ferdinand Schlatter,France,0,0,1,1,1900
Léon Tellier,France,0,0,1,1,1900
Harry Van Bergen,United States,0,0,1,1,1900
Ernst Schultz,Denmark,0,0,1,1,1900
Émile Torchebeuf,France,0,0,1,1,1900
Lajos Gönczy,Hungary,0,0,1,1,1900
Carl Albert Andersen,Norway,0,0,1,1,1900
Ernst Fast,Sweden,0,0,1,1,1900
John Bray,United States,0,0,1,1,1900
Dave Hall,United States,0,0,1,1,1900
Fred Moloney,United States,0,0,1,1,1900
Louis Trousselier,France,0,0,1,1,1900
Frederick Gill,France,0,0,1,1,1900
Gustav-Adolf Moths,Germany,0,0,1,1,1900
Dirk Boest Gips,Netherlands,0,0,1,1,1900
Antoine Fiolet,France,0,0,1,1,1900
Anton Heida,United States,5,1,0,6,1904
Marcus Hurley,United States,4,0,1,5,1904
George Eyser,United States,3,2,1,6,1904
Charlie Daniels,United States,3,1,1,5,1904
Jim Lightbody,United States,3,1,0,4,1904
Lida Howell,United States,3,0,0,3,1904
Ramón Fonst,Cuba,3,0,0,3,1904
Ray Ewry,United States,3,0,0,3,1904
Archie Hahn,United States,3,0,0,3,1904
Harry Hillman,United States,3,0,0,3,1904
Burton Downing,United States,2,3,1,6,1904
Albertson Van Zo Post,United States,2,1,2,5,1904
Julius Lenhart,Austria,2,1,0,3,1904
Phil Bryant,United States,2,0,1,3,1904
Emil Rausch,Germany,2,0,1,3,1904
Budd Goodwin,United States,2,0,1,3,1904
Beals Wright,United States,2,0,0,2,1904
Oliver Kirk,United States,2,0,0,2,1904
Manuel Díaz,Cuba,2,0,0,2,1904
Ed Hennig,United States,2,0,0,2,1904
Zoltán Halmay,Hungary,2,0,0,2,1904
Lou Handley,United States,2,0,0,2,1904
Meyer Prinstein,United States,2,0,0,2,1904
Joe Ruddy,United States,2,0,0,2,1904
Robert Williams,United States,1,2,0,3,1904
Ralph Rose,United States,1,1,1,3,1904
George Finnegan,United States,1,1,0,2,1904
Charles Mayer,United States,1,1,0,2,1904
Harry Spanjer,United States,1,1,0,2,1904
Chandler Egan,United States,1,1,0,2,1904
John Mulcahy,United States,1,1,0,2,1904
Bill Varley,United States,1,1,0,2,1904
Walter Brack,Germany,1,1,0,2,1904
Oscar Osthoff,United States,1,1,0,2,1904
John Flanagan,United States,1,1,0,2,1904
John Grieb,United States,1,1,0,2,1904
Howard Valentine,United States,1,1,0,2,1904
Eliza Pollock,United States,1,0,2,3,1904
Will Thompson,United States,1,0,2,3,1904
Arthur Newton,United States,1,0,2,3,1904
Edgar Leonard,United States,1,0,1,2,1904
Adolf Spinnler,Germany,1,0,1,2,1904
Georg Zacharias,Germany,1,0,1,2,1904
Leonie Taylor,United States,1,0,0,1,1904
Emily Woodruff,United States,1,0,0,1,1904
Louis Maxson,United States,1,0,0,1,1904
G. C. Spencer,United States,1,0,0,1,1904
Sam Berger,United States,1,0,0,1,1904
Al Young,United States,1,0,0,1,1904
George Lyon,Canada,1,0,0,1,1904
Charles Schlee,United States,1,0,0,1,1904
Élie Blanchard,Canada,1,0,0,1,1904
Billy Brennagh,Canada,1,0,0,1,1904
George Bretz,Canada,1,0,0,1,1904
Billy Burns,Canada,1,0,0,1,1904
George Cattanach,Canada,1,0,0,1,1904
George Cloutier,Canada,1,0,0,1,1904
Sandy Cowan,Canada,1,0,0,1,1904
Jack Flett,Canada,1,0,0,1,1904
Benjamin Jamieson,Canada,1,0,0,1,1904
Stuart Laidlaw,Canada,1,0,0,1,1904
Hilliard Lyle,Canada,1,0,0,1,1904
Lawrence Pentland,Canada,1,0,0,1,1904
Periklis Kakousis,Greece,1,0,0,1,1904
Ned Cummins,United States,1,0,0,1,1904
Ken Edwards,United States,1,0,0,1,1904
Walter Egan,United States,1,0,0,1,1904
Bob Hunter,United States,1,0,0,1,1904
Nat Moore,United States,1,0,0,1,1904
Mason Phelps,United States,1,0,0,1,1904
Ned Sawyer,United States,1,0,0,1,1904
Clement Smoot,United States,1,0,0,1,1904
Warren Wood,United States,1,0,0,1,1904
Sid Johnson,United States,1,0,0,1,1904
Sam Jones,United States,1,0,0,1,1904
Conrad Magnusson,United States,1,0,0,1,1904
Oscar Olson,United States,1,0,0,1,1904
Henry Seiling,United States,1,0,0,1,1904
George Ducker,Canada,1,0,0,1,1904
Jack Fraser,Canada,1,0,0,1,1904
John Gourlay,Canada,1,0,0,1,1904
Sandy Hall,Canada,1,0,0,1,1904
Albert Johnson,Canada,1,0,0,1,1904
Bobby Lane,Canada,1,0,0,1,1904
Ernest Linton,Canada,1,0,0,1,1904
Gordon McDonald,Canada,1,0,0,1,1904
Fred Steep,Canada,1,0,0,1,1904
Tom Taylor,Canada,1,0,0,1,1904
William Twaits,Canada,1,0,0,1,1904
Herman Glass,United States,1,0,0,1,1904
Max Hess,United States,1,0,0,1,1904
Philip Kassel,United States,1,0,0,1,1904
Ernst Reckeweg,United States,1,0,0,1,1904
Lou Abell,United States,1,0,0,1,1904
Charles Armstrong,United States,1,0,0,1,1904
Fred Cresser,United States,1,0,0,1,1904
Joe Dempsey,United States,1,0,0,1,1904
George Dietz,United States,1,0,0,1,1904
Gus Erker,United States,1,0,0,1,1904
"John Exley, Jr.",United States,1,0,0,1,1904
Robert Farnan,United States,1,0,0,1,1904
Jim Flanigan,United States,1,0,0,1,1904
Mike Gleason,United States,1,0,0,1,1904
Frank Greer,United States,1,0,0,1,1904
Hunter Lott,United States,1,0,0,1,1904
Al Nasse,United States,1,0,0,1,1904
Joseph Ryan,United States,1,0,0,1,1904
Frank Schell,United States,1,0,0,1,1904
Arthur Stockhoff,United States,1,0,0,1,1904
Billy Dickey,United States,1,0,0,1,1904
George Sheldon,United States,1,0,0,1,1904
Ben Bradshaw,United States,1,0,0,1,1904
Bob Curry,United States,1,0,0,1,1904
Charles Ericksen,Norway,1,0,0,1,1904
Bernhoff Hansen,Norway,1,0,0,1,1904
George Mehnert,United States,1,0,0,1,1904
Jack Niflot,United States,1,0,0,1,1904
Otto Roehm,United States,1,0,0,1,1904
Étienne Desmarteau,Canada,1,0,0,1,1904
Tom Kiely,Great Britain,1,0,0,1,1904
Charles Dvorak,United States,1,0,0,1,1904
Max Emmerich,United States,1,0,0,1,1904
Tom Hicks,United States,1,0,0,1,1904
David Munson,United States,1,0,0,1,1904
Paul Pilgrim,United States,1,0,0,1,1904
Fred Schule,United States,1,0,0,1,1904
Martin Sheridan,United States,1,0,0,1,1904
George Underwood,United States,1,0,0,1,1904
George Van Cleaf,United States,1,0,0,1,1904
Pat Flanagan,United States,1,0,0,1,1904
David Bratton,United States,1,0,0,1,1904
David Hesser,United States,1,0,0,1,1904
James Steen,United States,1,0,0,1,1904
Charles Jacobus,United States,1,0,0,1,1904
Otto Christman,Canada,1,0,0,1,1904
Red Henderson,Canada,1,0,0,1,1904
Frank Gailey,Australia,0,3,1,4,1904
Charles Tatham,United States,0,2,1,3,1904
Emma Cooke,United States,0,2,0,2,1904
Robert LeRoy,United States,0,2,0,2,1904
Georg Hoffmann,Germany,0,2,0,2,1904
David Hammond,United States,0,2,0,2,1904
Albert Corey,France,0,2,0,2,1904
Nate Cartmell,United States,0,2,0,2,1904
Con King,United States,0,2,0,2,1904
Bill Verner,United States,0,2,0,2,1904
Frank Waller,United States,0,2,0,2,1904
Bill Tuttle,United States,0,2,0,2,1904
William Merz,United States,0,1,4,5,1904
Teddy Billington,United States,0,1,3,4,1904
Franz Kugler,Germany,0,1,3,4,1904
Emil Voigt,United States,0,1,2,3,1904
Bill Hogenson,United States,0,1,2,3,1904
Alphonzo Bell,United States,0,1,1,2,1904
Joe Lydon,United States,0,1,1,2,1904
Arthur Andrews,United States,0,1,1,2,1904
George Wiley,United States,0,1,1,2,1904
Burt McKinnie,United States,0,1,1,2,1904
Frank Newton,United States,0,1,1,2,1904
William Grebe,United States,0,1,1,2,1904
Wilhelm Weber,Germany,0,1,1,2,1904
Charles Krause,United States,0,1,1,2,1904
Géza Kiss,Hungary,0,1,1,2,1904
Frank Kehoe,United States,0,1,1,2,1904
Scott Leary,United States,0,1,1,2,1904
Lacey Hearn,United States,0,1,1,2,1904
Joseph Stadler,United States,0,1,1,2,1904
William Clark,United States,0,1,0,1,1904
Samuel Duvall,United States,0,1,0,1,1904
Charles Hubbard,United States,0,1,0,1,1904
Charles Woodruff,United States,0,1,0,1,1904
Ralph McKittrick,United States,0,1,0,1,1904
Fred Semple,United States,0,1,0,1,1904
Miles Burke,United States,0,1,0,1,1904
Frank Haller,United States,0,1,0,1,1904
Ben Spradling,United States,0,1,0,1,1904
Russell Van Horn,United States,0,1,0,1,1904
Oscar Goerke,United States,0,1,0,1,1904
Jack Cady,United States,0,1,0,1,1904
Al Lambert,France,0,1,0,1,1904
John Maxwell,United States,0,1,0,1,1904
Harry Potter,United States,0,1,0,1,1904
Art Stickney,United States,0,1,0,1,1904
Stu Stickney,United States,0,1,0,1,1904
J. W. Dowling,United States,0,1,0,1,1904
W. R. Gibson,United States,0,1,0,1,1904
Patrick Grogan,United States,0,1,0,1,1904
Tom Hunter,United States,0,1,0,1,1904
William Murphy,United States,0,1,0,1,1904
William Partridge,United States,0,1,0,1,1904
George Passmore,United States,0,1,0,1,1904
William Passmore,United States,0,1,0,1,1904
W. J. Ross,United States,0,1,0,1,1904
Jack Sullivan,United States,0,1,0,1,1904
Albert Venn,United States,0,1,0,1,1904
A. M. Woods,United States,0,1,0,1,1904
Max Braun,United States,0,1,0,1,1904
Gus Rodenberg,United States,0,1,0,1,1904
Chuck Rose,United States,0,1,0,1,1904
William Seiling,United States,0,1,0,1,1904
Orin Upshaw,United States,0,1,0,1,1904
Arthur Fox,United States,0,1,0,1,1904
William Scott O'Connor,United States,0,1,0,1,1904
Fitzhugh Townsend,United States,0,1,0,1,1904
Charles Bartliff,United States,0,1,0,1,1904
Warren Brittingham,United States,0,1,0,1,1904
Oscar Brockmeyer,United States,0,1,0,1,1904
Alexander Cudmore,United States,0,1,0,1,1904
Charles January,United States,0,1,0,1,1904
John January,United States,0,1,0,1,1904
Tom January,United States,0,1,0,1,1904
Ray Lawler,United States,0,1,0,1,1904
Louis Menges,United States,0,1,0,1,1904
Peter Ratican,United States,0,1,0,1,1904
Emil Beyer,United States,0,1,0,1,1904
John Bissinger,United States,0,1,0,1,1904
Art Rosenkampff,United States,0,1,0,1,1904
Julian Schmitz,United States,0,1,0,1,1904
Otto Steffen,United States,0,1,0,1,1904
Max Wolf,United States,0,1,0,1,1904
Alan Bailey,Canada,0,1,0,1,1904
Phil Boyd,Canada,0,1,0,1,1904
Thomas Loudon,Canada,0,1,0,1,1904
Don MacKenzie,Canada,0,1,0,1,1904
Pat Reiffenstein,Canada,0,1,0,1,1904
Colonel Rice,Canada,0,1,0,1,1904
George Strange,Canada,0,1,0,1,1904
William Wadsworth,Canada,0,1,0,1,1904
"Joe Wright, Sr.",Canada,0,1,0,1,1904
Charles Aman,United States,0,1,0,1,1904
Mike Begley,United States,0,1,0,1,1904
Martin Formanack,United States,0,1,0,1,1904
John Hoben,United States,0,1,0,1,1904
Jim Juvenal,United States,0,1,0,1,1904
Joseph McLoughlin,United States,0,1,0,1,1904
Fred Suerig,United States,0,1,0,1,1904
Edgar Adams,United States,0,1,0,1,1904
Edwin Swatek,United States,0,1,0,1,1904
Ray Thorne,United States,0,1,0,1,1904
Fred Winter,United States,0,1,0,1,1904
Gustav Bauer,United States,0,1,0,1,1904
Bill Beckman,United States,0,1,0,1,1904
John Hein,United States,0,1,0,1,1904
Ted McLear,United States,0,1,0,1,1904
Rudolph Tesiny,United States,0,1,0,1,1904
Gus Wester,United States,0,1,0,1,1904
John Daly,Great Britain,0,1,0,1,1904
Frank Castleman,United States,0,1,0,1,1904
Wesley Coe,United States,0,1,0,1,1904
John DeWitt,United States,0,1,0,1,1904
Fred Engelhardt,United States,0,1,0,1,1904
Dan Frank,United States,0,1,0,1,1904
Adam Gunn,United States,0,1,0,1,1904
Sidney Hatch,United States,0,1,0,1,1904
LeRoy Samse,United States,0,1,0,1,1904
Garrett Serviss,United States,0,1,0,1,1904
Thad Shideler,United States,0,1,0,1,1904
Hugo Goetz,United States,0,1,0,1,1904
Rex Beach,United States,0,1,0,1,1904
Jerome Steever,United States,0,1,0,1,1904
Charles Healy,United States,0,1,0,1,1904
Smith Streeter,United States,0,1,0,1,1904
John Duha,United States,0,0,2,2,1904
Bill Orthwein,United States,0,0,2,2,1904
George Poage,United States,0,0,2,2,1904
Robert Stangland,United States,0,0,2,2,1904
Amedee Reyburn,United States,0,0,2,2,1904
Gwynne Evans,United States,0,0,2,2,1904
Wallace Bryant,United States,0,0,1,1,1904
Cyrus Dallin,United States,0,0,1,1,1904
Henry Richardson,United States,0,0,1,1,1904
Clarence Gamble,United States,0,0,1,1,1904
Joseph Wear,United States,0,0,1,1,1904
Arthur Wear,United States,0,0,1,1,1904
Allen West,United States,0,0,1,1,1904
Fred Gilmore,United States,0,0,1,1,1904
Bill Michaels,United States,0,0,1,1,1904
Peter Sturholdt,United States,0,0,1,1,1904
Almighty Voice,Canada,0,0,1,1,1904
Black Eagle,Canada,0,0,1,1,1904
Black Hawk,Canada,0,0,1,1,1904
Flat Iron,Canada,0,0,1,1,1904
Half Moon,Canada,0,0,1,1,1904
Lightfoot,Canada,0,0,1,1,1904
Man Afraid of the Soap,Canada,0,0,1,1,1904
Night Hawk,Canada,0,0,1,1,1904
Rain in Face,Canada,0,0,1,1,1904
Red Jacket,Canada,0,0,1,1,1904
Snake Eater,Canada,0,0,1,1,1904
Spotted Tail,Canada,0,0,1,1,1904
Doug Cadwallader,United States,0,0,1,1,1904
Lee Carleton,United States,0,0,1,1,1904
Harry Fraser,United States,0,0,1,1,1904
Art Hussey,United States,0,0,1,1,1904
Orus Jones,United States,0,0,1,1,1904
Allan Lard,United States,0,0,1,1,1904
George Oliver,United States,0,0,1,1,1904
Sim Price,United States,0,0,1,1,1904
John Rahm,United States,0,0,1,1,1904
Harry Weber,United States,0,0,1,1,1904
Lawrence Feuerbach,United States,0,0,1,1,1904
Oscar Friede,United States,0,0,1,1,1904
Charles Haberkorn,United States,0,0,1,1,1904
Harry Jacobs,United States,0,0,1,1,1904
Jim Mitchel,United States,0,0,1,1,1904
Charles Thias,United States,0,0,1,1,1904
Joseph Brady,United States,0,0,1,1,1904
George Cooke,United States,0,0,1,1,1904
Tom Cooke,United States,0,0,1,1,1904
Cormic Cosgrove,United States,0,0,1,1,1904
Edward Dierkes,United States,0,0,1,1,1904
Martin Dooling,United States,0,0,1,1,1904
Frank Frost,United States,0,0,1,1,1904
Claude Jameson,United States,0,0,1,1,1904
Henry Jameson,United States,0,0,1,1,1904
Johnson,United States,0,0,1,1,1904
Leo O'Connell,United States,0,0,1,1,1904
Harry Tate,United States,0,0,1,1,1904
George Mayer,United States,0,0,1,1,1904
Robert Maysack,United States,0,0,1,1,1904
Philip Schuster,United States,0,0,1,1,1904
Edward Siegler,United States,0,0,1,1,1904
Ralph Wilson,United States,0,0,1,1,1904
Joe Buerger,United States,0,0,1,1,1904
Frank Dummerth,United States,0,0,1,1,1904
John Freitag,United States,0,0,1,1,1904
Lou Heim,United States,0,0,1,1,1904
John Joachim,United States,0,0,1,1,1904
Joe Ravannack,United States,0,0,1,1,1904
Constance Titus,United States,0,0,1,1,1904
Gus Voerg,United States,0,0,1,1,1904
John Wells,United States,0,0,1,1,1904
Otto Wahle,Austria,0,0,1,1,1904
Jam Handy,United States,0,0,1,1,1904
John Meyers,United States,0,0,1,1,1904
Marquard Schwarz,United States,0,0,1,1,1904
Gus Goessling,United States,0,0,1,1,1904
Charles Clapper,United States,0,0,1,1,1904
William Nelson,United States,0,0,1,1,1904
Louis Strebler,United States,0,0,1,1,1904
Gustav Tiefenthaler,Switzerland,0,0,1,1,1904
Fred Warmbold,United States,0,0,1,1,1904
Jerry Winholtz,United States,0,0,1,1,1904
Al Zirkel,United States,0,0,1,1,1904
Paul Weinstein,Germany,0,0,1,1,1904
Nikolaos Georgantas,Greece,0,0,1,1,1904
Lesley Ashburner,United States,0,0,1,1,1904
John Biller,United States,0,0,1,1,1904
Emil Breitkreutz,United States,0,0,1,1,1904
Herman Groman,United States,0,0,1,1,1904
Truxtun Hare,United States,0,0,1,1,1904
Fay Moulton,United States,0,0,1,1,1904
Lawson Robertson,United States,0,0,1,1,1904
Lou Wilkins,United States,0,0,1,1,1904
Manfred Toeppen,United States,0,0,1,1,1904
Frank Schreiner,United States,0,0,1,1,1904
Charles Brown,United States,0,0,1,1,1904
Henry Taylor,Great Britain,3,0,0,3,1908
Mel Sheppard,United States,3,0,0,3,1908
Ben Jones,Great Britain,2,1,0,3,1908
Oscar Swahn,Sweden,2,0,1,3,1908
Martin Sheridan,United States,2,0,1,3,1908
Arthur Wentworth Gore,Great Britain,2,0,0,2,1908
Clarrie Kingsbury,Great Britain,2,0,0,2,1908
John Field-Richards,Great Britain,2,0,0,2,1908
Bernard Redwood,Great Britain,2,0,0,2,1908
Thomas Thornycroft,Great Britain,2,0,0,2,1908
Gaston Alibert,France,2,0,0,2,1908
Jenő Fuchs,Hungary,2,0,0,2,1908
Albert Helgerud,Norway,2,0,0,2,1908
Paul Radmilovic,Great Britain,2,0,0,2,1908
George Larner,Great Britain,2,0,0,2,1908
Eric Lemming,Sweden,2,0,0,2,1908
Ray Ewry,United States,2,0,0,2,1908
Josiah Ritchie,Great Britain,1,1,1,3,1908
Maurice Schillès,France,1,1,0,2,1908
Alexandre Lippmann,France,1,1,0,2,1908
John Fenning,Great Britain,1,1,0,2,1908
Gordon Thomson,Great Britain,1,1,0,2,1908
Paul Van Asbroeck,Belgium,1,1,0,2,1908
Walter Ewing,Canada,1,1,0,2,1908
Harry Humby,Great Britain,1,1,0,2,1908
Maurice Matthews,Great Britain,1,1,0,2,1908
Kellogg Casey,United States,1,1,0,2,1908
George de Relwyskow,Great Britain,1,1,0,2,1908
Arthur Robertson,Great Britain,1,1,0,2,1908
Harold Wilson,Great Britain,1,1,0,2,1908
André Auffray,France,1,0,1,2,1908
John Jacob Astor,Great Britain,1,0,1,2,1908
Evan Noel,Great Britain,1,0,1,2,1908
Eugène Olivier,France,1,0,1,2,1908
Edward Amoore,Great Britain,1,0,1,2,1908
Alexander Maunder,Great Britain,1,0,1,2,1908
Ole Sæther,Norway,1,0,1,2,1908
Jim Gorman,United States,1,0,1,2,1908
Charlie Daniels,United States,1,0,1,2,1908
Bobby Kerr,Canada,1,0,1,2,1908
Ned Barrett,Great Britain,1,0,1,2,1908
Norman Hallows,Great Britain,1,0,1,2,1908
Nate Cartmell,United States,1,0,1,2,1908
Madge Syers,Great Britain,1,0,1,2,1908
Gladys Eastlake-Smith,Great Britain,1,0,0,1,1908
Dorothy Lambert Chambers,Great Britain,1,0,0,1,1908
Roper Barrett,Great Britain,1,0,0,1,1908
Reggie Doherty,Great Britain,1,0,0,1,1908
George Hillyard,Great Britain,1,0,0,1,1908
Eugène Grisot,France,1,0,0,1,1908
Sybil Newall,Great Britain,1,0,0,1,1908
William Dod,Great Britain,1,0,0,1,1908
John Douglas,Great Britain,1,0,0,1,1908
Fred Grace,Great Britain,1,0,0,1,1908
Richard Gunn,Great Britain,1,0,0,1,1908
Albert Oldman,Great Britain,1,0,0,1,1908
Harry Thomas,Great Britain,1,0,0,1,1908
John Barnett,Australasia,1,0,0,1,1908
Bede Smith,Australasia,1,0,0,1,1908
Phil Carmichael,Australasia,1,0,0,1,1908
Dan Carroll,Australasia,1,0,0,1,1908
Bob Craig,Australasia,1,0,0,1,1908
Tom Griffin,Australasia,1,0,0,1,1908
Jack Hickey,Australasia,1,0,0,1,1908
Mannie McArthur,Australasia,1,0,0,1,1908
Arthur McCabe,Australasia,1,0,0,1,1908
Paddy McCue,Australasia,1,0,0,1,1908
Chris McKivat,Australasia,1,0,0,1,1908
Charles McMurtrie,Australasia,1,0,0,1,1908
Syd Middleton,Australasia,1,0,0,1,1908
Tom Richards,Australasia,1,0,0,1,1908
Charles Russell,Australasia,1,0,0,1,1908
Charles Bartlett,Great Britain,1,0,0,1,1908
Victor Johnson,Great Britain,1,0,0,1,1908
Leon Meredith,Great Britain,1,0,0,1,1908
Ernie Payne,Great Britain,1,0,0,1,1908
Paddy Brennan,Canada,1,0,0,1,1908
Jack Broderick,Canada,1,0,0,1,1908
Doc Campbell,Canada,1,0,0,1,1908
Gus Dillon,Canada,1,0,0,1,1908
Frank Dixon,Canada,1,0,0,1,1908
Richard Duckett,Canada,1,0,0,1,1908
Tom Gorman,Canada,1,0,0,1,1908
Ernie Hamilton,Canada,1,0,0,1,1908
Henny Hoobin,Canada,1,0,0,1,1908
Clary MacKerrow,Canada,1,0,0,1,1908
George Rennie,Canada,1,0,0,1,1908
Sandy Turnbull,Canada,1,0,0,1,1908
Émile Thubron,France,1,0,0,1,1908
Charles Miller,Great Britain,1,0,0,1,1908
George Miller,Great Britain,1,0,0,1,1908
Patteson Nickalls,Great Britain,1,0,0,1,1908
Herbert Wilson,Great Britain,1,0,0,1,1908
Vane Pennell,Great Britain,1,0,0,1,1908
Frederick Goodfellow,Great Britain,1,0,0,1,1908
William Hirons,Great Britain,1,0,0,1,1908
Frederick Humphreys,Great Britain,1,0,0,1,1908
Albert Ireton,Great Britain,1,0,0,1,1908
Frederick Merriman,Great Britain,1,0,0,1,1908
Edwin Mills,Great Britain,1,0,0,1,1908
James Shepherd,Great Britain,1,0,0,1,1908
Jay Gould,United States,1,0,0,1,1908
Louis Baillon,Great Britain,1,0,0,1,1908
Harry Freeman,Great Britain,1,0,0,1,1908
Eric Green,Great Britain,1,0,0,1,1908
Gerald Logan,Great Britain,1,0,0,1,1908
Alan Noble,Great Britain,1,0,0,1,1908
Edgar Page,Great Britain,1,0,0,1,1908
Reggie Pridmore,Great Britain,1,0,0,1,1908
Percy Rees,Great Britain,1,0,0,1,1908
John Robinson,Great Britain,1,0,0,1,1908
Stanley Shoveller,Great Britain,1,0,0,1,1908
Harvey Wood,Great Britain,1,0,0,1,1908
H. Georges Berger,France,1,0,0,1,1908
Charles Collignon,France,1,0,0,1,1908
Bernard Gravier,France,1,0,0,1,1908
Jean Stern,France,1,0,0,1,1908
Dezső Földes,Hungary,1,0,0,1,1908
Oszkár Gerde,Hungary,1,0,0,1,1908
Péter Tóth,Hungary,1,0,0,1,1908
Lajos Werkner,Hungary,1,0,0,1,1908
Horace Bailey,Great Britain,1,0,0,1,1908
Arthur Berry,Great Britain,1,0,0,1,1908
Frederick Chapman,Great Britain,1,0,0,1,1908
Walter Corbett,Great Britain,1,0,0,1,1908
Harold Hardman,Great Britain,1,0,0,1,1908
Bob Hawkes,Great Britain,1,0,0,1,1908
Kenneth Hunt,Great Britain,1,0,0,1,1908
Clyde Purnell,Great Britain,1,0,0,1,1908
Herbert Smith,Great Britain,1,0,0,1,1908
Harry Stapley,Great Britain,1,0,0,1,1908
Vivian Woodward,Great Britain,1,0,0,1,1908
Alberto Braglia,Italy,1,0,0,1,1908
Gösta Åsbrink,Sweden,1,0,0,1,1908
Carl Bertilsson,Sweden,1,0,0,1,1908
Hjalmar Cedercrona,Sweden,1,0,0,1,1908
Andreas Cervin,Sweden,1,0,0,1,1908
Rudolf Degermark,Sweden,1,0,0,1,1908
Carl Folcker,Sweden,1,0,0,1,1908
Sven Forssman,Sweden,1,0,0,1,1908
Erik Granfelt,Sweden,1,0,0,1,1908
Carl Hårleman,Sweden,1,0,0,1,1908
Arvid Holmberg,Sweden,1,0,0,1,1908
Carl Holmberg,Sweden,1,0,0,1,1908
Oswald Holmberg,Sweden,1,0,0,1,1908
Gunnar Höjer,Sweden,1,0,0,1,1908
Hugo Jahnke,Sweden,1,0,0,1,1908
Johan Jarlén,Sweden,1,0,0,1,1908
Gustaf Johnsson,Sweden,1,0,0,1,1908
Rolf Johnsson,Sweden,1,0,0,1,1908
Sven Landberg,Sweden,1,0,0,1,1908
Olle Lanner,Sweden,1,0,0,1,1908
Axel Ljung,Sweden,1,0,0,1,1908
Osvald Moberg,Sweden,1,0,0,1,1908
Carl Martin Norberg,Sweden,1,0,0,1,1908
Erik Norberg,Sweden,1,0,0,1,1908
Tor Norberg,Sweden,1,0,0,1,1908
Axel Norling,Sweden,1,0,0,1,1908
Daniel Norling,Sweden,1,0,0,1,1908
Gustaf Olson,Sweden,1,0,0,1,1908
Leonard Peterson,Sweden,1,0,0,1,1908
Sven Rosén,Sweden,1,0,0,1,1908
Gustaf Rosenquist,Sweden,1,0,0,1,1908
Axel Sjöblom,Sweden,1,0,0,1,1908
Karl-Johan Svensson,Sweden,1,0,0,1,1908
Birger Sörvik,Sweden,1,0,0,1,1908
Haakon Sörvik,Sweden,1,0,0,1,1908
Karl-Gustaf Vingqvist,Sweden,1,0,0,1,1908
Nils von Kantzow,Sweden,1,0,0,1,1908
Nils Widforss,Sweden,1,0,0,1,1908
Harry Blackstaffe,Great Britain,1,0,0,1,1908
Henry Bucknall,Great Britain,1,0,0,1,1908
Charles Burnell,Great Britain,1,0,0,1,1908
Robert Cudmore,Great Britain,1,0,0,1,1908
Raymond Etherington-Smith,Great Britain,1,0,0,1,1908
Angus Gillan,Great Britain,1,0,0,1,1908
Albert Gladstone,Great Britain,1,0,0,1,1908
Banner Johnstone,Great Britain,1,0,0,1,1908
Frederick Kelly,Great Britain,1,0,0,1,1908
Duncan Mackinnon,Great Britain,1,0,0,1,1908
Gilchrist Maclagan,Great Britain,1,0,0,1,1908
Guy Nickalls,Great Britain,1,0,0,1,1908
Ronald Sanderson,Great Britain,1,0,0,1,1908
Robert Somers-Smith,Great Britain,1,0,0,1,1908
Arthur Carnell,Great Britain,1,0,0,1,1908
Peter Easte,Great Britain,1,0,0,1,1908
John Fleming,Great Britain,1,0,0,1,1908
Joshua Millner,Great Britain,1,0,0,1,1908
Frank Moore,Great Britain,1,0,0,1,1908
Charles Palmer,Great Britain,1,0,0,1,1908
John Pike,Great Britain,1,0,0,1,1908
William Pimm,Great Britain,1,0,0,1,1908
John Postans,Great Britain,1,0,0,1,1908
William Styles,Great Britain,1,0,0,1,1908
Jul Braathe,Norway,1,0,0,1,1908
Einar Liberg,Norway,1,0,0,1,1908
Olaf Sæter,Norway,1,0,0,1,1908
Gudbrand Skatteboe,Norway,1,0,0,1,1908
Arvid Knöppel,Sweden,1,0,0,1,1908
Ernst Rosell,Sweden,1,0,0,1,1908
Alf Swahn,Sweden,1,0,0,1,1908
Charles Axtell,United States,1,0,0,1,1908
Sumner Benedict,United States,1,0,0,1,1908
Irving Calkins,United States,1,0,0,1,1908
John Dietz,United States,1,0,0,1,1908
Ivan Eastman,United States,1,0,0,1,1908
Bill Leushner,United States,1,0,0,1,1908
William Martin,United States,1,0,0,1,1908
Walter Winans,United States,1,0,0,1,1908
Charles Winder,United States,1,0,0,1,1908
Rob Derbyshire,Great Britain,1,0,0,1,1908
Willie Foster,Great Britain,1,0,0,1,1908
Fred Holman,Great Britain,1,0,0,1,1908
Arno Bieberstein,Germany,1,0,0,1,1908
Albert Zürner,Germany,1,0,0,1,1908
Hjalmar Johansson,Sweden,1,0,0,1,1908
George Cornet,Great Britain,1,0,0,1,1908
Eric Forsyth,Great Britain,1,0,0,1,1908
George Nevinson,Great Britain,1,0,0,1,1908
Charles Smith,Great Britain,1,0,0,1,1908
Tom Thould,Great Britain,1,0,0,1,1908
George Wilkinson,Great Britain,1,0,0,1,1908
Verner Weckman,Finland,1,0,0,1,1908
Stanley Bacon,Great Britain,1,0,0,1,1908
"Con O'Kelly, Sr.",Great Britain,1,0,0,1,1908
Richárd Weisz,Hungary,1,0,0,1,1908
Enrico Porro,Italy,1,0,0,1,1908
Frithiof Mårtensson,Sweden,1,0,0,1,1908
George Dole,United States,1,0,0,1,1908
George Mehnert,United States,1,0,0,1,1908
Frances Rivett-Carnac,Great Britain,1,0,0,1,1908
Robert Aspin,Great Britain,1,0,0,1,1908
Norman Bingley,Great Britain,1,0,0,1,1908
John Buchanan,Great Britain,1,0,0,1,1908
James Bunten,Great Britain,1,0,0,1,1908
Charles Campbell,Great Britain,1,0,0,1,1908
Blair Cochrane,Great Britain,1,0,0,1,1908
Charles Crichton,Great Britain,1,0,0,1,1908
Richard Dixon,Great Britain,1,0,0,1,1908
Arthur Downes,Great Britain,1,0,0,1,1908
Henry Downes,Great Britain,1,0,0,1,1908
David Dunlop,Great Britain,1,0,0,1,1908
Thomas Glen-Coats,Great Britain,1,0,0,1,1908
Gilbert Laws,Great Britain,1,0,0,1,1908
John Mackenzie,Great Britain,1,0,0,1,1908
Albert Martin,Great Britain,1,0,0,1,1908
Thomas McMeekin,Great Britain,1,0,0,1,1908
John Rhodes,Great Britain,1,0,0,1,1908
Charles Rivett-Carnac,Great Britain,1,0,0,1,1908
Henry Sutton,Great Britain,1,0,0,1,1908
Gerald Tait,Great Britain,1,0,0,1,1908
Arthur Wood,Great Britain,1,0,0,1,1908
Tim Ahearne,Great Britain,1,0,0,1,1908
William Coales,Great Britain,1,0,0,1,1908
Joe Deakin,Great Britain,1,0,0,1,1908
Wyndham Halswelle,Great Britain,1,0,0,1,1908
Arthur Russell,Great Britain,1,0,0,1,1908
Emil Voigt,Great Britain,1,0,0,1,1908
Reggie Walker,South Africa,1,0,0,1,1908
Charles Bacon,United States,1,0,0,1,1908
Ed Cook,United States,1,0,0,1,1908
John Flanagan,United States,1,0,0,1,1908
A. C. Gilbert,United States,1,0,0,1,1908
Frank Hamilton,United States,1,0,0,1,1908
Johnny Hayes,United States,1,0,0,1,1908
Frank Irons,United States,1,0,0,1,1908
Harry Porter,United States,1,0,0,1,1908
Ralph Rose,United States,1,0,0,1,1908
Forrest Smithson,United States,1,0,0,1,1908
John B. Taylor,United States,1,0,0,1,1908
Annie Hübler,Germany,1,0,0,1,1908
Heinrich Burger,Germany,1,0,0,1,1908
Nikolay Kolomenkin,Russian Federation,1,0,0,1,1908
Ulrich Salchow,Sweden,1,0,0,1,1908
Nils Hellsten,Sweden,1,0,0,1,1908
Ted Ranken,Great Britain,0,3,0,3,1908
George Caridia,Great Britain,0,2,0,2,1908
Réginald Storms,Belgium,0,2,0,2,1908
George Beattie,Canada,0,2,0,2,1908
Zoltán Halmay,Hungary,0,2,0,2,1908
Ernie Webb,Great Britain,0,2,0,2,1908
Kostas Tsiklitiras,Greece,0,2,0,2,1908
Karl Neumer,Germany,0,1,1,2,1908
Henry Leaf,Great Britain,0,1,1,2,1908
William Ellicott,Great Britain,0,1,1,2,1908
Frank Beaurepaire,Australasia,0,1,1,2,1908
Hanns Braun,Germany,0,1,1,2,1908
Arne Halse,Norway,0,1,1,2,1908
John Eisele,United States,0,1,1,2,1908
Johnny Garrels,United States,0,1,1,2,1908
Bill Horr,United States,0,1,1,2,1908
Dora Boothby,Great Britain,0,1,0,1,1908
Alice Greene,Great Britain,0,1,0,1,1908
James Parke,Great Britain,0,1,0,1,1908
George Simond,Great Britain,0,1,0,1,1908
Otto Froitzheim,Germany,0,1,0,1,1908
Louis Vernet,France,0,1,0,1,1908
Lottie Dod,Great Britain,0,1,0,1,1908
Reginald Brooks-King,Great Britain,0,1,0,1,1908
Johnny Condon,Great Britain,0,1,0,1,1908
Sid Evans,Great Britain,0,1,0,1,1908
Charlie Morris,Great Britain,0,1,0,1,1908
Fred Spiller,Great Britain,0,1,0,1,1908
Émile Demangel,France,0,1,0,1,1908
Charles Denny,Great Britain,0,1,0,1,1908
Max Goetze,Germany,0,1,0,1,1908
Frederick Hamlin,Great Britain,0,1,0,1,1908
Thomas Johnson,Great Britain,0,1,0,1,1908
Richard Katzer,Germany,0,1,0,1,1908
Hermann Martens,Germany,0,1,0,1,1908
Eustace Miles,Great Britain,0,1,0,1,1908
George Alexander,Great Britain,0,1,0,1,1908
George Buckland,Great Britain,0,1,0,1,1908
Eric Dutton,Great Britain,0,1,0,1,1908
Sydney Hayes,Great Britain,0,1,0,1,1908
Wilfrid Johnson,Great Britain,0,1,0,1,1908
Edward Jones,Great Britain,0,1,0,1,1908
Reginald Martin,Great Britain,0,1,0,1,1908
Gerald Mason,Great Britain,0,1,0,1,1908
Johnson Parker-Smith,Great Britain,0,1,0,1,1908
Hubert Ramsey,Great Britain,0,1,0,1,1908
Charles Scott,Great Britain,0,1,0,1,1908
Norman Whitley,Great Britain,0,1,0,1,1908
Walter Buckmaster,Great Britain,0,1,0,1,1908
Freddie Freake,Great Britain,0,1,0,1,1908
Walter Jones,Great Britain,0,1,0,1,1908
Hardress Lloyd,Great Britain,0,1,0,1,1908
John McCann,Great Britain,0,1,0,1,1908
Percy O'Reilly,Great Britain,0,1,0,1,1908
Auston Rotheram,Great Britain,0,1,0,1,1908
"Jack, Lord Wodehouse",Great Britain,0,1,0,1,1908
Cecil Browning,Great Britain,0,1,0,1,1908
Edmond Bury,Great Britain,0,1,0,1,1908
James Davey,Great Britain,0,1,0,1,1908
Frederick Dean,Great Britain,0,1,0,1,1908
Edward Jackett,Great Britain,0,1,0,1,1908
Dick Jackett,Great Britain,0,1,0,1,1908
E. J. Jones,Great Britain,0,1,0,1,1908
Jimmy Jose,Great Britain,0,1,0,1,1908
A. Lawry,Great Britain,0,1,0,1,1908
Charlie Marshall,Great Britain,0,1,0,1,1908
Barney Solomon,Great Britain,0,1,0,1,1908
Bert Solomon,Great Britain,0,1,0,1,1908
Nicholas Tregurtha,Great Britain,0,1,0,1,1908
John Trevaskis,Great Britain,0,1,0,1,1908
Thomas Wedge,Great Britain,0,1,0,1,1908
A. Willcocks,Great Britain,0,1,0,1,1908
Tom Butler,Great Britain,0,1,0,1,1908
Jim Clarke,Great Britain,0,1,0,1,1908
William Greggan,Great Britain,0,1,0,1,1908
Alexander Kidd,Great Britain,0,1,0,1,1908
Daniel Lowey,Great Britain,0,1,0,1,1908
Paddy Philbin,Great Britain,0,1,0,1,1908
George Smith,Great Britain,0,1,0,1,1908
Thomas Swindlehurst,Great Britain,0,1,0,1,1908
Percy Allman-Smith,Great Britain,0,1,0,1,1908
Henry Brown,Great Britain,0,1,0,1,1908
Walter Campbell,Great Britain,0,1,0,1,1908
William Graham,Great Britain,0,1,0,1,1908
Richard Gregg,Great Britain,0,1,0,1,1908
Edward Holmes,Great Britain,0,1,0,1,1908
Robert Kennedy,Great Britain,0,1,0,1,1908
Henry Murphy,Great Britain,0,1,0,1,1908
Walter Peterson,Great Britain,0,1,0,1,1908
Charles Power,Great Britain,0,1,0,1,1908
Franks Robinson,Great Britain,0,1,0,1,1908
Victor Boin,Belgium,0,1,0,1,1908
Edgar Amphlett,Great Britain,0,1,0,1,1908
Leaf Daniell,Great Britain,0,1,0,1,1908
Cecil Haig,Great Britain,0,1,0,1,1908
Martin Holt,Great Britain,0,1,0,1,1908
Robert Montgomerie,Great Britain,0,1,0,1,1908
Edgar Seligman,Great Britain,0,1,0,1,1908
Béla Zulawszky,Hungary,0,1,0,1,1908
Marcello Bertinetti,Italy,0,1,0,1,1908
Sante Ceccherini,Italy,0,1,0,1,1908
Riccardo Nowak,Italy,0,1,0,1,1908
Abelardo Olivier,Italy,0,1,0,1,1908
Alessandro Pirzio Biroli,Italy,0,1,0,1,1908
Marius Andersen,Denmark,0,1,0,1,1908
Harald Bohr,Denmark,0,1,0,1,1908
Ludwig Drescher,Denmark,0,1,0,1,1908
Harald Hansen,Denmark,0,1,0,1,1908
August Lindgren,Denmark,0,1,0,1,1908
Christian Middelboe,Denmark,0,1,0,1,1908
Nils Middelboe,Denmark,0,1,0,1,1908
Oscar Nielsen,Denmark,0,1,0,1,1908
Sofus Nielsen,Denmark,0,1,0,1,1908
Bjørn Rasmussen,Denmark,0,1,0,1,1908
Charles Buchwald,Denmark,0,1,0,1,1908
Vilhelm Wolfhagen,Denmark,0,1,0,1,1908
Walter Tysall,Great Britain,0,1,0,1,1908
Arthur Amundsen,Norway,0,1,0,1,1908
Otto Authén,Norway,0,1,0,1,1908
Herman Bohne,Norway,0,1,0,1,1908
Oskar Bye,Norway,0,1,0,1,1908
Trygve Bøyesen,Norway,0,1,0,1,1908
Sverre Grøner,Norway,0,1,0,1,1908
Harald Halvorsen,Norway,0,1,0,1,1908
Peter Hol,Norway,0,1,0,1,1908
Eugen Ingebretsen,Norway,0,1,0,1,1908
Ole Iversen,Norway,0,1,0,1,1908
Per Jespersen,Norway,0,1,0,1,1908
Sigurd Johannessen,Norway,0,1,0,1,1908
Nicolai Kiær,Norway,0,1,0,1,1908
Carl Klæth,Norway,0,1,0,1,1908
Thor Larsen,Norway,0,1,0,1,1908
Rolf Lefdahl,Norway,0,1,0,1,1908
Hans Lem,Norway,0,1,0,1,1908
Anders Moen,Norway,0,1,0,1,1908
Frithjof Olsen,Norway,0,1,0,1,1908
Carl Alfred Pedersen,Norway,0,1,0,1,1908
Paul Pedersen,Norway,0,1,0,1,1908
Sigvard Sivertsen,Norway,0,1,0,1,1908
John Skrataas,Norway,0,1,0,1,1908
Harald Smedvik,Norway,0,1,0,1,1908
Andreas Strand,Norway,0,1,0,1,1908
Olaf Syvertsen,Norway,0,1,0,1,1908
Thomas Thorstensen,Norway,0,1,0,1,1908
Oscar de Somville,Belgium,0,1,0,1,1908
Georges Mys,Belgium,0,1,0,1,1908
Marcel Morimont,Belgium,0,1,0,1,1908
Rémy Orban,Belgium,0,1,0,1,1908
Rodolphe Poma,Belgium,0,1,0,1,1908
Oscar Taelman,Belgium,0,1,0,1,1908
Alfred Van Landeghem,Belgium,0,1,0,1,1908
Polydore Veirman,Belgium,0,1,0,1,1908
François Vergucht,Belgium,0,1,0,1,1908
Harold Barker,Great Britain,0,1,0,1,1908
Eric Fairbairn,Great Britain,0,1,0,1,1908
Philip Filleul,Great Britain,0,1,0,1,1908
Alexander McCulloch,Great Britain,0,1,0,1,1908
Philip Verdon,Great Britain,0,1,0,1,1908
René Englebert,Belgium,0,1,0,1,1908
Charles Paumier du Vergier,Belgium,0,1,0,1,1908
Mylie Fletcher,Canada,0,1,0,1,1908
David McMackon,Canada,0,1,0,1,1908
George Vivian,Canada,0,1,0,1,1908
Arthur Westover,Canada,0,1,0,1,1908
Arthur Fulton,Great Britain,0,1,0,1,1908
Harold Hawkins,Great Britain,0,1,0,1,1908
William Lane-Joynt,Great Britain,0,1,0,1,1908
John Martin,Great Britain,0,1,0,1,1908
Charles Nix,Great Britain,0,1,0,1,1908
Harcourt Ommundsen,Great Britain,0,1,0,1,1908
Walter Padgett,Great Britain,0,1,0,1,1908
Philip Richardson,Great Britain,0,1,0,1,1908
Fleetwood Varley,Great Britain,0,1,0,1,1908
Arthur Wilson,Great Britain,0,1,0,1,1908
Per-Olof Arvidsson,Sweden,0,1,0,1,1908
Eric Carlberg,Sweden,0,1,0,1,1908
Vilhelm Carlberg,Sweden,0,1,0,1,1908
Janne Gustafsson,Sweden,0,1,0,1,1908
Axel Jansson,Sweden,0,1,0,1,1908
Gustaf Adolf Jonsson,Sweden,0,1,0,1,1908
Claës Rundberg,Sweden,0,1,0,1,1908
Frans-Albert Schartau,Sweden,0,1,0,1,1908
Gustav-Adolf Sjöberg,Sweden,0,1,0,1,1908
Hübner von Holst,Sweden,0,1,0,1,1908
Harry Simon,United States,0,1,0,1,1908
Snowy Baker,Australasia,0,1,0,1,1908
Fernand Feyaerts,Belgium,0,1,0,1,1908
Herman Meyboom,Belgium,0,1,0,1,1908
Ludvig Dam,Denmark,0,1,0,1,1908
Sydney Battersby,Great Britain,0,1,0,1,1908
William Robinson,Great Britain,0,1,0,1,1908
Kurt Behrens,Germany,0,1,0,1,1908
Béla Las-Torres,Hungary,0,1,0,1,1908
József Munk,Hungary,0,1,0,1,1908
Imre Zachár,Hungary,0,1,0,1,1908
Karl Malmström,Sweden,0,1,0,1,1908
Herman Donners,Belgium,0,1,0,1,1908
Oscar Grégoire,Belgium,0,1,0,1,1908
Albert Michant,Belgium,0,1,0,1,1908
Joseph Pletincx,Belgium,0,1,0,1,1908
Yrjö Saarela,Finland,0,1,0,1,1908
William Press,Great Britain,0,1,0,1,1908
John Slim,Great Britain,0,1,0,1,1908
William Wood,Great Britain,0,1,0,1,1908
Jacob Gundersen,Norway,0,1,0,1,1908
Nikolay Orlov,Russian Federation,0,1,0,1,1908
Aleksandr Petrov,Russian Federation,0,1,0,1,1908
Mauritz Andersson,Sweden,0,1,0,1,1908
James Baxter,Great Britain,0,1,0,1,1908
William Davidson,Great Britain,0,1,0,1,1908
J. A. Gardiner,Great Britain,0,1,0,1,1908
Carl Hellström,Sweden,0,1,0,1,1908
Léon Huybrechts,Belgium,0,1,0,1,1908
Louis Huybrechts,Belgium,0,1,0,1,1908
John Jellico,Great Britain,0,1,0,1,1908
J. Graham Kenion,Great Britain,0,1,0,1,1908
Thomas Littledale,Great Britain,0,1,0,1,1908
Charles MacIver,Great Britain,0,1,0,1,1908
Charles R. MacIver,Great Britain,0,1,0,1,1908
Colin McLeod Robertson,Great Britain,0,1,0,1,1908
Eric Sandberg,Sweden,0,1,0,1,1908
James Spence,Great Britain,0,1,0,1,1908
Edmund Thormählen,Sweden,0,1,0,1,1908
Erik Wallerius,Sweden,0,1,0,1,1908
Harald Wallin,Sweden,0,1,0,1,1908
Henri Weewauters,Belgium,0,1,0,1,1908
Garfield MacDonald,Canada,0,1,0,1,1908
Johannes Gandil,Denmark,0,1,0,1,1908
Géo André,France,0,1,0,1,1908
Denis Horgan,Great Britain,0,1,0,1,1908
Con Leahy,Great Britain,0,1,0,1,1908
Eddie Owen,Great Britain,0,1,0,1,1908
Hans Eicke,Germany,0,1,0,1,1908
Arthur Hoffmann,Germany,0,1,0,1,1908
Otto Trieloff,Germany,0,1,0,1,1908
Mikhail Dorizas,Greece,0,1,0,1,1908
István Somodi,Hungary,0,1,0,1,1908
Emilio Lunghi,Italy,0,1,0,1,1908
Carl Albert Andersen,Norway,0,1,0,1,1908
Conrad Carlsrud,Norway,0,1,0,1,1908
Charles Hefferon,South Africa,0,1,0,1,1908
John Biller,United States,0,1,0,1,1908
George Bonhag,United States,0,1,0,1,1908
Bobby Cloughen,United States,0,1,0,1,1908
Harvey Cohn,United States,0,1,0,1,1908
Gayle Dull,United States,0,1,0,1,1908
Merritt Giffin,United States,0,1,0,1,1908
Harry Hillman,United States,0,1,0,1,1908
Dan Kelly,United States,0,1,0,1,1908
Matt McGrath,United States,0,1,0,1,1908
James Rector,United States,0,1,0,1,1908
Herb Trube,United States,0,1,0,1,1908
Harald Hansen,Norway,0,1,0,1,1908
Jack Peterson,Great Britain,0,1,0,1,1908
Phyllis Johnson,Great Britain,0,1,0,1,1908
Elsa Rendschmidt,Germany,0,1,0,1,1908
Arthur Cumming,Great Britain,0,1,0,1,1908
Richard Johansson,Sweden,0,1,0,1,1908
James Johnson,Great Britain,0,1,0,1,1908
"Vilém Goppold z Lobsdorfu, Sr.",Bohemia,0,0,2,2,1908
Gordon Balfour,Canada,0,0,2,2,1908
Becher Gale,Canada,0,0,2,2,1908
Charles Riddy,Canada,0,0,2,2,1908
Geoffrey Taylor,Canada,0,0,2,2,1908
Harald Julin,Sweden,0,0,2,2,1908
Pontus Hanson,Sweden,0,0,2,2,1908
Ruth Winch,Great Britain,0,0,1,1,1908
Clement Cazalet,Great Britain,0,0,1,1,1908
Charles Dixon,Great Britain,0,0,1,1,1908
Wilberforce Eaves,Great Britain,0,0,1,1,1908
Gustave Cabaret,France,0,0,1,1,1908
Beatrice Hill-Lowe,Great Britain,0,0,1,1,1908
Henry Richardson,United States,0,0,1,1,1908
Märtha Adlerstråhle,Sweden,0,0,1,1,1908
Wollmar Boström,Sweden,0,0,1,1,1908
Gunnar Setterwall,Sweden,0,0,1,1,1908
Harry Johnson,Great Britain,0,0,1,1,1908
Frank Parks,Great Britain,0,0,1,1,1908
William Philo,Great Britain,0,0,1,1,1908
Hugh Roddin,Great Britain,0,0,1,1,1908
Wally Webb,Great Britain,0,0,1,1,1908
Will Anderson,Canada,0,0,1,1,1908
Walt Andrews,Canada,0,0,1,1,1908
Charlie Brooks,Great Britain,0,0,1,1,1908
William Isaacs,Great Britain,0,0,1,1,1908
Octave Lapize,France,0,0,1,1,1908
Fred McCarthy,Canada,0,0,1,1,1908
William Morton,Canada,0,0,1,1,1908
Joseph Werbrouck,Belgium,0,0,1,1,1908
Neville Lytton,Great Britain,0,0,1,1,1908
Henry Brougham,Great Britain,0,0,1,1,1908
Walter Chaffe,Great Britain,0,0,1,1,1908
Joseph Dowler,Great Britain,0,0,1,1,1908
Ernest Ebbage,Great Britain,0,0,1,1,1908
Thomas Homewood,Great Britain,0,0,1,1,1908
Alexander Munro,Great Britain,0,0,1,1,1908
Willie Slade,Great Britain,0,0,1,1,1908
Walter Tammas,Great Britain,0,0,1,1,1908
James Woodget,Great Britain,0,0,1,1,1908
Alexander Burt,Great Britain,0,0,1,1,1908
John Burt,Great Britain,0,0,1,1,1908
Frank Connah,Great Britain,0,0,1,1,1908
Alastair Denniston,Great Britain,0,0,1,1,1908
Llewellyn Evans,Great Britain,0,0,1,1,1908
Charles Foulkes,Great Britain,0,0,1,1,1908
Hew Fraser,Great Britain,0,0,1,1,1908
James Harper-Orr,Great Britain,0,0,1,1,1908
Ivan Laing,Great Britain,0,0,1,1,1908
Arthur Law,Great Britain,0,0,1,1,1908
Robert Lyne,Great Britain,0,0,1,1,1908
Hugh Neilson,Great Britain,0,0,1,1,1908
William Orchardson,Great Britain,0,0,1,1,1908
Wilfred Pallot,Great Britain,0,0,1,1,1908
Frederick Phillips,Great Britain,0,0,1,1,1908
Edwin Richards,Great Britain,0,0,1,1,1908
Charles Shepherd,Great Britain,0,0,1,1,1908
Norman Stevenson,Great Britain,0,0,1,1,1908
Bertrand Turnbull,Great Britain,0,0,1,1,1908
Philip Turnbull,Great Britain,0,0,1,1,1908
Hugh Walker,Great Britain,0,0,1,1,1908
Ralph Williams,Great Britain,0,0,1,1,1908
Paul Anspach,Belgium,0,0,1,1,1908
Désiré Beaurain,Belgium,0,0,1,1,1908
Fernand Bosmans,Belgium,0,0,1,1,1908
Fernand de Montigny,Belgium,0,0,1,1,1908
Ferdinand Feyerick,Belgium,0,0,1,1,1908
François Rom,Belgium,0,0,1,1,1908
Victor Willems,Belgium,0,0,1,1,1908
Otakar Lada,Bohemia,0,0,1,1,1908
Vlastimil Lada-Sázavský,Bohemia,0,0,1,1,1908
Bedřich Schejbal,Bohemia,0,0,1,1,1908
Léon Lécuyer,France,0,0,1,1,1908
Jaroslav Tuček,Bohemia,0,0,1,1,1908
Reinier Beeuwkes,Netherlands,0,0,1,1,1908
Frans de Bruijn Kops,Netherlands,0,0,1,1,1908
Bok de Korver,Netherlands,0,0,1,1,1908
Karel Heijting,Netherlands,0,0,1,1,1908
Jan Kok,Netherlands,0,0,1,1,1908
Miel Mundt,Netherlands,0,0,1,1,1908
Lou Otten,Netherlands,0,0,1,1,1908
Jops Reeman,Netherlands,0,0,1,1,1908
Edu Snethlage,Netherlands,0,0,1,1,1908
Eetje Sol,Netherlands,0,0,1,1,1908
Jan Thomée,Netherlands,0,0,1,1,1908
Caius Welcker,Netherlands,0,0,1,1,1908
Eino Forsström,Finland,0,0,1,1,1908
Otto Granström,Finland,0,0,1,1,1908
Iivari Kyykoski,Finland,0,0,1,1,1908
Heikki Lehmusto,Finland,0,0,1,1,1908
John Lindroth,Finland,0,0,1,1,1908
Yrjö Linko,Finland,0,0,1,1,1908
Edvard Linna,Finland,0,0,1,1,1908
Matti Markkanen,Finland,0,0,1,1,1908
Kalle Mikkolainen,Finland,0,0,1,1,1908
Arvi Pohjanpää,Finland,0,0,1,1,1908
Aarne Pohjonen,Finland,0,0,1,1,1908
Kalle Kustaa Paasia,Finland,0,0,1,1,1908
Eino Railio,Finland,0,0,1,1,1908
Ale Riipinen,Finland,0,0,1,1,1908
Einar Sahlstein,Finland,0,0,1,1,1908
Torsten Sandelin,Finland,0,0,1,1,1908
Elis Sipilä,Finland,0,0,1,1,1908
Viktor Smeds,Finland,0,0,1,1,1908
Kaarlo Soinio,Finland,0,0,1,1,1908
Kurt Stenberg,Finland,0,0,1,1,1908
Arno Saarinen,Finland,0,0,1,1,1908
Väinö Tiiri,Finland,0,0,1,1,1908
Magnus Wegelius,Finland,0,0,1,1,1908
Louis Ségura,France,0,0,1,1,1908
Norway Jackes,Canada,0,0,1,1,1908
Douglas Kertland,Canada,0,0,1,1,1908
Walter Lewis,Canada,0,0,1,1,1908
Irvine Robertson,Canada,0,0,1,1,1908
Julius Thomson,Canada,0,0,1,1,1908
Frederick Toms,Canada,0,0,1,1,1908
"Joe Wright, Sr.",Canada,0,0,1,1,1908
Richard Boyle,Great Britain,0,0,1,1,1908
John Burn,Great Britain,0,0,1,1,1908
Waldo Carver,Great Britain,0,0,1,1,1908
Henry Goldsmith,Great Britain,0,0,1,1,1908
Frank Jerwood,Great Britain,0,0,1,1,1908
Harold Kitching,Great Britain,0,0,1,1,1908
Eric Powell,Great Britain,0,0,1,1,1908
Douglas Stuart,Great Britain,0,0,1,1,1908
Edward Williams,Great Britain,0,0,1,1,1908
Willy Düskow,Germany,0,0,1,1,1908
Martin Stahnke,Germany,0,0,1,1,1908
Bernhard von Gaza,Germany,0,0,1,1,1908
Károly Levitzky,Hungary,0,0,1,1,1908
Johan Burk,Netherlands,0,0,1,1,1908
Bernardus Croon,Netherlands,0,0,1,1,1908
Hermannus Höfte,Netherlands,0,0,1,1,1908
Albertus Wielsma,Netherlands,0,0,1,1,1908
Charles Crowe,Canada,0,0,1,1,1908
William Eastcott,Canada,0,0,1,1,1908
Harry Kerr,Canada,0,0,1,1,1908
Dugald McInnes,Canada,0,0,1,1,1908
William Smith,Canada,0,0,1,1,1908
Bruce Williams,Canada,0,0,1,1,1908
Veli Nieminen,Finland,0,0,1,1,1908
Eugène Balme,France,0,0,1,1,1908
Henri Bonnefoy,France,0,0,1,1,1908
Paul Colas,France,0,0,1,1,1908
Albert Courquin,France,0,0,1,1,1908
"Raoul, Count de Boigne",France,0,0,1,1,1908
Léon Johnson,France,0,0,1,1,1908
Maurice Lecoq,France,0,0,1,1,1908
André Parmentier,France,0,0,1,1,1908
André Regaud,France,0,0,1,1,1908
George Barnes,Great Britain,0,0,1,1,1908
Maurice Blood,Great Britain,0,0,1,1,1908
John Butt,Great Britain,0,0,1,1,1908
Geoffrey Coles,Great Britain,0,0,1,1,1908
Harold Creasey,Great Britain,0,0,1,1,1908
Bob Hutton,Great Britain,0,0,1,1,1908
Henry Lynch-Staunton,Great Britain,0,0,1,1,1908
William Marsden,Great Britain,0,0,1,1,1908
William Morris,Great Britain,0,0,1,1,1908
Alexander Rogers,Great Britain,0,0,1,1,1908
George Skinner,Great Britain,0,0,1,1,1908
Jesse Wallingford,Great Britain,0,0,1,1,1908
George Whitaker,Great Britain,0,0,1,1,1908
Anastasios Metaxas,Greece,0,0,1,1,1908
Otto Scheff,Austria,0,0,1,1,1908
Bert Haresnape,Great Britain,0,0,1,1,1908
Gottlob Walz,Germany,0,0,1,1,1908
Robert Andersson,Sweden,0,0,1,1,1908
Axel Runström,Sweden,0,0,1,1,1908
Arvid Spångberg,Sweden,0,0,1,1,1908
Gunnar Wennerström,Sweden,0,0,1,1,1908
George Gaidzik,United States,0,0,1,1,1908
Budd Goodwin,United States,0,0,1,1,1908
Harry Hebner,United States,0,0,1,1,1908
Leslie Rich,United States,0,0,1,1,1908
Erik Bergvall,Sweden,0,0,1,1,1908
Torsten Kumfeldt,Sweden,0,0,1,1,1908
Aubert Côté,Canada,0,0,1,1,1908
Anders Andersen,Denmark,0,0,1,1,1908
Carl Jensen,Denmark,0,0,1,1,1908
Søren Jensen,Denmark,0,0,1,1,1908
Arvo Lindén,Finland,0,0,1,1,1908
Fred Beck,Great Britain,0,0,1,1,1908
Arthur Gingell,Great Britain,0,0,1,1,1908
William McKie,Great Britain,0,0,1,1,1908
Henri Arthus,France,0,0,1,1,1908
Collingwood Hughes,Great Britain,0,0,1,1,1908
Frederick Hughes,Great Britain,0,0,1,1,1908
Philip Hunloke,Great Britain,0,0,1,1,1908
Louis Potheau,France,0,0,1,1,1908
Pierre Rabot,France,0,0,1,1,1908
George Ratsey,Great Britain,0,0,1,1,1908
William Ward,Great Britain,0,0,1,1,1908
Harry Kerr,Australasia,0,0,1,1,1908
Ed Archibald,Canada,0,0,1,1,1908
Cal Bricker,Canada,0,0,1,1,1908
Con Walsh,Canada,0,0,1,1,1908
Verner Järvinen,Finland,0,0,1,1,1908
Johan Kemp,Finland,0,0,1,1,1908
Aarne Salovaara,Finland,0,0,1,1,1908
Jean Bouin,France,0,0,1,1,1908
Louis Bonniot de Fleurac,France,0,0,1,1,1908
Joseph Dréher,France,0,0,1,1,1908
Alexandre Fayollat,France,0,0,1,1,1908
Paul Lizandier,France,0,0,1,1,1908
Edward Spencer,Great Britain,0,0,1,1,1908
Jimmy Tremeer,Great Britain,0,0,1,1,1908
Ödön Bodor,Hungary,0,0,1,1,1908
Frigyes Wiesner-Mezei,Hungary,0,0,1,1,1908
József Nagy,Hungary,0,0,1,1,1908
Pál Simon,Hungary,0,0,1,1,1908
Edvard Larsen,Norway,0,0,1,1,1908
Otto Nilsson,Sweden,0,0,1,1,1908
John Svanberg,Sweden,0,0,1,1,1908
Bruno Söderström,Sweden,0,0,1,1,1908
Joe Forshaw,United States,0,0,1,1,1908
Clare Jacobs,United States,0,0,1,1,1908
Art Shaw,United States,0,0,1,1,1908
Dorothy Greenhough-Smith,Great Britain,0,0,1,1,1908
Geoffrey Hall-Say,Great Britain,0,0,1,1,1908
Edgar Syers,Great Britain,0,0,1,1,1908
Per Thorén,Sweden,0,0,1,1,1908
Vilhelm Carlberg,Sweden,3,2,0,5,1912
Hannes Kolehmainen,Finland,3,1,0,4,1912
Al Lane,United States,3,0,0,3,1912
Eric Carlberg,Sweden,2,2,0,4,1912
Hübner von Holst,Sweden,2,1,1,4,1912
Åke Lundeberg,Sweden,2,1,0,3,1912
André Gobert,France,2,0,0,2,1912
Edith Hannam,Great Britain,2,0,0,2,1912
Charles Winslow,South Africa,2,0,0,2,1912
Axel Nordlander,Sweden,2,0,0,2,1912
Paul Anspach,Belgium,2,0,0,2,1912
Jenő Fuchs,Hungary,2,0,0,2,1912
Alberto Braglia,Italy,2,0,0,2,1912
Paul Colas,France,2,0,0,2,1912
Alf Swahn,Sweden,2,0,0,2,1912
Jay Graham,United States,2,0,0,2,1912
George Hodgson,Canada,2,0,0,2,1912
Walter Bathe,Germany,2,0,0,2,1912
Erik Adlerz,Sweden,2,0,0,2,1912
Ralph Craig,United States,2,0,0,2,1912
Armas Taipale,Finland,2,0,0,2,1912
Ted Meredith,United States,2,0,0,2,1912
Charles Reidpath,United States,2,0,0,2,1912
Jim Thorpe,United States,2,0,0,2,1912
Carl Osburn,United States,1,2,1,4,1912
Charles Dixon,Great Britain,1,1,1,3,1912
Jacques Cariou,France,1,1,1,3,1912
Dora Köring,Germany,1,1,0,2,1912
Harry Kitson,South Africa,1,1,0,2,1912
Joseph Pepe,Great Britain,1,1,0,2,1912
William Pimm,Great Britain,1,1,0,2,1912
Paul Palén,Sweden,1,1,0,2,1912
Peter Dolfen,United States,1,1,0,2,1912
Walter Winans,United States,1,1,0,2,1912
Cecil Healy,Australasia,1,1,0,2,1912
Harry Hebner,United States,1,1,0,2,1912
Duke Kahanamoku,United States,1,1,0,2,1912
Julius Saaristo,Finland,1,1,0,2,1912
Hjalmar Andersson,Sweden,1,1,0,2,1912
Bror Fock,Sweden,1,1,0,2,1912
Platt Adams,United States,1,1,0,2,1912
Abel Kiviat,United States,1,1,0,2,1912
Pat McDonald,United States,1,1,0,2,1912
Ralph Rose,United States,1,1,0,2,1912
Mel Sheppard,United States,1,1,0,2,1912
Fred Hird,United States,1,0,2,3,1912
Warren Sprout,United States,1,0,2,3,1912
Harold Hardwick,Australasia,1,0,2,3,1912
Marguerite Broquedis-Billout,France,1,0,1,2,1912
Ervin Mészáros,Hungary,1,0,1,2,1912
Serafino Mazzarocchi,Italy,1,0,1,2,1912
Carl Björkman,Sweden,1,0,1,2,1912
Mauritz Eriksson,Sweden,1,0,1,2,1912
Hugo Johansson,Sweden,1,0,1,2,1912
Bernhard Larsson,Sweden,1,0,1,2,1912
Oscar Swahn,Sweden,1,0,1,2,1912
John Jackson,United States,1,0,1,2,1912
Jennie Fletcher,Great Britain,1,0,1,2,1912
Willie Applegarth,Great Britain,1,0,1,2,1912
Kostas Tsiklitiras,Greece,1,0,1,2,1912
John Eke,Sweden,1,0,1,2,1912
Ed Lindberg,United States,1,0,1,2,1912
Norm Taber,United States,1,0,1,2,1912
Maurice Germot,France,1,0,0,1,1912
Heinrich Schomburgk,Germany,1,0,0,1,1912
Nils Adlercreutz,Sweden,1,0,0,1,1912
"Carl, Count Bonde",Sweden,1,0,0,1,1912
Ernst Casparsson,Sweden,1,0,0,1,1912
Henric Horn af Åminne,Sweden,1,0,0,1,1912
Gustaf Kilman,Sweden,1,0,0,1,1912
Fredrik Rosencrantz,Sweden,1,0,0,1,1912
Hans von Rosen,Sweden,1,0,0,1,1912
Gunnar Björk,Sweden,1,0,0,1,1912
Alex Ekström,Sweden,1,0,0,1,1912
Erik Friborg,Sweden,1,0,0,1,1912
Werner Karlsson,Sweden,1,0,0,1,1912
Josef Landsberg,Sweden,1,0,0,1,1912
Hjalmar Levin,Sweden,1,0,0,1,1912
Rudolph Lewis,South Africa,1,0,0,1,1912
Carl Lundquist,Sweden,1,0,0,1,1912
Algot Lönn,Sweden,1,0,0,1,1912
Ragnar Malm,Sweden,1,0,0,1,1912
Henrik Morén,Sweden,1,0,0,1,1912
Axel Wilhelm Persson,Sweden,1,0,0,1,1912
Arvid Pettersson,Sweden,1,0,0,1,1912
Arvid Andersson,Sweden,1,0,0,1,1912
Adolf Bergman,Sweden,1,0,0,1,1912
Johan Edman,Sweden,1,0,0,1,1912
Erik Fredriksson,Sweden,1,0,0,1,1912
August Gustafsson,Sweden,1,0,0,1,1912
Carl Jonsson,Sweden,1,0,0,1,1912
Erik Larsson,Sweden,1,0,0,1,1912
Herbert Lindström,Sweden,1,0,0,1,1912
Henri Anspach,Belgium,1,0,0,1,1912
Robert Hennet,Belgium,1,0,0,1,1912
Jacques Ochs,Belgium,1,0,0,1,1912
Gaston Salmon,Belgium,1,0,0,1,1912
Victor Willems,Belgium,1,0,0,1,1912
László Berti,Hungary,1,0,0,1,1912
Dezső Földes,Hungary,1,0,0,1,1912
Oszkár Gerde,Hungary,1,0,0,1,1912
Zoltán Schenker,Hungary,1,0,0,1,1912
Péter Tóth,Hungary,1,0,0,1,1912
Lajos Werkner,Hungary,1,0,0,1,1912
Nedo Nadi,Italy,1,0,0,1,1912
Arthur Berry,Great Britain,1,0,0,1,1912
Ronald Brebner,Great Britain,1,0,0,1,1912
Tommy Burn,Great Britain,1,0,0,1,1912
Joe Dines,Great Britain,1,0,0,1,1912
Ted Hanney,Great Britain,1,0,0,1,1912
Gordon Hoare,Great Britain,1,0,0,1,1912
Arthur Knight,Great Britain,1,0,0,1,1912
Harry Littlewort,Great Britain,1,0,0,1,1912
Douglas McWhirter,Great Britain,1,0,0,1,1912
Ivor Sharpe,Great Britain,1,0,0,1,1912
Harry Stamper,Great Britain,1,0,0,1,1912
Harold Walden,Great Britain,1,0,0,1,1912
Vivian Woodward,Great Britain,1,0,0,1,1912
Edward Wright,Great Britain,1,0,0,1,1912
Pietro Bianchi,Italy,1,0,0,1,1912
Guido Boni,Italy,1,0,0,1,1912
Giuseppe Domenichelli,Italy,1,0,0,1,1912
Carlo Fregosi,Italy,1,0,0,1,1912
Alfredo Gollini,Italy,1,0,0,1,1912
Francesco Loy,Italy,1,0,0,1,1912
Luigi Maiocco,Italy,1,0,0,1,1912
Giovanni Mangiante,Italy,1,0,0,1,1912
Renzo Mangiante,Italy,1,0,0,1,1912
Guido Romano,Italy,1,0,0,1,1912
Paolo Salvi,Italy,1,0,0,1,1912
Luciano Savorini,Italy,1,0,0,1,1912
Adolfo Tunesi,Italy,1,0,0,1,1912
Giorgio Zampori,Italy,1,0,0,1,1912
Umberto Zanolini,Italy,1,0,0,1,1912
Angelo Zorzi,Italy,1,0,0,1,1912
Isak Abrahamsen,Norway,1,0,0,1,1912
Hans Beyer,Norway,1,0,0,1,1912
Hartman Bjørnson,Norway,1,0,0,1,1912
Alfred Engelsen,Norway,1,0,0,1,1912
Bjarne Johnsen,Norway,1,0,0,1,1912
Sigurd Jørgensen,Norway,1,0,0,1,1912
Knud Knudsen,Norway,1,0,0,1,1912
Alf Lie,Norway,1,0,0,1,1912
Rolf Lie,Norway,1,0,0,1,1912
Tor Lund,Norway,1,0,0,1,1912
Petter Martinsen,Norway,1,0,0,1,1912
Per Mathisen,Norway,1,0,0,1,1912
Jacob Opdahl,Norway,1,0,0,1,1912
Nils Opdahl,Norway,1,0,0,1,1912
Bjarne Pettersen,Norway,1,0,0,1,1912
Robert Sjursen,Norway,1,0,0,1,1912
Frithjof Sælen,Norway,1,0,0,1,1912
Øistein Schirmer,Norway,1,0,0,1,1912
Georg Selenius,Norway,1,0,0,1,1912
Sigvard Sivertsen,Norway,1,0,0,1,1912
Einar Strøm,Norway,1,0,0,1,1912
Gabriel Thorstensen,Norway,1,0,0,1,1912
Thomas Thorstensen,Norway,1,0,0,1,1912
Nils Voss,Norway,1,0,0,1,1912
Per Bertilsson,Sweden,1,0,0,1,1912
Carl Ehrenfried Carlberg,Sweden,1,0,0,1,1912
Nils Granfelt,Sweden,1,0,0,1,1912
Curt Hartzell,Sweden,1,0,0,1,1912
Oswald Holmberg,Sweden,1,0,0,1,1912
Anders Hylander,Sweden,1,0,0,1,1912
Axel Janse,Sweden,1,0,0,1,1912
Boo Kullberg,Sweden,1,0,0,1,1912
Sven Landberg,Sweden,1,0,0,1,1912
Per Nilsson,Sweden,1,0,0,1,1912
Benkt Norelius,Sweden,1,0,0,1,1912
Axel Norling,Sweden,1,0,0,1,1912
Daniel Norling,Sweden,1,0,0,1,1912
Sven Rosén,Sweden,1,0,0,1,1912
Nils Silfverskiöld,Sweden,1,0,0,1,1912
Carl Silfverstrand,Sweden,1,0,0,1,1912
Yngve Stiernspetz,Sweden,1,0,0,1,1912
Karl-Erik Svensson,Sweden,1,0,0,1,1912
Karl-Johan Svensson,Sweden,1,0,0,1,1912
John Sörenson,Sweden,1,0,0,1,1912
Knut Torell,Sweden,1,0,0,1,1912
Edvard Wennerholm,Sweden,1,0,0,1,1912
Claës-Axel Wersäll,Sweden,1,0,0,1,1912
David Wiman,Sweden,1,0,0,1,1912
Gustaf Lewenhaupt,Sweden,1,0,0,1,1912
Gösta Lilliehöök,Sweden,1,0,0,1,1912
Ejler Allert,Denmark,1,0,0,1,1912
Christian Hansen,Denmark,1,0,0,1,1912
Poul Hartmann,Denmark,1,0,0,1,1912
Carl Møller,Denmark,1,0,0,1,1912
Carl Pedersen,Denmark,1,0,0,1,1912
Edgar Burgess,Great Britain,1,0,0,1,1912
Philip Fleming,Great Britain,1,0,0,1,1912
Stanley Garton,Great Britain,1,0,0,1,1912
Angus Gillan,Great Britain,1,0,0,1,1912
Ewart Horsfall,Great Britain,1,0,0,1,1912
Wally Kinnear,Great Britain,1,0,0,1,1912
Alister Kirby,Great Britain,1,0,0,1,1912
Sidney Swann,Great Britain,1,0,0,1,1912
Henry Wells,Great Britain,1,0,0,1,1912
Leslie Wormald,Great Britain,1,0,0,1,1912
Albert Arnheiter,Germany,1,0,0,1,1912
Otto Fickeisen,Germany,1,0,0,1,1912
Rudolf Fickeisen,Germany,1,0,0,1,1912
Otto Maier,Germany,1,0,0,1,1912
Hermann Wilker,Germany,1,0,0,1,1912
Edward Lessimore,Great Britain,1,0,0,1,1912
Bob Murray,Great Britain,1,0,0,1,1912
Sándor Prokopp,Hungary,1,0,0,1,1912
Per-Olof Arvidsson,Sweden,1,0,0,1,1912
Erik Blomqvist,Sweden,1,0,0,1,1912
Gustaf Boivie,Sweden,1,0,0,1,1912
Gustaf Adolf Jonsson,Sweden,1,0,0,1,1912
Harry Adams,United States,1,0,0,1,1912
Charles Billings,United States,1,0,0,1,1912
Allan Briggs,United States,1,0,0,1,1912
Cornelius Burdette,United States,1,0,0,1,1912
John Dietz,United States,1,0,0,1,1912
Edward Gleason,United States,1,0,0,1,1912
Frank Hall,United States,1,0,0,1,1912
John Hendrickson,United States,1,0,0,1,1912
Harry Sears,United States,1,0,0,1,1912
Ralph Spotts,United States,1,0,0,1,1912
Fanny Durack,Australasia,1,0,0,1,1912
Les Boardman,Australasia,1,0,0,1,1912
Malcolm Champion,Australasia,1,0,0,1,1912
Isabella Moore,Great Britain,1,0,0,1,1912
Annie Speirs,Great Britain,1,0,0,1,1912
Irene Steer,Great Britain,1,0,0,1,1912
Paul Günther,Germany,1,0,0,1,1912
Greta Johansson,Sweden,1,0,0,1,1912
Isaac Bentham,Great Britain,1,0,0,1,1912
Charles Bugbee,Great Britain,1,0,0,1,1912
George Cornet,Great Britain,1,0,0,1,1912
Arthur Hill,Great Britain,1,0,0,1,1912
Paul Radmilovic,Great Britain,1,0,0,1,1912
Charles Smith,Great Britain,1,0,0,1,1912
George Wilkinson,Great Britain,1,0,0,1,1912
Kaarlo Koskelo,Finland,1,0,0,1,1912
Yrjö Saarela,Finland,1,0,0,1,1912
Emil Väre,Finland,1,0,0,1,1912
Claes Johanson,Sweden,1,0,0,1,1912
Johan Anker,Norway,1,0,0,1,1912
Nils Berthelsen,Norway,1,0,0,1,1912
Andreas Brecke,Norway,1,0,0,1,1912
Torleiv Corneliussen,Norway,1,0,0,1,1912
Filip Ericson,Sweden,1,0,0,1,1912
Eilert Falch-Lund,Norway,1,0,0,1,1912
Thoralf Glad,Norway,1,0,0,1,1912
Halfdan Hansen,Norway,1,0,0,1,1912
Arnfinn Heje,Norway,1,0,0,1,1912
Carl Hellström,Sweden,1,0,0,1,1912
Paul Isberg,Sweden,1,0,0,1,1912
Christian Jebe,Norway,1,0,0,1,1912
Magnus Konow,Norway,1,0,0,1,1912
Alfred Larsen,Norway,1,0,0,1,1912
Petter Larsen,Norway,1,0,0,1,1912
Herman Nyberg,Sweden,1,0,0,1,1912
Harry Rosenswärd,Sweden,1,0,0,1,1912
Fritz Staib,Norway,1,0,0,1,1912
Gustav Thaulow,Norway,1,0,0,1,1912
Amédée Thubé,France,1,0,0,1,1912
Gaston Thubé,France,1,0,0,1,1912
Jacques Thubé,France,1,0,0,1,1912
Erik Wallerius,Sweden,1,0,0,1,1912
Harald Wallin,Sweden,1,0,0,1,1912
Valentin Aas,Norway,1,0,0,1,1912
George Goulding,Canada,1,0,0,1,1912
Vic d'Arcy,Great Britain,1,0,0,1,1912
Arnold Jackson,Great Britain,1,0,0,1,1912
David Jacobs,Great Britain,1,0,0,1,1912
Henry Macintosh,Great Britain,1,0,0,1,1912
Ferdinand Bie,Norway,1,0,0,1,1912
Ken McArthur,South Africa,1,0,0,1,1912
Gustaf Carlén,Sweden,1,0,0,1,1912
Edvin Hellgren,Sweden,1,0,0,1,1912
John Klintberg,Sweden,1,0,0,1,1912
Brynolf Larsson,Sweden,1,0,0,1,1912
Eric Lemming,Sweden,1,0,0,1,1912
Axel Lindahl,Sweden,1,0,0,1,1912
Topsy Lindblom,Sweden,1,0,0,1,1912
Klas Lundström,Sweden,1,0,0,1,1912
Henrik Nordström,Sweden,1,0,0,1,1912
Johan Sundkvist,Sweden,1,0,0,1,1912
Josef Ternström,Sweden,1,0,0,1,1912
Hugo Wieslander,Sweden,1,0,0,1,1912
Harry Babcock,United States,1,0,0,1,1912
Tell Berna,United States,1,0,0,1,1912
George Bonhag,United States,1,0,0,1,1912
Albert Gutterson,United States,1,0,0,1,1912
Fred Kelly,United States,1,0,0,1,1912
Matt McGrath,United States,1,0,0,1,1912
Alma Richards,United States,1,0,0,1,1912
Louis Scott,United States,1,0,0,1,1912
Humbert Lundén,Sweden,1,0,0,1,1912
"Pierre, Baron de Coubertin",France,1,0,0,1,1912
Richard Barthélemy,Italy,1,0,0,1,1912
Carlo Pellegrini,Italy,1,0,0,1,1912
Alphonse Laverrière,Switzerland,1,0,0,1,1912
Eugène-Édouard Monod,Switzerland,1,0,0,1,1912
Gunnar Setterwall,Sweden,0,2,1,3,1912
Jack Hatfield,Great Britain,0,2,1,3,1912
Harry von Rochow,Germany,0,2,0,2,1912
Freddie Grubb,Great Britain,0,2,0,2,1912
William Milne,Great Britain,0,2,0,2,1912
Bill Leushner,United States,0,1,2,3,1912
Sigrid Fick,Sweden,0,1,1,2,1912
Richard Verderber,Austria,0,1,1,2,1912
Lars Jørgen Madsen,Denmark,0,1,1,2,1912
Alfred Goeldel-Bronikoven,Germany,0,1,1,2,1912
Georg de Laval,Sweden,0,1,1,2,1912
Neil McDonnell,United States,0,1,1,2,1912
Ken Huszagh,United States,0,1,1,2,1912
Elmer Niklander,Finland,0,1,1,2,1912
Albin Stenroos,Finland,0,1,1,2,1912
Georg Åberg,Sweden,0,1,1,2,1912
Ben Adams,United States,0,1,1,2,1912
Donald Lippincott,United States,0,1,1,2,1912
Helen Aitchison,Great Britain,0,1,0,1,1912
Roper Barrett,Great Britain,0,1,0,1,1912
Fritz Felix Piepes,Austria,0,1,0,1,1912
Arthur Zborzil,Austria,0,1,0,1,1912
Sofie Castenschiold,Denmark,0,1,0,1,1912
Carl Kempe,Sweden,0,1,0,1,1912
"Gustaf Adolf Boltenstern, Sr.",Sweden,0,1,0,1,1912
Pierre Dufour d'Astafort,France,0,1,0,1,1912
Ernest Meyer,France,0,1,0,1,1912
Gaston Seigner,France,0,1,0,1,1912
Rabod Wilhelm von Kröcher,Germany,0,1,0,1,1912
Eduard von Lütcken,Germany,0,1,0,1,1912
Carl von Moers,Germany,0,1,0,1,1912
"Richard, Count von Schaesberg-Thannheim",Germany,0,1,0,1,1912
Charlie Davey,Great Britain,0,1,0,1,1912
Bert Gayler,Great Britain,0,1,0,1,1912
Arthur Gibbon,Great Britain,0,1,0,1,1912
Bill Hammond,Great Britain,0,1,0,1,1912
Francis Higgins,Great Britain,0,1,0,1,1912
Stanley Jones,Great Britain,0,1,0,1,1912
John Kirk,Great Britain,0,1,0,1,1912
Leon Meredith,Great Britain,0,1,0,1,1912
Ernie Merlin,Great Britain,0,1,0,1,1912
Charlie Moss,Great Britain,0,1,0,1,1912
Arthur Stokes,Great Britain,0,1,0,1,1912
Walter Chaffe,Great Britain,0,1,0,1,1912
Joseph Dowler,Great Britain,0,1,0,1,1912
Frederick Humphreys,Great Britain,0,1,0,1,1912
Matt Hynes,Great Britain,0,1,0,1,1912
Edwin Mills,Great Britain,0,1,0,1,1912
Alexander Munro,Great Britain,0,1,0,1,1912
John Sewell,Great Britain,0,1,0,1,1912
James Shepherd,Great Britain,0,1,0,1,1912
Rudolf Cvetko,Austria,0,1,0,1,1912
Friedrich Golling,Austria,0,1,0,1,1912
Otto Herschmann,Austria,0,1,0,1,1912
Andreas Suttner,Austria,0,1,0,1,1912
Reinhold Trampler,Austria,0,1,0,1,1912
Ivan Osiier,Denmark,0,1,0,1,1912
Percy Davson,Great Britain,0,1,0,1,1912
Arthur Everitt,Great Britain,0,1,0,1,1912
Martin Holt,Great Britain,0,1,0,1,1912
Sydney Martineau,Great Britain,0,1,0,1,1912
Robert Montgomerie,Great Britain,0,1,0,1,1912
Edgar Seligman,Great Britain,0,1,0,1,1912
Béla Békessy,Hungary,0,1,0,1,1912
Albert Bogen,Austria,0,1,0,1,1912
Pietro Speciale,Italy,0,1,0,1,1912
Paul Berth,Denmark,0,1,0,1,1912
Hjalmar Christoffersen,Denmark,0,1,0,1,1912
Harald Hansen,Denmark,0,1,0,1,1912
Sofus Hansen,Denmark,0,1,0,1,1912
Emil Jørgensen,Denmark,0,1,0,1,1912
Nils Middelboe,Denmark,0,1,0,1,1912
Oscar Nielsen,Denmark,0,1,0,1,1912
Poul Nielsen,Denmark,0,1,0,1,1912
Sofus Nielsen,Denmark,0,1,0,1,1912
Anton Olsen,Denmark,0,1,0,1,1912
Axel Petersen,Denmark,0,1,0,1,1912
Ivar Lykke,Denmark,0,1,0,1,1912
Axel Tufvesson,Denmark,0,1,0,1,1912
Charles Buchwald,Denmark,0,1,0,1,1912
Vilhelm Wolfhagen,Denmark,0,1,0,1,1912
Peter Villemoes Andersen,Denmark,0,1,0,1,1912
Valdemar Bøggild,Denmark,0,1,0,1,1912
Søren Peter Christensen,Denmark,0,1,0,1,1912
Ingvald Eriksen,Denmark,0,1,0,1,1912
George Falcke,Denmark,0,1,0,1,1912
Torkild Garp,Denmark,0,1,0,1,1912
Hans Trier Hansen,Denmark,0,1,0,1,1912
Johannes Hansen,Denmark,0,1,0,1,1912
Rasmus Hansen,Denmark,0,1,0,1,1912
Jens Kristian Jensen,Denmark,0,1,0,1,1912
Alfred Jensen,Denmark,0,1,0,1,1912
Karl Kirk,Denmark,0,1,0,1,1912
Jens Kirkegaard,Denmark,0,1,0,1,1912
Olaf Kjems,Denmark,0,1,0,1,1912
Carl Otto Laurits Larsen,Denmark,0,1,0,1,1912
Jens Peter Martinus Laursen,Denmark,0,1,0,1,1912
Marius Lefevre,Denmark,0,1,0,1,1912
Poul Mark,Denmark,0,1,0,1,1912
Einar Olsen,Denmark,0,1,0,1,1912
Hans Pedersen,Denmark,0,1,0,1,1912
Hans Eiler Pedersen,Denmark,0,1,0,1,1912
Olaf Pedersen,Denmark,0,1,0,1,1912
Peder Pedersen,Denmark,0,1,0,1,1912
Aksel Sørensen,Denmark,0,1,0,1,1912
Søren Thorborg,Denmark,0,1,0,1,1912
Kristen Vadgaard,Denmark,0,1,0,1,1912
Johannes Vinther,Denmark,0,1,0,1,1912
Kalle Ekholm,Finland,0,1,0,1,1912
Eino Forsström,Finland,0,1,0,1,1912
Eero Hyvärinen,Finland,0,1,0,1,1912
Mikko Hyvärinen,Finland,0,1,0,1,1912
Ilmari Keinänen,Finland,0,1,0,1,1912
Jalmari Kivenheimo,Finland,0,1,0,1,1912
Karl Lund,Finland,0,1,0,1,1912
Aarne Pelkonen,Finland,0,1,0,1,1912
Ilmari Pernaja,Finland,0,1,0,1,1912
Arvid Rydman,Finland,0,1,0,1,1912
Heikki Sammallahti,Finland,0,1,0,1,1912
Hannes Sirola,Finland,0,1,0,1,1912
Klaus Suomela,Finland,0,1,0,1,1912
Eino Saastamoinen,Finland,0,1,0,1,1912
Lauri Tanner,Finland,0,1,0,1,1912
Väinö Tiiri,Finland,0,1,0,1,1912
Kalle Vasama,Finland,0,1,0,1,1912
Kaarlo Vähämäki,Finland,0,1,0,1,1912
Louis Ségura,France,0,1,0,1,1912
Lajos Aradi,Hungary,0,1,0,1,1912
József Berkes,Hungary,0,1,0,1,1912
Imre Erdődy,Hungary,0,1,0,1,1912
Imre Gellért,Hungary,0,1,0,1,1912
Győző Halmos,Hungary,0,1,0,1,1912
Ottó Hellmich,Hungary,0,1,0,1,1912
István Herczeg,Hungary,0,1,0,1,1912
József Keresztessy,Hungary,0,1,0,1,1912
János Krizmanich,Hungary,0,1,0,1,1912
Elemér Pászti,Hungary,0,1,0,1,1912
Árpád Pédery,Hungary,0,1,0,1,1912
Jenő Réti,Hungary,0,1,0,1,1912
Ferenc Szűts,Hungary,0,1,0,1,1912
Ödön Téry,Hungary,0,1,0,1,1912
Géza Tuli,Hungary,0,1,0,1,1912
Gösta Åsbrink,Sweden,0,1,0,1,1912
Polydore Veirman,Belgium,0,1,0,1,1912
Julius Beresford,Great Britain,0,1,0,1,1912
Robert Bourne,Great Britain,0,1,0,1,1912
Beaufort Burdekin,Great Britain,0,1,0,1,1912
Geoffrey Carr,Great Britain,0,1,0,1,1912
William Fison,Great Britain,0,1,0,1,1912
Thomas Gillespie,Great Britain,0,1,0,1,1912
Charles Littlejohn,Great Britain,0,1,0,1,1912
Bruce Logan,Great Britain,0,1,0,1,1912
William Parker,Great Britain,0,1,0,1,1912
Frederick Pitman,Great Britain,0,1,0,1,1912
Charles Rought,Great Britain,0,1,0,1,1912
Karl Vernon,Great Britain,0,1,0,1,1912
John Walker,Great Britain,0,1,0,1,1912
Arthur Wiggins,Great Britain,0,1,0,1,1912
William Bruhn-Möller,Sweden,0,1,0,1,1912
Konrad Brunkman,Sweden,0,1,0,1,1912
Herman Dahlbäck,Sweden,0,1,0,1,1912
Ture Rosvall,Sweden,0,1,0,1,1912
Leo Wilkens,Sweden,0,1,0,1,1912
Henry Burr,Great Britain,0,1,0,1,1912
John Butt,Great Britain,0,1,0,1,1912
Arthur Fulton,Great Britain,0,1,0,1,1912
William Grosvenor,Great Britain,0,1,0,1,1912
Harry Humby,Great Britain,0,1,0,1,1912
Alexander Maunder,Great Britain,0,1,0,1,1912
Harcourt Ommundsen,Great Britain,0,1,0,1,1912
Charles Palmer,Great Britain,0,1,0,1,1912
Edward Parnell,Great Britain,0,1,0,1,1912
James Reid,Great Britain,0,1,0,1,1912
Edward Skilton,Great Britain,0,1,0,1,1912
William Styles,Great Britain,0,1,0,1,1912
George Whitaker,Great Britain,0,1,0,1,1912
Albert Helgerud,Norway,0,1,0,1,1912
Einar Liberg,Norway,0,1,0,1,1912
Olaf Sæter,Norway,0,1,0,1,1912
Ole Sæther,Norway,0,1,0,1,1912
Gudbrand Skatteboe,Norway,0,1,0,1,1912
Østen Østensen,Norway,0,1,0,1,1912
Amos Kash,Russian Federation,0,1,0,1,1912
Nikolay Melnitsky,Russian Federation,0,1,0,1,1912
Georgy Panteleymonov,Russian Federation,0,1,0,1,1912
Pavel Voyloshnikov,Russian Federation,0,1,0,1,1912
Edward Benedicks,Sweden,0,1,0,1,1912
Erik Boström,Sweden,0,1,0,1,1912
Arthur Nordenswan,Sweden,0,1,0,1,1912
Ruben Örtegren,Sweden,0,1,0,1,1912
Bill Libbey,United States,0,1,0,1,1912
Mina Wylie,Australasia,0,1,0,1,1912
Tauno Ilmoniemi,Finland,0,1,0,1,1912
Wally Dressel,Germany,0,1,0,1,1912
Louise Otto,Germany,0,1,0,1,1912
Grete Rosenberg,Germany,0,1,0,1,1912
Hermine Stindt,Germany,0,1,0,1,1912
Otto Fahr,Germany,0,1,0,1,1912
Willy Lützow,Germany,0,1,0,1,1912
Hans Luber,Germany,0,1,0,1,1912
Albert Zürner,Germany,0,1,0,1,1912
Lisa Regnell,Sweden,0,1,0,1,1912
Robert Andersson,Sweden,0,1,0,1,1912
Wille Andersson,Sweden,0,1,0,1,1912
Max Gumpel,Sweden,0,1,0,1,1912
Thor Henning,Sweden,0,1,0,1,1912
Hjalmar Johansson,Sweden,0,1,0,1,1912
Harald Julin,Sweden,0,1,0,1,1912
Perry McGillivray,United States,0,1,0,1,1912
Erik Bergqvist,Sweden,0,1,0,1,1912
Pontus Hanson,Sweden,0,1,0,1,1912
Torsten Kumfeldt,Sweden,0,1,0,1,1912
Ivar Böhling,Finland,0,1,0,1,1912
Johan Olin,Finland,0,1,0,1,1912
Georg Gerstacker,Germany,0,1,0,1,1912
Martin Klein,Estonia,0,1,0,1,1912
Anders Ahlgren,Sweden,0,1,0,1,1912
Gustaf Malmström,Sweden,0,1,0,1,1912
Per Bergman,Sweden,0,1,0,1,1912
Dick Bergström,Sweden,0,1,0,1,1912
Kurt Bergström,Sweden,0,1,0,1,1912
Waldemar Björkstén,Finland,0,1,0,1,1912
Jacob Björnström,Finland,0,1,0,1,1912
Bror Brenner,Finland,0,1,0,1,1912
Allan Franck,Finland,0,1,0,1,1912
Emil Henriques,Sweden,0,1,0,1,1912
Steen Herschend,Denmark,0,1,0,1,1912
Bengt Heyman,Sweden,0,1,0,1,1912
Folke Johnson,Sweden,0,1,0,1,1912
Ivan Lamby,Sweden,0,1,0,1,1912
Erik Lindh,Finland,0,1,0,1,1912
Erik Lindqvist,Sweden,0,1,0,1,1912
Hans Meulengracht Madsen,Denmark,0,1,0,1,1912
Juho Aarne Pekkalainen,Finland,0,1,0,1,1912
Nils Persson,Sweden,0,1,0,1,1912
Alvar Thiel,Sweden,0,1,0,1,1912
Svenn Thomsen,Denmark,0,1,0,1,1912
Harry Wahl,Finland,0,1,0,1,1912
Nils Westermark,Sweden,0,1,0,1,1912
Herbert Westermark,Sweden,0,1,0,1,1912
Cal Bricker,Canada,0,1,0,1,1912
Duncan Gillis,Canada,0,1,0,1,1912
Lauri Eskola,Finland,0,1,0,1,1912
Efraim Harju,Finland,0,1,0,1,1912
Väinö Heikkilä,Finland,0,1,0,1,1912
Viljam Johansson,Finland,0,1,0,1,1912
Ville Kyrönen,Finland,0,1,0,1,1912
Aarne Lindholm,Finland,0,1,0,1,1912
Aarne Salovaara,Finland,0,1,0,1,1912
Väinö Siikaniemi,Finland,0,1,0,1,1912
Jean Bouin,France,0,1,0,1,1912
Pierre Failliot,France,0,1,0,1,1912
Charles Lelong,France,0,1,0,1,1912
Charles Poulenard,France,0,1,0,1,1912
Robert Schürrer,France,0,1,0,1,1912
Ernie Webb,Great Britain,0,1,0,1,1912
Hanns Braun,Germany,0,1,0,1,1912
Hans Liesche,Germany,0,1,0,1,1912
Samu Fóti,Hungary,0,1,0,1,1912
Chris Gitsham,South Africa,0,1,0,1,1912
Nils Frykberg,Sweden,0,1,0,1,1912
Knut Lindberg,Sweden,0,1,0,1,1912
Charles Lomberg,Sweden,0,1,0,1,1912
Karl August Luther,Sweden,0,1,0,1,1912
Ivan Möller,Sweden,0,1,0,1,1912
Thorild Olsson,Sweden,0,1,0,1,1912
Ture Person,Sweden,0,1,0,1,1912
Ernst Wide,Sweden,0,1,0,1,1912
John Zander,Sweden,0,1,0,1,1912
Dick Byrd,United States,0,1,0,1,1912
Jim Donahue,United States,0,1,0,1,1912
Alvah Meyer,United States,0,1,0,1,1912
Frank Nelson,United States,0,1,0,1,1912
Lewis Tewanima,United States,0,1,0,1,1912
James Wendell,United States,0,1,0,1,1912
Marc Wright,United States,0,1,0,1,1912
Jørgen Ravn,Denmark,0,1,0,1,1912
Hugo Clason,Sweden,0,1,0,1,1912
Hugo Sällström,Sweden,0,1,0,1,1912
Sigurd Kander,Sweden,0,1,0,1,1912
Georges Dubois,France,0,1,0,1,1912
Charles Stewart,Great Britain,0,0,3,3,1912
Albert Canet,France,0,0,2,2,1912
Carl Schutte,United States,0,0,2,2,1912
Arie de Jong,Netherlands,0,0,2,2,1912
Jetze Doorman,Netherlands,0,0,2,2,1912
Willem Hubert van Blijenburgh,Netherlands,0,0,2,2,1912
George van Rossem,Netherlands,0,0,2,2,1912
Niels Larsen,Denmark,0,0,2,2,1912
Nestori Toivonen,Finland,0,0,2,2,1912
Hugh Durant,Great Britain,0,0,2,2,1912
Albert Kempster,Great Britain,0,0,2,2,1912
Horatio Poulter,Great Britain,0,0,2,2,1912
William Cottrill,Great Britain,0,0,2,2,1912
George Hutson,Great Britain,0,0,2,2,1912
Édouard Mény de Marangue,France,0,0,1,1,1912
Mabel Parton,Great Britain,0,0,1,1,1912
Alfred Beamish,Great Britain,0,0,1,1,1912
Oskar Kreuzer,Germany,0,0,1,1,1912
Molla Bjurstedt-Mallory,Norway,0,0,1,1,1912
Emmanuel de Blommaert de Soye,Belgium,0,0,1,1,1912
Ernst Deloch,Germany,0,0,1,1,1912
Sigismund Freyer,Germany,0,0,1,1,1912
"Friedrich Karl, Prince von Preußen",Germany,0,0,1,1,1912
Ephraim Graham,United States,0,0,1,1,1912
Guy Henry,United States,0,0,1,1,1912
Ben Lear,United States,0,0,1,1,1912
Jack Montgomery,United States,0,0,1,1,1912
"Hans von Blixen-Finecke, Sr.",Sweden,0,0,1,1,1912
"Wilhelm, Count von Hohenau",Germany,0,0,1,1,1912
John Becht,United States,0,0,1,1,1912
Joe Kopsky,United States,0,0,1,1,1912
Albert Krushel,United States,0,0,1,1,1912
Al Loftes,United States,0,0,1,1,1912
Walden Martin,United States,0,0,1,1,1912
Frank Meissner,United States,0,0,1,1,1912
Jesse Pike,United States,0,0,1,1,1912
Jerome Steinert,United States,0,0,1,1,1912
Victor Boin,Belgium,0,0,1,1,1912
Philippe Le Hardy de Beaulieu,Belgium,0,0,1,1,1912
Hendrik de Iongh,Netherlands,0,0,1,1,1912
Leo Nardus,Netherlands,0,0,1,1,1912
Dirk Scalongne,Netherlands,0,0,1,1,1912
Joop Boutmy,Netherlands,0,0,1,1,1912
Piet Bouman,Netherlands,0,0,1,1,1912
Nico Bouvy,Netherlands,0,0,1,1,1912
Huug de Groot,Netherlands,0,0,1,1,1912
Bok de Korver,Netherlands,0,0,1,1,1912
Nico de Wolf,Netherlands,0,0,1,1,1912
Constant Feith,Netherlands,0,0,1,1,1912
Gé Fortgens,Netherlands,0,0,1,1,1912
Just Göbel,Netherlands,0,0,1,1,1912
Dirk Lotsij,Netherlands,0,0,1,1,1912
Cees ten Cate,Netherlands,0,0,1,1,1912
Jan van Breda Kolff,Netherlands,0,0,1,1,1912
Jan van der Sluis,Netherlands,0,0,1,1,1912
Jan Vos,Netherlands,0,0,1,1,1912
David Wijnveldt,Netherlands,0,0,1,1,1912
Axel Andersen,Denmark,0,0,1,1,1912
Hjalmart Andersen,Denmark,0,0,1,1,1912
Halvor Birch,Denmark,0,0,1,1,1912
Wilhelm Grimmelmann,Denmark,0,0,1,1,1912
Marius Hansen,Denmark,0,0,1,1,1912
Arvor Hansen,Denmark,0,0,1,1,1912
Christian Hansen,Denmark,0,0,1,1,1912
Charles Jensen,Denmark,0,0,1,1,1912
Hjalmar Johansen,Denmark,0,0,1,1,1912
Poul Preben Jørgensen,Denmark,0,0,1,1,1912
Carl Krebs,Denmark,0,0,1,1,1912
Vigo Meulengracht Madsen,Denmark,0,0,1,1,1912
Lukas Nielsen,Denmark,0,0,1,1,1912
Rikard Nordstrøm,Denmark,0,0,1,1,1912
Steen Lerche Olsen,Denmark,0,0,1,1,1912
Oluf Olsson,Denmark,0,0,1,1,1912
Carl Pedersen,Denmark,0,0,1,1,1912
Kristian Pedersen,Denmark,0,0,1,1,1912
Niels Petersen,Denmark,0,0,1,1,1912
Christian Svendsen,Denmark,0,0,1,1,1912
Albert Betts,Great Britain,0,0,1,1,1912
William Cowhig,Great Britain,0,0,1,1,1912
Sidney Cross,Great Britain,0,0,1,1,1912
Harry Dickason,Great Britain,0,0,1,1,1912
Bert Drury,Great Britain,0,0,1,1,1912
Bernard Franklin,Great Britain,0,0,1,1,1912
Len Hanson,Great Britain,0,0,1,1,1912
Sam Hodgetts,Great Britain,0,0,1,1,1912
Charles Luck,Great Britain,0,0,1,1,1912
William MacKune,Great Britain,0,0,1,1,1912
Ronald McLean,Great Britain,0,0,1,1,1912
Alfred Messenger,Great Britain,0,0,1,1,1912
Henry Oberholzer,Great Britain,0,0,1,1,1912
Ted Pepper,Great Britain,0,0,1,1,1912
Edward Potts,Great Britain,0,0,1,1,1912
Reginald Potts,Great Britain,0,0,1,1,1912
George Ross,Great Britain,0,0,1,1,1912
Charles Simmons,Great Britain,0,0,1,1,1912
Arthur Southern,Great Britain,0,0,1,1,1912
William Titt,Great Britain,0,0,1,1,1912
Charles Vigurs,Great Britain,0,0,1,1,1912
Sam Walker,Great Britain,0,0,1,1,1912
John Whitaker,Great Britain,0,0,1,1,1912
Arthur Amundsen,Norway,0,0,1,1,1912
Jørgen Andersen,Norway,0,0,1,1,1912
Georg Brustad,Norway,0,0,1,1,1912
Trygve Bøyesen,Norway,0,0,1,1,1912
Conrad Christensen,Norway,0,0,1,1,1912
Oscar Engelstad,Norway,0,0,1,1,1912
Marius Eriksen,Norway,0,0,1,1,1912
Aksel Hansen,Norway,0,0,1,1,1912
Peter Hol,Norway,0,0,1,1,1912
Eugen Ingebretsen,Norway,0,0,1,1,1912
Olaf Ingebrigtsen,Norway,0,0,1,1,1912
Olaf Jacobsen,Norway,0,0,1,1,1912
Erling Jensen,Norway,0,0,1,1,1912
Thor Jensen,Norway,0,0,1,1,1912
Frithjof Olsen,Norway,0,0,1,1,1912
Oscar Olstad,Norway,0,0,1,1,1912
Edvin Paulsen,Norway,0,0,1,1,1912
Carl Alfred Pedersen,Norway,0,0,1,1,1912
Paul Pedersen,Norway,0,0,1,1,1912
Realf Robach,Norway,0,0,1,1,1912
Sigurd Smebye,Norway,0,0,1,1,1912
Torleif Torkildsen,Norway,0,0,1,1,1912
Everard Butler,Canada,0,0,1,1,1912
Erik Bisgaard,Denmark,0,0,1,1,1912
Ejgil Clemmensen,Denmark,0,0,1,1,1912
Rasmus Frandsen,Denmark,0,0,1,1,1912
Mikael Simonsen,Denmark,0,0,1,1,1912
Poul Thymann,Denmark,0,0,1,1,1912
Fritz Bartholomae,Germany,0,0,1,1,1912
Willi Bartholomae,Germany,0,0,1,1,1912
Max Bröske,Germany,0,0,1,1,1912
Werner Dehn,Germany,0,0,1,1,1912
Otto Liebing,Germany,0,0,1,1,1912
Hans Matthiae,Germany,0,0,1,1,1912
Rudolf Reichelt,Germany,0,0,1,1,1912
Kurt Runge,Germany,0,0,1,1,1912
Max Vetter,Germany,0,0,1,1,1912
Olaf Bjørnstad,Norway,0,0,1,1,1912
Max Herseth,Norway,0,0,1,1,1912
Reidar Holter,Norway,0,0,1,1,1912
Claus Høyer,Norway,0,0,1,1,1912
Theodor Klem,Norway,0,0,1,1,1912
Henry Larsen,Norway,0,0,1,1,1912
Frithjof Olstad,Norway,0,0,1,1,1912
Mathias Torstensen,Norway,0,0,1,1,1912
Ejnar Tønsager,Norway,0,0,1,1,1912
Haakon Tønsager,Norway,0,0,1,1,1912
Mart Kuusik,Estonia,0,0,1,1,1912
Niels Andersen,Denmark,0,0,1,1,1912
Jens Hajslund,Denmark,0,0,1,1,1912
Laurits Larsen,Denmark,0,0,1,1,1912
Ole Olsen,Denmark,0,0,1,1,1912
Axel Fredrik Londen,Finland,0,0,1,1,1912
Ernst Rosenqvist,Finland,0,0,1,1,1912
Iivo Väänänen,Finland,0,0,1,1,1912
Harry Burt,Great Britain,0,0,1,1,1912
"Erich, Count von Bernstorff-Gyldensteen",Germany,0,0,1,1,1912
Horst Goeldel-Bronikoven,Germany,0,0,1,1,1912
Erland Koch,Germany,0,0,1,1,1912
Albert Preuß,Germany,0,0,1,1,1912
"Franz, Baron von Zedlitz und Leipe",Germany,0,0,1,1,1912
Embret Skogen,Norway,0,0,1,1,1912
Harry Blaus,Latvia,0,0,1,1,1912
Tönnes Björkman,Sweden,0,0,1,1,1912
Gideon Ericsson,Sweden,0,0,1,1,1912
Werner Jernström,Sweden,0,0,1,1,1912
Grete Adler,Austria,0,0,1,1,1912
Klara Milch,Austria,0,0,1,1,1912
Fini Sticker,Austria,0,0,1,1,1912
Berta Zahourek,Austria,0,0,1,1,1912
Félicien Courbet,Belgium,0,0,1,1,1912
Herman Meyboom,Belgium,0,0,1,1,1912
Belle White,Great Britain,0,0,1,1,1912
Sydney Battersby,Great Britain,0,0,1,1,1912
Percy Courtman,Great Britain,0,0,1,1,1912
Willie Foster,Great Britain,0,0,1,1,1912
Henry Taylor,Great Britain,0,0,1,1,1912
Kurt Behrens,Germany,0,0,1,1,1912
Paul Kellner,Germany,0,0,1,1,1912
Paul Malisch,Germany,0,0,1,1,1912
Gustaf Blomgren,Sweden,0,0,1,1,1912
Johan Jansson,Sweden,0,0,1,1,1912
Herman Donners,Belgium,0,0,1,1,1912
Albert Durant,Belgium,0,0,1,1,1912
Oscar Grégoire,Belgium,0,0,1,1,1912
Jean Hoffman,Belgium,0,0,1,1,1912
Pierre Nijs,Belgium,0,0,1,1,1912
Joseph Pletincx,Belgium,0,0,1,1,1912
Søren Jensen,Denmark,0,0,1,1,1912
Alppo Asikainen,Finland,0,0,1,1,1912
Otto Lasanen,Finland,0,0,1,1,1912
Béla Varga,Hungary,0,0,1,1,1912
Edvin Mathiasson,Sweden,0,0,1,1,1912
Arthur Ahnger,Finland,0,0,1,1,1912
Ferdinand Alfthan,Finland,0,0,1,1,1912
Otto Aust,Sweden,0,0,1,1,1912
Esper Beloselsky,Russian Federation,0,0,1,1,1912
Ernst Brasche,Russian Federation,0,0,1,1,1912
Pekka Hartvall,Finland,0,0,1,1,1912
Jarl Hulldén,Finland,0,0,1,1,1912
Sigurd Juslén,Finland,0,0,1,1,1912
Ernst Krogius,Finland,0,0,1,1,1912
Emil Lindh,Finland,0,0,1,1,1912
Karl Lindholm,Russian Federation,0,0,1,1,1912
Nikolay Pushnitsky,Russian Federation,0,0,1,1,1912
Aleksandr Rodionov,Russian Federation,0,0,1,1,1912
Eric Sandberg,Sweden,0,0,1,1,1912
Harald Sandberg,Sweden,0,0,1,1,1912
Eino Sandelin,Finland,0,0,1,1,1912
Johan Silén,Finland,0,0,1,1,1912
Joseph Schomacker,Russian Federation,0,0,1,1,1912
Philipp Strauch,Russian Federation,0,0,1,1,1912
Bertil Tallberg,Finland,0,0,1,1,1912
Gunnar Tallberg,Finland,0,0,1,1,1912
Georg Westling,Finland,0,0,1,1,1912
William Halpenny,Canada,0,0,1,1,1912
Frank Lukeman,Canada,0,0,1,1,1912
Urho Peltonen,Finland,0,0,1,1,1912
Ernest Glover,Great Britain,0,0,1,1,1912
Ernest Henley,Great Britain,0,0,1,1,1912
Frederick Hibbins,Great Britain,0,0,1,1,1912
Thomas Humphreys,Great Britain,0,0,1,1,1912
William Moore,Great Britain,0,0,1,1,1912
George Nicol,Great Britain,0,0,1,1,1912
Eddie Owen,Great Britain,0,0,1,1,1912
Cyril Porter,Great Britain,0,0,1,1,1912
William Scott,Great Britain,0,0,1,1,1912
Cyril Seedhouse,Great Britain,0,0,1,1,1912
James Soutter,Great Britain,0,0,1,1,1912
Mór Kóczán,Czechoslovakia,0,0,1,1,1912
Nando Altimani,Italy,0,0,1,1,1912
Erik Almlöf,Sweden,0,0,1,1,1912
Gösta Holmér,Sweden,0,0,1,1,1912
Emil Magnusson,Sweden,0,0,1,1,1912
Bertil Uggla,Sweden,0,0,1,1,1912
Clarence Childs,United States,0,0,1,1,1912
Ira Davenport,United States,0,0,1,1,1912
Jim Duncan,United States,0,0,1,1,1912
Martin Hawkins,United States,0,0,1,1,1912
George Horine,United States,0,0,1,1,1912
Frank Murphy,United States,0,0,1,1,1912
Gaston Strobino,United States,0,0,1,1,1912
Larry Whitney,United States,0,0,1,1,1912
Tony Wilding,Australasia,0,0,1,1,1912
Willis Lee,United States,5,1,1,7,1920
Nedo Nadi,Italy,5,0,0,5,1920
Hubert Van Innis,Belgium,4,2,0,6,1920
Lloyd Spooner,United States,4,1,2,7,1920
Carl Osburn,United States,4,1,1,6,1920
Otto Olsen,Norway,3,2,0,5,1920
Aldo Nadi,Italy,3,1,0,4,1920
Paavo Nurmi,Finland,3,1,0,4,1920
Dennis Fenton,United States,3,0,1,4,1920
Edmond Cloetens,Belgium,3,0,0,3,1920
Edmond Van Moer,Belgium,3,0,0,3,1920
Ole Lilloe-Olsen,Norway,3,0,0,3,1920
Bud Fisher,United States,3,0,0,3,1920
Karl Frederick,United States,3,0,0,3,1920
Joe Jackson,United States,3,0,0,3,1920
Ollie Schriver,United States,3,0,0,3,1920
Ethelda Bleibtrey,United States,3,0,0,3,1920
Norman Ross,United States,3,0,0,3,1920
Louis Van De Perck,Belgium,2,2,0,4,1920
Larry Nuesslein,United States,2,1,2,5,1920
Alphonse Allaert,Belgium,2,1,0,3,1920
Edmond De Knibber,Belgium,2,1,0,3,1920
Jérôme De Mayer,Belgium,2,1,0,3,1920
Louis Delcon,Belgium,2,1,0,3,1920
Louis Fierens,Belgium,2,1,0,3,1920
Louis Van Beeck,Belgium,2,1,0,3,1920
Pierre Van Thielt,Belgium,2,1,0,3,1920
Albert Hill,Great Britain,2,1,0,3,1920
Morris Kirksey,United States,2,1,0,3,1920
Charley Paddock,United States,2,1,0,3,1920
Firmin Flamand,Belgium,2,0,1,3,1920
Joseph Hermans,Belgium,2,0,1,3,1920
Suzanne Lenglen,France,2,0,1,3,1920
Einar Liberg,Norway,2,0,1,3,1920
Harald Natvig,Norway,2,0,1,3,1920
Al Lane,United States,2,0,1,3,1920
Auguste Van De Verre,Belgium,2,0,0,2,1920
Daniël Bouckaert,Belgium,2,0,0,2,1920
"Helmer, Count Mörner",Sweden,2,0,0,2,1920
Baldo Baldi,Italy,2,0,0,2,1920
Tommaso Costantino,Italy,2,0,0,2,1920
Abelardo Olivier,Italy,2,0,0,2,1920
Oreste Puliti,Italy,2,0,0,2,1920
Dino Urbani,Italy,2,0,0,2,1920
Giorgio Zampori,Italy,2,0,0,2,1920
"Jack Kelly, Sr.",United States,2,0,0,2,1920
Hans Nordvik,Norway,2,0,0,2,1920
Mark Arie,United States,2,0,0,2,1920
Mike Kelly,United States,2,0,0,2,1920
James Snook,United States,2,0,0,2,1920
Håkan Malmrot,Sweden,2,0,0,2,1920
Duke Kahanamoku,United States,2,0,0,2,1920
Ugo Frigerio,Italy,2,0,0,2,1920
Julien Brulé,France,1,3,1,5,1920
Kitty McKane,Great Britain,1,1,1,3,1920
Bevil Rudd,South Africa,1,1,1,3,1920
Max Woosnam,Great Britain,1,1,0,2,1920
Åge Lundström,Sweden,1,1,0,2,1920
Harry Stenqvist,Sweden,1,1,0,2,1920
Sherm Clark,United States,1,1,0,2,1920
Niels Larsen,Denmark,1,1,0,2,1920
Lars Jørgen Madsen,Denmark,1,1,0,2,1920
Ray Bracken,United States,1,1,0,2,1920
Arthur Rothrock,United States,1,1,0,2,1920
Frank Troeh,United States,1,1,0,2,1920
Irene Guest,United States,1,1,0,2,1920
Margaret Woodbridge,United States,1,1,0,2,1920
Pua Kele Kealoha,United States,1,1,0,2,1920
Bud Pinkston,United States,1,1,0,2,1920
Elmer Niklander,Finland,1,1,0,2,1920
Joseph Guillemot,France,1,1,0,2,1920
Guy Butler,Great Britain,1,1,0,2,1920
Percy Hodge,Great Britain,1,1,0,2,1920
Paddy Ryan,United States,1,1,0,2,1920
Hugo Johansson,Sweden,1,0,2,3,1920
Frances Schroth,United States,1,0,2,3,1920
Max Décugis,France,1,0,1,2,1920
Louis Finet,Belgium,1,0,1,2,1920
Hans von Rosen,Sweden,1,0,1,2,1920
Fernand Canteloube,France,1,0,1,2,1920
Harry Ryan,Great Britain,1,0,1,2,1920
Armand Massard,France,1,0,1,2,1920
Guilherme Paraense,Brazil,1,0,1,2,1920
Frank Wright,United States,1,0,1,2,1920
Heikki Liimatainen,Finland,1,0,1,2,1920
William Petersson,Sweden,1,0,1,2,1920
Larry Shields,United States,1,0,1,2,1920
Winifred McNair,Great Britain,1,0,0,1,1920
Noel Turnbull,Great Britain,1,0,0,1,1920
Bert Schneider,Canada,1,0,0,1,1920
Piet de Brouwer,Netherlands,1,0,0,1,1920
Joep Packbiers,Netherlands,1,0,0,1,1920
Janus Theeuwes,Netherlands,1,0,0,1,1920
Driekske van Bussel,Netherlands,1,0,0,1,1920
"Jo van Gastel, Jr.",Netherlands,1,0,0,1,1920
Tiest van Gestel,Netherlands,1,0,0,1,1920
Janus van Merrienboer,Netherlands,1,0,0,1,1920
Theo Willems,Netherlands,1,0,0,1,1920
Louis Raymond,South Africa,1,0,0,1,1920
Paul Fritsch,France,1,0,0,1,1920
Harry Mallin,Great Britain,1,0,0,1,1920
Ron Rawson,Great Britain,1,0,0,1,1920
Sal Walker,South Africa,1,0,0,1,1920
Frankie Genaro,United States,1,0,0,1,1920
Eddie Eagan,United States,1,0,0,1,1920
Sammy Mosberg,United States,1,0,0,1,1920
Dan Carroll,Australasia,1,0,0,1,1920
Claës König,Sweden,1,0,0,1,1920
Tommaso Lequio di Assaba,Italy,1,0,0,1,1920
Janne Lundblad,Sweden,1,0,0,1,1920
Frank Martin,Sweden,1,0,0,1,1920
Van Ranst,Belgium,1,0,0,1,1920
Georg von Braun,Sweden,1,0,0,1,1920
Arnaldo Carli,Italy,1,0,0,1,1920
Georges Détreille,France,1,0,0,1,1920
Ruggero Ferrario,Italy,1,0,0,1,1920
Henry George,Belgium,1,0,0,1,1920
Franco Giorgetti,Italy,1,0,0,1,1920
Marcel Gobillot,France,1,0,0,1,1920
Thomas Lance,Great Britain,1,0,0,1,1920
Primo Magnani,Italy,1,0,0,1,1920
Maurice Peeters,Netherlands,1,0,0,1,1920
Achille Souchard,France,1,0,0,1,1920
Frederick Barrett,Great Britain,1,0,0,1,1920
Tim Melvill,Great Britain,1,0,0,1,1920
Vivian Lockett,Great Britain,1,0,0,1,1920
"Jack, Lord Wodehouse",Great Britain,1,0,0,1,1920
George Canning,Great Britain,1,0,0,1,1920
Fred Holmes,Great Britain,1,0,0,1,1920
Frederick Humphreys,Great Britain,1,0,0,1,1920
Edwin Mills,Great Britain,1,0,0,1,1920
John Sewell,Great Britain,1,0,0,1,1920
James Shepherd,Great Britain,1,0,0,1,1920
Harry Stiff,Great Britain,1,0,0,1,1920
Ernest Thorne,Great Britain,1,0,0,1,1920
Charlie Doe,United States,1,0,0,1,1920
George Fish,United States,1,0,0,1,1920
Jim Fitzpatrick,United States,1,0,0,1,1920
Lou Hunter,United States,1,0,0,1,1920
Charles Mehan,United States,1,0,0,1,1920
John Muldoon,United States,1,0,0,1,1920
John O'Neil,United States,1,0,0,1,1920
Jack Patrick,United States,1,0,0,1,1920
Cornelius Righter,United States,1,0,0,1,1920
Rudy Scholz,United States,1,0,0,1,1920
Babe Slater,United States,1,0,0,1,1920
Charles Tilden,United States,1,0,0,1,1920
Heaton Wrenn,United States,1,0,0,1,1920
Charles Atkin,Great Britain,1,0,0,1,1920
Jack Bennett,Great Britain,1,0,0,1,1920
Harold Cassels,Great Britain,1,0,0,1,1920
Harold Cooke,Great Britain,1,0,0,1,1920
Eric Crockford,Great Britain,1,0,0,1,1920
Harry Haslam,Great Britain,1,0,0,1,1920
Arthur Leighton,Great Britain,1,0,0,1,1920
Sholto Marcon,Great Britain,1,0,0,1,1920
Jack MacBryan,Great Britain,1,0,0,1,1920
George McGrath,Great Britain,1,0,0,1,1920
Stanley Shoveller,Great Britain,1,0,0,1,1920
William Smith,Great Britain,1,0,0,1,1920
Cyril Wilkinson,Great Britain,1,0,0,1,1920
Antonio Allocchio,Italy,1,0,0,1,1920
Tullio Bozza,Italy,1,0,0,1,1920
Giovanni Canova,Italy,1,0,0,1,1920
Francesco Gargano,Italy,1,0,0,1,1920
Andrea Marrazzi,Italy,1,0,0,1,1920
Giorgio Santelli,Italy,1,0,0,1,1920
Pietro Speciale,Italy,1,0,0,1,1920
Rodolfo Terlizzi,Italy,1,0,0,1,1920
"Paolo, Count Thaon Di Revel",Italy,1,0,0,1,1920
Félix Balyu,Belgium,1,0,0,1,1920
Désiré Bastin,Belgium,1,0,0,1,1920
Mathieu Bragard,Belgium,1,0,0,1,1920
Robert Coppée,Belgium,1,0,0,1,1920
Jean De Bie,Belgium,1,0,0,1,1920
André Fierens,Belgium,1,0,0,1,1920
Emile Hanse,Belgium,1,0,0,1,1920
Georges Hebdin,Belgium,1,0,0,1,1920
Rik Larnoe,Belgium,1,0,0,1,1920
Joseph Musch,Belgium,1,0,0,1,1920
Fernand Nisot,Belgium,1,0,0,1,1920
Armand Swartenbroecks,Belgium,1,0,0,1,1920
Louis Van Hege,Belgium,1,0,0,1,1920
Oscar Verbeeck,Belgium,1,0,0,1,1920
Georg Albertsen,Denmark,1,0,0,1,1920
Carl R. Andersen,Denmark,1,0,0,1,1920
Viggo Dibbern,Denmark,1,0,0,1,1920
Aage Frandsen,Denmark,1,0,0,1,1920
Hugo Helsten,Denmark,1,0,0,1,1920
Harry Holm,Denmark,1,0,0,1,1920
Robert Johnsen,Denmark,1,0,0,1,1920
Christian Juhl,Denmark,1,0,0,1,1920
Vilhelm Lange,Denmark,1,0,0,1,1920
Svend Meulengracht Madsen,Denmark,1,0,0,1,1920
Peder Marcussen,Denmark,1,0,0,1,1920
Peter Møller,Denmark,1,0,0,1,1920
Niels Turin-Nielsen,Denmark,1,0,0,1,1920
Steen Lerche Olsen,Denmark,1,0,0,1,1920
Christian Møller Pedersen,Denmark,1,0,0,1,1920
Stig Rønne,Denmark,1,0,0,1,1920
Harry Sørensen,Denmark,1,0,0,1,1920
Christian Thomas,Denmark,1,0,0,1,1920
Knud Vermehren,Denmark,1,0,0,1,1920
Arnaldo Andreoli,Italy,1,0,0,1,1920
Ettore Bellotto,Italy,1,0,0,1,1920
Pietro Bianchi,Italy,1,0,0,1,1920
Fernando Bonatti,Italy,1,0,0,1,1920
Luigi Cambiaso,Italy,1,0,0,1,1920
Luigi Contessi,Italy,1,0,0,1,1920
Carlo Costigliolo,Italy,1,0,0,1,1920
Luigi Costigliolo,Italy,1,0,0,1,1920
Giuseppe Domenichelli,Italy,1,0,0,1,1920
Roberto Ferrari,Italy,1,0,0,1,1920
Carlo Fregosi,Italy,1,0,0,1,1920
Romualdo Ghiglione,Italy,1,0,0,1,1920
Ambrogio Levati,Italy,1,0,0,1,1920
Francesco Loy,Italy,1,0,0,1,1920
Vittorio Lucchetti,Italy,1,0,0,1,1920
Luigi Maiocco,Italy,1,0,0,1,1920
Ferdinando Mandrini,Italy,1,0,0,1,1920
Renzo Mangiante,Italy,1,0,0,1,1920
Antonio Marovelli,Italy,1,0,0,1,1920
Michele Mastromarino,Italy,1,0,0,1,1920
Giuseppe Paris,Italy,1,0,0,1,1920
Manlio Pastorini,Italy,1,0,0,1,1920
Ezio Roselli,Italy,1,0,0,1,1920
Paolo Salvi,Italy,1,0,0,1,1920
Giovanni Battista Tubino,Italy,1,0,0,1,1920
Angelo Zorzi,Italy,1,0,0,1,1920
Fausto Acke,Sweden,1,0,0,1,1920
Arvid Andersson,Sweden,1,0,0,1,1920
Bengt Bengtsson,Sweden,1,0,0,1,1920
Fabian Biörck,Sweden,1,0,0,1,1920
Helge Bäckander,Sweden,1,0,0,1,1920
Erik Charpentier,Sweden,1,0,0,1,1920
Sture Ericsson,Sweden,1,0,0,1,1920
Konrad Granström,Sweden,1,0,0,1,1920
Helge Gustafsson,Sweden,1,0,0,1,1920
Ture Hedman,Sweden,1,0,0,1,1920
Åke Häger,Sweden,1,0,0,1,1920
Sven Johnson,Sweden,1,0,0,1,1920
Sven-Olof Jonsson,Sweden,1,0,0,1,1920
Karl Lindahl,Sweden,1,0,0,1,1920
Bengt Morberg,Sweden,1,0,0,1,1920
Daniel Norling,Sweden,1,0,0,1,1920
Frans Persson,Sweden,1,0,0,1,1920
Alf Svensén,Sweden,1,0,0,1,1920
Klas Särner,Sweden,1,0,0,1,1920
Gunnar Söderlindh,Sweden,1,0,0,1,1920
John Sörenson,Sweden,1,0,0,1,1920
Gösta Törner,Sweden,1,0,0,1,1920
Gustaf Dyrssen,Sweden,1,0,0,1,1920
Guido De Felip,Italy,1,0,0,1,1920
Ercole Olgeni,Italy,1,0,0,1,1920
Giovanni Scatturin,Italy,1,0,0,1,1920
Willy Brüderlin,Switzerland,1,0,0,1,1920
Max Rudolf,Switzerland,1,0,0,1,1920
Paul Rudolf,Switzerland,1,0,0,1,1920
Paul Staub,Switzerland,1,0,0,1,1920
Hans Walter,Switzerland,1,0,0,1,1920
Paul Costello,United States,1,0,0,1,1920
Vince Gallagher,United States,1,0,0,1,1920
Ed Graves,United States,1,0,0,1,1920
Virgil Jacomini,United States,1,0,0,1,1920
Don Johnston,United States,1,0,0,1,1920
Bill Jordan,United States,1,0,0,1,1920
Clyde King,United States,1,0,0,1,1920
Ed Moore,United States,1,0,0,1,1920
Zeke Sanborn,United States,1,0,0,1,1920
Anders Peter Nielsen,Denmark,1,0,0,1,1920
Anders Petersen,Denmark,1,0,0,1,1920
Erik Sætter-Lassen,Denmark,1,0,0,1,1920
Thorsten Johansen,Norway,1,0,0,1,1920
Horace Bonser,United States,1,0,0,1,1920
Jay Clark,United States,1,0,0,1,1920
Louis Harant,United States,1,0,0,1,1920
Forest McNeir,United States,1,0,0,1,1920
Stefanie Clausen,Denmark,1,0,0,1,1920
Herold Jansson,Denmark,1,0,0,1,1920
Edmund Lindmark,Sweden,1,0,0,1,1920
Curt Sjöberg,Sweden,1,0,0,1,1920
Arvid Wallman,Sweden,1,0,0,1,1920
Aileen Riggin,United States,1,0,0,1,1920
Warren Kealoha,United States,1,0,0,1,1920
Lou Kuehn,United States,1,0,0,1,1920
Perry McGillivray,United States,1,0,0,1,1920
Charles Bugbee,Great Britain,1,0,0,1,1920
Billy Dean,Great Britain,1,0,0,1,1920
Chris Jones,Great Britain,1,0,0,1,1920
Bill Peacock,Great Britain,1,0,0,1,1920
Paul Radmilovic,Great Britain,1,0,0,1,1920
Charles Smith,Great Britain,1,0,0,1,1920
Noel Purcell,Great Britain,1,0,0,1,1920
Frans De Haes,Belgium,1,0,0,1,1920
Alfred Neuland,Estonia,1,0,0,1,1920
Ernest Cadine,France,1,0,0,1,1920
Henri Gance,France,1,0,0,1,1920
Filippo Bottino,Italy,1,0,0,1,1920
Kalle Anttila,Finland,1,0,0,1,1920
Oskari Friman,Finland,1,0,0,1,1920
Eino Leino,Finland,1,0,0,1,1920
Adolf Lindfors,Finland,1,0,0,1,1920
Emil Väre,Finland,1,0,0,1,1920
Robert Roth,Switzerland,1,0,0,1,1920
Claes Johanson,Sweden,1,0,0,1,1920
Anders Larsson,Sweden,1,0,0,1,1920
Carl Westergren,Sweden,1,0,0,1,1920
Charley Ackerly,United States,1,0,0,1,1920
Dorothy Wright,Great Britain,1,0,0,1,1920
Arthur Allers,Norway,1,0,0,1,1920
Charles Archer Arentz,Norway,1,0,0,1,1920
Gösta Bengtsson,Sweden,1,0,0,1,1920
Halvor Olai Birkeland,Norway,1,0,0,1,1920
Rasmus Birkeland,Norway,1,0,0,1,1920
Martin Borthen,Norway,1,0,0,1,1920
Andreas Brecke,Norway,1,0,0,1,1920
Frédéric-Albert Bruynseels,Belgium,1,0,0,1,1920
Berend Carp,Netherlands,1,0,0,1,1920
Joop Carp,Netherlands,1,0,0,1,1920
Lauritz Christiansen,Norway,1,0,0,1,1920
Thorleif Kristoffersen,Norway,1,0,0,1,1920
Robert Coleman,Great Britain,1,0,0,1,1920
Émile Cornellie,Belgium,1,0,0,1,1920
Florimond Cornellie,Belgium,1,0,0,1,1920
Otto Falkenberg,Norway,1,0,0,1,1920
Johan Friele,Norway,1,0,0,1,1920
Robert Giertsen,Norway,1,0,0,1,1920
Willy Gilbert,Norway,1,0,0,1,1920
Kaspar Hassel,Norway,1,0,0,1,1920
Erik Herseth,Norway,1,0,0,1,1920
Cornelis Hin,Netherlands,1,0,0,1,1920
Johan Hin,Netherlands,1,0,0,1,1920
Frans Hin,Netherlands,1,0,0,1,1920
Thorleif Holbye,Norway,1,0,0,1,1920
Tore Holm,Sweden,1,0,0,1,1920
Yngve Holm,Sweden,1,0,0,1,1920
Sigurd Holter,Norway,1,0,0,1,1920
Alf Brun Jakobsen,Norway,1,0,0,1,1920
Gunnar Jamvold,Norway,1,0,0,1,1920
Peter Jamvold,Norway,1,0,0,1,1920
Claus Juell,Norway,1,0,0,1,1920
Magnus Konow,Norway,1,0,0,1,1920
Paal Kaasen,Norway,1,0,0,1,1920
Gösta Lundquist,Sweden,1,0,0,1,1920
William Maddison,Great Britain,1,0,0,1,1920
Reidar Martiniuson,Norway,1,0,0,1,1920
Halvor Møgster,Norway,1,0,0,1,1920
Hans Stoermann-Næss,Norway,1,0,0,1,1920
Ingar Nielsen,Norway,1,0,0,1,1920
Kristoffer Olsen,Norway,1,0,0,1,1920
Egill Reimers,Norway,1,0,0,1,1920
"August Ringvold, Sr.",Norway,1,0,0,1,1920
Axel Rydin,Sweden,1,0,0,1,1920
Ingolf Rød,Norway,1,0,0,1,1920
Halfdan Schjøtt,Norway,1,0,0,1,1920
Trygve Schjøtt,Norway,1,0,0,1,1920
Arne Sejersted,Norway,1,0,0,1,1920
Rolf Steffenburg,Sweden,1,0,0,1,1920
Ole Sørensen,Norway,1,0,0,1,1920
Georg Tengvall,Sweden,1,0,0,1,1920
Ragnar Vik,Norway,1,0,0,1,1920
Tell Wagle,Norway,1,0,0,1,1920
Piet Wernink,Netherlands,1,0,0,1,1920
Christen Wiese,Norway,1,0,0,1,1920
Cyril Wright,Great Britain,1,0,0,1,1920
Erik Ørvig,Norway,1,0,0,1,1920
Olaf Ørvig,Norway,1,0,0,1,1920
Thor Ørvig,Norway,1,0,0,1,1920
Henrik Østervold,Norway,1,0,0,1,1920
Jan Østervold,Norway,1,0,0,1,1920
Kristian Østervold,Norway,1,0,0,1,1920
Ole Østervold,Norway,1,0,0,1,1920
Tommy Thomson,Canada,1,0,0,1,1920
Hannes Kolehmainen,Finland,1,0,0,1,1920
Teodor Koskenniemi,Finland,1,0,0,1,1920
Eero Lehtonen,Finland,1,0,0,1,1920
Hannes Miettinen,Finland,1,0,0,1,1920
Jonni Myyrä,Finland,1,0,0,1,1920
Ville Pörhölä,Finland,1,0,0,1,1920
Eino Rastas,Finland,1,0,0,1,1920
Ville Tuulos,Finland,1,0,0,1,1920
Ilmari Vesamaa,Finland,1,0,0,1,1920
John Ainsworth-Davis,Great Britain,1,0,0,1,1920
Cecil Griffiths,Great Britain,1,0,0,1,1920
Robert Lindsay,Great Britain,1,0,0,1,1920
Helge Løvland,Norway,1,0,0,1,1920
Albert Andersson,Sweden,1,0,0,1,1920
Hal Brown,United States,1,0,0,1,1920
Mike Devaney,United States,1,0,0,1,1920
Ivan Dresser,United States,1,0,0,1,1920
Frank Foss,United States,1,0,0,1,1920
Dick Landon,United States,1,0,0,1,1920
Frank Loomis,United States,1,0,0,1,1920
Pat McDonald,United States,1,0,0,1,1920
Loren Murchison,United States,1,0,0,1,1920
Arlie Schardt,United States,1,0,0,1,1920
Jackson Scholz,United States,1,0,0,1,1920
Dink Templeton,United States,1,0,0,1,1920
Allen Woodring,United States,1,0,0,1,1920
Colin Campbell,Great Britain,1,0,0,1,1920
Ludowika Jakobsson-Eilers,Finland,1,0,0,1,1920
Magda Julin,Sweden,1,0,0,1,1920
Bobby Benson,Canada,1,0,0,1,1920
Wally Byron,Canada,1,0,0,1,1920
Frank Fredrickson,Canada,1,0,0,1,1920
Chris Fridfinnson,Canada,1,0,0,1,1920
Mike Goodman,Canada,1,0,0,1,1920
Gillis Grafström,Sweden,1,0,0,1,1920
Slim Halderson,Canada,1,0,0,1,1920
Walter Jakobsson,Finland,1,0,0,1,1920
Konnie Johannesson,Canada,1,0,0,1,1920
Huck Woodman,Canada,1,0,0,1,1920
Albéric Collin,Belgium,1,0,0,1,1920
Georges Monier,Belgium,1,0,0,1,1920
Raniero Nicolai,Italy,1,0,0,1,1920
Léonce Quentin,France,0,3,1,4,1920
Østen Østensen,Norway,0,2,2,4,1920
Léon Epin,France,0,2,1,3,1920
Pascal Fauvel,France,0,2,1,3,1920
Eugène Grisot,France,0,2,1,3,1920
Paul Leroy,France,0,2,1,3,1920
Arthur Mabillon,France,0,2,1,3,1920
Eugène Richez,France,0,2,1,3,1920
Georges Trombert,France,0,2,1,3,1920
Albert Helgerud,Norway,0,2,1,3,1920
Olaf Sletten,Norway,0,2,1,3,1920
Fredric Landelius,Sweden,0,2,1,3,1920
Alf Swahn,Sweden,0,2,1,3,1920
Dorothy Holman,Great Britain,0,2,0,2,1920
Ichiya Kumagae,Japan,0,2,0,2,1920
Field,France,0,2,0,2,1920
Albert Alden,Great Britain,0,2,0,2,1920
Thomas Johnson,Great Britain,0,2,0,2,1920
Philippe Cattiau,France,0,2,0,2,1920
Léon Johnson,France,0,2,0,2,1920
Sigvard Hultcrantz,Sweden,0,2,0,2,1920
Thor Henning,Sweden,0,2,0,2,1920
Eric Backman,Sweden,0,1,3,4,1920
Ettore Caffaratti,Italy,0,1,2,3,1920
Magnus Wegelius,Finland,0,1,2,3,1920
Mauritz Eriksson,Sweden,0,1,2,3,1920
Giulio Cacciandra,Italy,0,1,1,2,1920
Henry Kaltenbrunn,South Africa,0,1,1,2,1920
Bill Smith,South Africa,0,1,1,2,1920
James Walker,South Africa,0,1,1,2,1920
Gaston Amson,France,0,1,1,2,1920
Roger Ducret,France,0,1,1,2,1920
Alexandre Lippmann,France,0,1,1,2,1920
Marco Torrès,France,0,1,1,2,1920
Afrânio da Costa,Brazil,0,1,1,2,1920
Yrjö Kolho,Finland,0,1,1,2,1920
Kalle Lappalainen,Finland,0,1,1,2,1920
Robert Tikkanen,Finland,0,1,1,2,1920
Nestori Toivonen,Finland,0,1,1,2,1920
Leon Lagerlöf,Sweden,0,1,1,2,1920
Erik Ohlsson,Sweden,0,1,1,2,1920
Tom Brown,United States,0,1,1,2,1920
Frank Beaurepaire,Australasia,0,1,1,2,1920
Gérard Blitz,Belgium,0,1,1,2,1920
George Vernot,Canada,0,1,1,2,1920
James Wilson,Great Britain,0,1,1,2,1920
Carl Johan Lind,Sweden,0,1,1,2,1920
Geraldine Beamish,Great Britain,0,1,0,1,1920
Seiichiro Kashio,Japan,0,1,0,1,1920
Cliff Graham,Canada,0,1,0,1,1920
Art Prud'homme,Canada,0,1,0,1,1920
Gotfred Johansen,Denmark,0,1,0,1,1920
Anders Pedersen,Denmark,0,1,0,1,1920
Søren Petersen,Denmark,0,1,0,1,1920
Jean Gachet,France,0,1,0,1,1920
Alex Ireland,Great Britain,0,1,0,1,1920
Sverre Sørsdal,Norway,0,1,0,1,1920
Cauchy,France,0,1,0,1,1920
André Coumans,Belgium,0,1,0,1,1920
Herman d'Oultremont,Belgium,0,1,0,1,1920
Herman de Gaiffier d'Hestroy,Belgium,0,1,0,1,1920
Henri Laame,Belgium,0,1,0,1,1920
Salins,France,0,1,0,1,1920
Bertil Sandström,Sweden,0,1,0,1,1920
Garibaldi Spighi,Italy,0,1,0,1,1920
Alessandro Valerio,Italy,0,1,0,1,1920
Sigge Lundberg,Sweden,0,1,0,1,1920
Ragnar Malm,Sweden,0,1,0,1,1920
Axel Wilhelm Persson,Sweden,0,1,0,1,1920
Jock Stewart,Great Britain,0,1,0,1,1920
Albert White,Great Britain,0,1,0,1,1920
Álvaro de Figueroa,Spain,0,1,0,1,1920
José de Figueroa,Spain,0,1,0,1,1920
Hernando Fitz-James,Spain,0,1,0,1,1920
Jacobo Fitz-James,Spain,0,1,0,1,1920
Leopoldo Saínz de la Maza,Spain,0,1,0,1,1920
Édouard Bader,France,0,1,0,1,1920
François Borde,France,0,1,0,1,1920
Adolphe Bousquet,France,0,1,0,1,1920
Jean Bruneval,France,0,1,0,1,1920
Alphonse Castex,France,0,1,0,1,1920
René Crabos,France,0,1,0,1,1920
Curtet,France,0,1,0,1,1920
Alfred Eluère,France,0,1,0,1,1920
Jacques Forestier,France,0,1,0,1,1920
Maurice Labeyrie,France,0,1,0,1,1920
Robert Levasseur,France,0,1,0,1,1920
Pierre Petiteau,France,0,1,0,1,1920
Raoul Thiercelin,France,0,1,0,1,1920
Wim Bekkers,Netherlands,0,1,0,1,1920
Jan Hengeveld,Netherlands,0,1,0,1,1920
Sijtse Jansma,Netherlands,0,1,0,1,1920
Henk Janssen,Netherlands,0,1,0,1,1920
Anton van Loon,Netherlands,0,1,0,1,1920
Willem van Loon,Netherlands,0,1,0,1,1920
Rinus van Rekum,Netherlands,0,1,0,1,1920
Wim van Rekum,Netherlands,0,1,0,1,1920
Hans Bjerrum,Denmark,0,1,0,1,1920
Ejvind Blach,Denmark,0,1,0,1,1920
Svend Blach,Denmark,0,1,0,1,1920
Steen Due,Denmark,0,1,0,1,1920
Thorvald Eigenbrod,Denmark,0,1,0,1,1920
Frands Faber,Denmark,0,1,0,1,1920
Hans Jørgen Hansen,Denmark,0,1,0,1,1920
Hans Christian Herlak,Denmark,0,1,0,1,1920
Henning Holst,Denmark,0,1,0,1,1920
Erik Husted,Denmark,0,1,0,1,1920
Paul Metz,Denmark,0,1,0,1,1920
Andreas Rasmussen,Denmark,0,1,0,1,1920
Paul Anspach,Belgium,0,1,0,1,1920
Victor Boin,Belgium,0,1,0,1,1920
Joseph De Craecker,Belgium,0,1,0,1,1920
Ernest Gevers,Belgium,0,1,0,1,1920
"Félix, Count Goblet d'Alviella",Belgium,0,1,0,1,1920
Philippe Le Hardy de Beaulieu,Belgium,0,1,0,1,1920
Léon Tom,Belgium,0,1,0,1,1920
"Lionel, Marquis de Castellane-Majastres",France,0,1,0,1,1920
Henri de Saint Germain,France,0,1,0,1,1920
Lucien Gaudin,France,0,1,0,1,1920
André Labatut,France,0,1,0,1,1920
Jean Margraff,France,0,1,0,1,1920
Marc Perrodon,France,0,1,0,1,1920
Marcel Perrot,France,0,1,0,1,1920
Patricio Arabolaza,Spain,0,1,0,1,1920
Mariano Arrate,Spain,0,1,0,1,1920
Artola,Spain,0,1,0,1,1920
Belauste,Spain,0,1,0,1,1920
Sabino,Spain,0,1,0,1,1920
Ramón Eguiazábal,Spain,0,1,0,1,1920
Moncho Gil,Spain,0,1,0,1,1920
Acedo,Spain,0,1,0,1,1920
Silverio,Spain,0,1,0,1,1920
Pichichi,Spain,0,1,0,1,1920
Otero,Spain,0,1,0,1,1920
Pagaza,Spain,0,1,0,1,1920
Samitier,Spain,0,1,0,1,1920
Sancho,Spain,0,1,0,1,1920
Sesúmaga,Spain,0,1,0,1,1920
Vallana,Spain,0,1,0,1,1920
Joaquín Vázquez,Spain,0,1,0,1,1920
Ricardo Zamora,Spain,0,1,0,1,1920
Eugène Auwerkeren,Belgium,0,1,0,1,1920
Théophile Bauer,Belgium,0,1,0,1,1920
François Claessens,Belgium,0,1,0,1,1920
Augustus Cootmans,Belgium,0,1,0,1,1920
François Gibens,Belgium,0,1,0,1,1920
Albert Haepers,Belgium,0,1,0,1,1920
Domien Jacob,Belgium,0,1,0,1,1920
Félicien Kempeneers,Belgium,0,1,0,1,1920
Jules Labéeu,Belgium,0,1,0,1,1920
Hubert Lafortune,Belgium,0,1,0,1,1920
Auguste Landrieu,Belgium,0,1,0,1,1920
Charles Lannie,Belgium,0,1,0,1,1920
Constant Loriot,Belgium,0,1,0,1,1920
Nicolaas Moerloos,Belgium,0,1,0,1,1920
Ferdinand Minnaert,Belgium,0,1,0,1,1920
Louis Stoop,Belgium,0,1,0,1,1920
Jean Van Guysse,Belgium,0,1,0,1,1920
Alphonse Van Mele,Belgium,0,1,0,1,1920
François Verboven,Belgium,0,1,0,1,1920
Jean Verboven,Belgium,0,1,0,1,1920
Julien Verdonck,Belgium,0,1,0,1,1920
Joseph Verstraeten,Belgium,0,1,0,1,1920
Georges Vivex,Belgium,0,1,0,1,1920
Julianus Wagemans,Belgium,0,1,0,1,1920
Johannes Birk,Denmark,0,1,0,1,1920
Frede Hansen,Denmark,0,1,0,1,1920
Frederik Hansen,Denmark,0,1,0,1,1920
Kristian Hansen,Denmark,0,1,0,1,1920
Hans Hovgaard Jakobsen,Denmark,0,1,0,1,1920
Aage Jørgensen,Denmark,0,1,0,1,1920
Alfred Jørgensen,Denmark,0,1,0,1,1920
Alfred Ollerup,Denmark,0,1,0,1,1920
Arne Jørgensen,Denmark,0,1,0,1,1920
Knud Kirkeløkke,Denmark,0,1,0,1,1920
Jens Lambæk,Denmark,0,1,0,1,1920
Kristjan Larsen,Denmark,0,1,0,1,1920
Kristian Madsen,Denmark,0,1,0,1,1920
Niels Kristian Nielsen,Denmark,0,1,0,1,1920
Niels Erik Nielsen,Denmark,0,1,0,1,1920
Dynes Pedersen,Denmark,0,1,0,1,1920
Hans Pedersen,Denmark,0,1,0,1,1920
Johannes Pedersen,Denmark,0,1,0,1,1920
Peder Dorf Pedersen,Denmark,0,1,0,1,1920
Rasmus Rasmussen,Denmark,0,1,0,1,1920
Hans Christian Sørensen,Denmark,0,1,0,1,1920
Hans Laurids Sørensen,Denmark,0,1,0,1,1920
Søren Sørensen,Denmark,0,1,0,1,1920
Georg Vest,Denmark,0,1,0,1,1920
Aage Walther,Denmark,0,1,0,1,1920
Jørgen Andersen,Norway,0,1,0,1,1920
Gustav Bayer,Norway,0,1,0,1,1920
Jørgen Bjørnstad,Norway,0,1,0,1,1920
Asbjørn Bodahl,Norway,0,1,0,1,1920
Eilert Bøhm,Norway,0,1,0,1,1920
Trygve Bøyesen,Norway,0,1,0,1,1920
Ingolf Davidsen,Norway,0,1,0,1,1920
Haakon Endreson,Norway,0,1,0,1,1920
Jakob Erstad,Norway,0,1,0,1,1920
Harald Færstad,Norway,0,1,0,1,1920
Herman Helgesen,Norway,0,1,0,1,1920
Peter Hol,Norway,0,1,0,1,1920
Otto Johannessen,Norway,0,1,0,1,1920
Johan Anker Johansen,Norway,0,1,0,1,1920
Trygve Kristoffersen,Norway,0,1,0,1,1920
Henrik Nilsen,Norway,0,1,0,1,1920
Jacob Opdahl,Norway,0,1,0,1,1920
Arthur Rydstrøm,Norway,0,1,0,1,1920
Frithjof Sælen,Norway,0,1,0,1,1920
Bjørn Skjærpe,Norway,0,1,0,1,1920
Wilhelm Steffensen,Norway,0,1,0,1,1920
Olav Sundal,Norway,0,1,0,1,1920
Reidar Tønsberg,Norway,0,1,0,1,1920
Lauritz Wigand-Larsen,Norway,0,1,0,1,1920
Alf Aanning,Norway,0,1,0,1,1920
Karl Aas,Norway,0,1,0,1,1920
Erik de Laval,Sweden,0,1,0,1,1920
Ernest Barberolle,France,0,1,0,1,1920
Maurice Monney-Bouton,France,0,1,0,1,1920
Gabriel Poix,France,0,1,0,1,1920
Jack Beresford,Great Britain,0,1,0,1,1920
John Campbell,Great Britain,0,1,0,1,1920
Sebastian Earl,Great Britain,0,1,0,1,1920
Ewart Horsfall,Great Britain,0,1,0,1,1920
Walter James,Great Britain,0,1,0,1,1920
Robin Johnstone,Great Britain,0,1,0,1,1920
Richard Lucas,Great Britain,0,1,0,1,1920
Guy O. Nickalls,Great Britain,0,1,0,1,1920
Ralph Shove,Great Britain,0,1,0,1,1920
Sidney Swann,Great Britain,0,1,0,1,1920
Pietro Annoni,Italy,0,1,0,1,1920
Erminio Dones,Italy,0,1,0,1,1920
Annan Knudsen,Norway,0,1,0,1,1920
Erich Federschmidt,United States,0,1,0,1,1920
Franz Federschmidt,United States,0,1,0,1,1920
Carl Klose,United States,0,1,0,1,1920
Ken Myers,United States,0,1,0,1,1920
Albert Bosquet,Belgium,0,1,0,1,1920
Joseph Cogels,Belgium,0,1,0,1,1920
Émile Dupont,Belgium,0,1,0,1,1920
Edouard Feisinger,Belgium,0,1,0,1,1920
Henri Quersin,Belgium,0,1,0,1,1920
Louis Van Tilt,Belgium,0,1,0,1,1920
André Parmentier,France,0,1,0,1,1920
Achille Paroche,France,0,1,0,1,1920
Georges Roes,France,0,1,0,1,1920
Émile Rumeau,France,0,1,0,1,1920
Georgios Moraitinis,Greece,0,1,0,1,1920
Alexandros Theofilakis,Greece,0,1,0,1,1920
Ioannis Theofilakis,Greece,0,1,0,1,1920
Alexandros Vrasivanopoulos,Greece,0,1,0,1,1920
Iason Sappas,Greece,0,1,0,1,1920
Jakob Onsrud,Norway,0,1,0,1,1920
Gudbrand Skatteboe,Norway,0,1,0,1,1920
Bob Bodley,South Africa,0,1,0,1,1920
Ferdinand Buchanan,South Africa,0,1,0,1,1920
George Harvey,South Africa,0,1,0,1,1920
Freddie Morgan,South Africa,0,1,0,1,1920
David Smith,South Africa,0,1,0,1,1920
Anders Andersson,Sweden,0,1,0,1,1920
Edward Benedicks,Sweden,0,1,0,1,1920
Gunnar Gabrielsson,Sweden,0,1,0,1,1920
Anders Johnsson,Sweden,0,1,0,1,1920
Bengt Lagercrantz,Sweden,0,1,0,1,1920
Casimir Reuterskiöld,Sweden,0,1,0,1,1920
Ragnar Stare,Sweden,0,1,0,1,1920
Oscar Swahn,Sweden,0,1,0,1,1920
Harry Hay,Australia,0,1,0,1,1920
Billy Herald,Australia,0,1,0,1,1920
Ivan Stedman,Australia,0,1,0,1,1920
René Bauwens,Belgium,0,1,0,1,1920
Eileen Armstrong,Great Britain,0,1,0,1,1920
Hilda James,Great Britain,0,1,0,1,1920
Connie Jeans,Great Britain,0,1,0,1,1920
Grace McKenzie,Great Britain,0,1,0,1,1920
Charlotte Radcliffe,Great Britain,0,1,0,1,1920
Erik Adlerz,Sweden,0,1,0,1,1920
Nils Skoglund,Sweden,0,1,0,1,1920
Helen Wainwright,United States,0,1,0,1,1920
Ray Kegeris,United States,0,1,0,1,1920
Ludy Langer,United States,0,1,0,1,1920
Maurice Blitz,Belgium,0,1,0,1,1920
Pierre Dewin,Belgium,0,1,0,1,1920
Albert Durant,Belgium,0,1,0,1,1920
Paul Gailly,Belgium,0,1,0,1,1920
Pierre Nijs,Belgium,0,1,0,1,1920
Joseph Pletincx,Belgium,0,1,0,1,1920
Louis Williquet,Belgium,0,1,0,1,1920
Alfred Schmidt,Estonia,0,1,0,1,1920
Pietro Bianchi,Italy,0,1,0,1,1920
Jos Alzin,Luxembourg,0,1,0,1,1920
Fritz Hünenberger,Switzerland,0,1,0,1,1920
Poul Hansen,Denmark,0,1,0,1,1920
Heikki Kähkönen,Finland,0,1,0,1,1920
Arthur Lindfors,Finland,0,1,0,1,1920
Väinö Penttala,Finland,0,1,0,1,1920
Edil Rosenqvist,Finland,0,1,0,1,1920
Taavi Tamminen,Finland,0,1,0,1,1920
Charles Courant,Switzerland,0,1,0,1,1920
Gottfrid Svensson,Sweden,0,1,0,1,1920
Sam Gerson,United States,0,1,0,1,1920
Nat Pendleton,United States,0,1,0,1,1920
Sten Abel,Norway,0,1,0,1,1920
Percy Almstedt,Sweden,0,1,0,1,1920
Petrus Beukers,Netherlands,0,1,0,1,1920
Christian Dick,Norway,0,1,0,1,1920
Leif Erichsen,Norway,0,1,0,1,1920
Johan Faye,Norway,0,1,0,1,1920
Léon Huybrechts,Belgium,0,1,0,1,1920
John Klotz,Belgium,0,1,0,1,1920
Erik Mellbin,Sweden,0,1,0,1,1920
Robert Monier,France,0,1,0,1,1920
Niels Nielsen,Norway,0,1,0,1,1920
Félix Picon,France,0,1,0,1,1920
Jens Salvesen,Norway,0,1,0,1,1920
Fin Schiander,Norway,0,1,0,1,1920
Lauritz Schmidt,Norway,0,1,0,1,1920
Gustaf Svensson,Sweden,0,1,0,1,1920
Ragnar Svensson,Sweden,0,1,0,1,1920
Nils Thomas,Norway,0,1,0,1,1920
Einar Torgersen,Norway,0,1,0,1,1920
Ralph Tschudi,Norway,0,1,0,1,1920
Charles Van Den Bussche,Belgium,0,1,0,1,1920
Arnoud van der Biesen,Netherlands,0,1,0,1,1920
Albert Weil,France,0,1,0,1,1920
George Parker,Australia,0,1,0,1,1920
Henry Petersen,Denmark,0,1,0,1,1920
Jüri Lossman,Estonia,0,1,0,1,1920
Urho Peltonen,Finland,0,1,0,1,1920
Armas Taipale,Finland,0,1,0,1,1920
Émile Ali Khan,France,0,1,0,1,1920
André Chilo,France,0,1,0,1,1920
René Lorain,France,0,1,0,1,1920
René Mourlon,France,0,1,0,1,1920
René Tirard,France,0,1,0,1,1920
Joe Blewitt,Great Britain,0,1,0,1,1920
Larry Cummins,Great Britain,0,1,0,1,1920
Walter Freeman,Great Britain,0,1,0,1,1920
James Hatton,Great Britain,0,1,0,1,1920
Anton Hegarty,Great Britain,0,1,0,1,1920
Duncan McPhee,Great Britain,0,1,0,1,1920
Alfred Nichols,Great Britain,0,1,0,1,1920
Philip Baker,Great Britain,0,1,0,1,1920
William Seagrove,Great Britain,0,1,0,1,1920
Christopher Vose,Great Britain,0,1,0,1,1920
Yngvar Bryn,Norway,0,1,0,1,1920
Henry Dafel,South Africa,0,1,0,1,1920
Clarence Oldfield,South Africa,0,1,0,1,1920
Jack Oosterlaak,South Africa,0,1,0,1,1920
Folke Jansson,Sweden,0,1,0,1,1920
Hal Barron,United States,0,1,0,1,1920
Everett Bradley,United States,0,1,0,1,1920
Earl Eby,United States,0,1,0,1,1920
Pat Flynn,United States,0,1,0,1,1920
Brutus Hamilton,United States,0,1,0,1,1920
Carl Johnson,United States,0,1,0,1,1920
Harold Muller,United States,0,1,0,1,1920
John Norton,United States,0,1,0,1,1920
Joe Pearman,United States,0,1,0,1,1920
Grenet,France,0,1,0,1,1920
Svea Norén,Sweden,0,1,0,1,1920
Alexia Bryn,Norway,0,1,0,1,1920
Ray Bonney,United States,0,1,0,1,1920
Tony Conroy,United States,0,1,0,1,1920
Herb Drury,United States,0,1,0,1,1920
Ed Fitzgerald,United States,0,1,0,1,1920
Gerry Geran,United States,0,1,0,1,1920
Moose Goheen,United States,0,1,0,1,1920
Andreas Krogh,Norway,0,1,0,1,1920
Joe McCormick,United States,0,1,0,1,1920
Larry McCormick,United States,0,1,0,1,1920
Frank Synnott,United States,0,1,0,1,1920
Leon Tuck,United States,0,1,0,1,1920
Cy Weidenborner,United States,0,1,0,1,1920
Oscar Eriksson,Sweden,0,1,0,1,1920
Simon Goossens,Belgium,0,1,0,1,1920
Henriette Brossin de Mère-de Polanska,France,0,1,0,1,1920
Theodore Andrea Cook,Great Britain,0,1,0,1,1920
Oreste Riva,Italy,0,1,0,1,1920
Holger Sinding-Larsen,Norway,0,1,0,1,1920
Fritz Kuchen,Switzerland,0,0,3,3,1920
Piet Ikelaar,Netherlands,0,0,2,2,1920
Gustave Buchard,France,0,0,2,2,1920
Arie de Jong,Netherlands,0,0,2,2,1920
Thoralf Hagen,Norway,0,0,2,2,1920
Vilho Vauhkonen,Finland,0,0,2,2,1920
Gustave Amoudruz,Switzerland,0,0,2,2,1920
Joseph Jehle,Switzerland,0,0,2,2,1920
Werner Schneeberger,Switzerland,0,0,2,2,1920
Fritz Zulauf,Switzerland,0,0,2,2,1920
Arvo Aaltonen,Finland,0,0,2,2,1920
Harry Edward,Great Britain,0,0,2,2,1920
Moe Herscovitch,Canada,0,0,1,1,1920
Chris Newton,Canada,0,0,1,1,1920
Élisabeth d'Ayen,France,0,0,1,1,1920
Pierre Albarran,France,0,0,1,1,1920
Charles Winslow,South Africa,0,0,1,1,1920
Milada Skrbková,Czech Republic,0,0,1,1,1920
Ladislav Žemla,Bohemia,0,0,1,1,1920
Xavier Eluère,France,0,0,1,1,1920
William Cuthbertson,Great Britain,0,0,1,1,1920
Harry Franks,Great Britain,0,0,1,1,1920
George McKenzie,Great Britain,0,0,1,1,1920
Edoardo Garzena,Italy,0,0,1,1,1920
Fred Kolberg,United States,0,0,1,1,1920
Edouard Bourguignon,Belgium,0,0,1,1,1920
Alphonse Ducatillon,Belgium,0,0,1,1,1920
Rémy Maertens,Belgium,0,0,1,1,1920
Christian Piek,Belgium,0,0,1,1,1920
Henri Pintens,Belgium,0,0,1,1,1920
Charles Van Den Broeck,Belgium,0,0,1,1,1920
François Van Hoorenbeek,Belgium,0,0,1,1,1920
Alessandro Alvisi,Italy,0,0,1,1,1920
Carlo Asinari Di San Marzano,Italy,0,0,1,1,1920
Jules Bonvalet,Belgium,0,0,1,1,1920
Carl Green,Sweden,0,0,1,1,1920
Carl Gustaf Lewenhaupt,Sweden,0,0,1,1,1920
Oswald Lints,Belgium,0,0,1,1,1920
Roger Moeremans d'Emaüs,Belgium,0,0,1,1,1920
Jack Montgomery,United States,0,0,1,1,1920
Anders Mårtensson,Sweden,0,0,1,1,1920
Oskar Nilsson,Sweden,0,0,1,1,1920
Albert De Bunné,Belgium,0,0,1,1,1920
Frans de Vreng,Netherlands,0,0,1,1,1920
Sammy Goosen,South Africa,0,0,1,1,1920
Jean Janssens,Belgium,0,0,1,1,1920
André Vercruysse,Belgium,0,0,1,1,1920
Albert Wyckmans,Belgium,0,0,1,1,1920
André Becquet,Belgium,0,0,1,1,1920
Pierre Chibert,Belgium,0,0,1,1,1920
Raoul Daufresne de la Chevalerie,Belgium,0,0,1,1,1920
Charles Delelienne,Belgium,0,0,1,1,1920
Louis Diercxsens,Belgium,0,0,1,1,1920
Robert Gevers,Belgium,0,0,1,1,1920
Charles Gniette,Belgium,0,0,1,1,1920
Adolphe Goemaere,Belgium,0,0,1,1,1920
Raymond Keppens,Belgium,0,0,1,1,1920
René Strauwen,Belgium,0,0,1,1,1920
Pierre Valcke,Belgium,0,0,1,1,1920
Maurice Van Den Bemden,Belgium,0,0,1,1,1920
Jean Van Nerom,Belgium,0,0,1,1,1920
Terry Allen,United States,0,0,1,1,1920
Arthur Harris,United States,0,0,1,1,1920
Nelson Margetts,United States,0,0,1,1,1920
Fernand de Montigny,Belgium,0,0,1,1,1920
Georges Casanova,France,0,0,1,1,1920
Louis Moreau,France,0,0,1,1,1920
Louis Delaunoij,Netherlands,0,0,1,1,1920
Jetze Doorman,Netherlands,0,0,1,1,1920
Willem Hubert van Blijenburgh,Netherlands,0,0,1,1,1920
Jan van der Wiel,Netherlands,0,0,1,1,1920
Henri Wijnoldy-Daniëls,Netherlands,0,0,1,1,1920
Salomon Zeldenrust,Netherlands,0,0,1,1,1920
Henry Breckinridge,United States,0,0,1,1,1920
Francis Honeycutt,United States,0,0,1,1,1920
Arthur Lyon,United States,0,0,1,1,1920
Harold Rayner,United States,0,0,1,1,1920
Robert Sears,United States,0,0,1,1,1920
Arie Bieshaar,Netherlands,0,0,1,1,1920
Leo Bosschart,Netherlands,0,0,1,1,1920
Evert Jan Bulder,Netherlands,0,0,1,1,1920
Jaap Bulder,Netherlands,0,0,1,1,1920
Jan de Natris,Netherlands,0,0,1,1,1920
Harry Dénis,Netherlands,0,0,1,1,1920
Ber Groosjohan,Netherlands,0,0,1,1,1920
Frits Kuipers,Netherlands,0,0,1,1,1920
Dick Mac Neill,Netherlands,0,0,1,1,1920
Henk Steeman,Netherlands,0,0,1,1,1920
Jan van Dort,Netherlands,0,0,1,1,1920
Ben Verweij,Netherlands,0,0,1,1,1920
"Felix, Jonkheer von Heijden",Netherlands,0,0,1,1,1920
Paul Arets,Belgium,0,0,1,1,1920
Léon Bronckaert,Belgium,0,0,1,1,1920
Léopold Clabots,Belgium,0,0,1,1,1920
Jean-Baptiste Claessens,Belgium,0,0,1,1,1920
Léon Darrien,Belgium,0,0,1,1,1920
Lucien Dehoux,Belgium,0,0,1,1,1920
Ernest Deleu,Belgium,0,0,1,1,1920
Émile Duboisson,Belgium,0,0,1,1,1920
Ernest Dureuil,Belgium,0,0,1,1,1920
Joseph Fiems,Belgium,0,0,1,1,1920
Marcel Hansen,Belgium,0,0,1,1,1920
Louis Henin,Belgium,0,0,1,1,1920
Omer Hoffman,Belgium,0,0,1,1,1920
Félix Logiest,Belgium,0,0,1,1,1920
Charles Maerschalck,Belgium,0,0,1,1,1920
René Paenhuijsen,Belgium,0,0,1,1,1920
Arnold Pierret,Belgium,0,0,1,1,1920
René Pinchart,Belgium,0,0,1,1,1920
Gaspard Pirotte,Belgium,0,0,1,1,1920
Augustien Pluys,Belgium,0,0,1,1,1920
Léopold Son,Belgium,0,0,1,1,1920
Édouard Taeymans,Belgium,0,0,1,1,1920
Pierre Thiriar,Belgium,0,0,1,1,1920
Henri Verhavert,Belgium,0,0,1,1,1920
Georges Berger,France,0,0,1,1,1920
Émile Bouchès,France,0,0,1,1,1920
René Boulanger,France,0,0,1,1,1920
Alfred Buyenne,France,0,0,1,1,1920
Léon Delsarte,France,0,0,1,1,1920
Lucien Démanet,France,0,0,1,1,1920
Paul Durin,France,0,0,1,1,1920
Victor Duvant,France,0,0,1,1,1920
Fernand Fauconnier,France,0,0,1,1,1920
Jean Gounot,France,0,0,1,1,1920
Arthur Hermann,France,0,0,1,1,1920
Albert Hersoy,France,0,0,1,1,1920
Alphonse Higelin,France,0,0,1,1,1920
Auguste Hoël,France,0,0,1,1,1920
Louis Kimpe,France,0,0,1,1,1920
Georges Lagouge,France,0,0,1,1,1920
Paulin Lemaire,France,0,0,1,1,1920
Ernest Lespinasse,France,0,0,1,1,1920
Émile Martel,France,0,0,1,1,1920
Eugène Cordonnier,France,0,0,1,1,1920
Jules Pirard,France,0,0,1,1,1920
Eugène Pollet,France,0,0,1,1,1920
Georges Thurnherr,France,0,0,1,1,1920
François Walker,France,0,0,1,1,1920
Julien Wartelle,France,0,0,1,1,1920
Paul Wartelle,France,0,0,1,1,1920
Gösta Runö,Sweden,0,0,1,1,1920
Gaston Giran,France,0,0,1,1,1920
Alfred Plé,France,0,0,1,1,1920
Haakon Ellingsen,Norway,0,0,1,1,1920
Per Gulbrandsen,Norway,0,0,1,1,1920
Theodor Klem,Norway,0,0,1,1,1920
Henry Larsen,Norway,0,0,1,1,1920
Thore Michelsen,Norway,0,0,1,1,1920
Arne Mortensen,Norway,0,0,1,1,1920
Karl Nag,Norway,0,0,1,1,1920
Theodor Nag,Norway,0,0,1,1,1920
Adolf Nilsen,Norway,0,0,1,1,1920
Conrad Olsen,Norway,0,0,1,1,1920
Tollef Tollefsen,Norway,0,0,1,1,1920
Birger Var,Norway,0,0,1,1,1920
Darcy Hadfield,New Zealand,0,0,1,1,1920
Édouard Candeveau,Switzerland,0,0,1,1,1920
Alfred Felber,Switzerland,0,0,1,1,1920
Paul Piaget,Switzerland,0,0,1,1,1920
Dario Barbosa,Brazil,0,0,1,1,1920
Fernando Soledade,Brazil,0,0,1,1,1920
Sebastião Wolf,Brazil,0,0,1,1,1920
Voitto Kolho,Finland,0,0,1,1,1920
Veli Nieminen,Finland,0,0,1,1,1920
Sigvart Johansen,Norway,0,0,1,1,1920
Anton Olsen,Norway,0,0,1,1,1920
Eugene Addor,Switzerland,0,0,1,1,1920
Hans Egli,Switzerland,0,0,1,1,1920
Ulrich Fahrner,Switzerland,0,0,1,1,1920
Domenico Giambonini,Switzerland,0,0,1,1,1920
Bernard Siegenthaler,Switzerland,0,0,1,1,1920
Weibel,Switzerland,0,0,1,1,1920
Erik Blomqvist,Sweden,0,0,1,1,1920
Olle Ericsson,Sweden,0,0,1,1,1920
Walfrid Hellman,Sweden,0,0,1,1,1920
Gustaf Adolf Jonsson,Sweden,0,0,1,1,1920
Per Kinde,Sweden,0,0,1,1,1920
Erik Lundquist,Sweden,0,0,1,1,1920
Karl Richter,Sweden,0,0,1,1,1920
Erik Sökjer-Petersén,Sweden,0,0,1,1,1920
Harold Annison,Great Britain,0,0,1,1,1920
Percy Peter,Great Britain,0,0,1,1,1920
Leslie Savage,Great Britain,0,0,1,1,1920
Henry Taylor,Great Britain,0,0,1,1,1920
Aina Berg,Sweden,0,0,1,1,1920
Jane Gylling,Sweden,0,0,1,1,1920
Emy Machnow,Sweden,0,0,1,1,1920
Carin Nilsson,Sweden,0,0,1,1,1920
Ewa Olliwier,Sweden,0,0,1,1,1920
Erik Andersson,Sweden,0,0,1,1,1920
Robert Andersson,Sweden,0,0,1,1,1920
Wille Andersson,Sweden,0,0,1,1,1920
Max Gumpel,Sweden,0,0,1,1,1920
Johan Jansson,Sweden,0,0,1,1,1920
Harald Julin,Sweden,0,0,1,1,1920
Thelma Payne,United States,0,0,1,1,1920
Louis Balbach,United States,0,0,1,1,1920
Bill Harris,United States,0,0,1,1,1920
Harry Prieste,United States,0,0,1,1,1920
Nils Backlund,Sweden,0,0,1,1,1920
Erik Bergqvist,Sweden,0,0,1,1,1920
Pontus Hanson,Sweden,0,0,1,1,1920
Torsten Kumfeldt,Sweden,0,0,1,1,1920
Theodor Nauman,Sweden,0,0,1,1,1920
Florimond Rooms,Belgium,0,0,1,1,1920
Louis Bernot,France,0,0,1,1,1920
Eugène Ryter,Switzerland,0,0,1,1,1920
Erik Pettersson,Sweden,0,0,1,1,1920
Albert Pettersson,Sweden,0,0,1,1,1920
Johannes Eriksen,Denmark,0,0,1,1,1920
Martti Nieminen,Finland,0,0,1,1,1920
Matti Perttilä,Finland,0,0,1,1,1920
Bernard Bernard,Great Britain,0,0,1,1,1920
H. A. Wright,Great Britain,0,0,1,1,1920
Frithjof Andersen,Norway,0,0,1,1,1920
Ernst Nilsson,Sweden,0,0,1,1,1920
Fritiof Svensson,Sweden,0,0,1,1,1920
Charley Johnson,United States,0,0,1,1,1920
Walter Maurer,United States,0,0,1,1,1920
Fred Meyer,United States,0,0,1,1,1920
Henrik Agersborg,Norway,0,0,1,1,1920
Einar Berntsen,Norway,0,0,1,1,1920
Willy De L'Arbre,Belgium,0,0,1,1,1920
Albert Grisar,Belgium,0,0,1,1,1920
"Georges Hellebuyck, Sr.",Belgium,0,0,1,1,1920
Trygve Pedersen,Norway,0,0,1,1,1920
Léopold Standaert,Belgium,0,0,1,1,1920
Henri Weewauters,Belgium,0,0,1,1,1920
Gustave Wuyts,Belgium,0,0,1,1,1920
Paavo Johansson,Finland,0,0,1,1,1920
Hugo Lahtinen,Finland,0,0,1,1,1920
Géo André,France,0,0,1,1,1920
Maurice Delvart,France,0,0,1,1,1920
André Devaux,France,0,0,1,1,1920
Gaston Féry,France,0,0,1,1,1920
Charlie Gunn,Great Britain,0,0,1,1,1920
Ernesto Ambrosini,Italy,0,0,1,1,1920
Valerio Arri,Italy,0,0,1,1,1920
"Oscar, Ridder van Rappard",Netherlands,0,0,1,1,1920
Erik Abrahamsson,Sweden,0,0,1,1,1920
Knut Alm,Sweden,0,0,1,1,1920
Erik Almlöf,Sweden,0,0,1,1,1920
Bo Ekelund,Sweden,0,0,1,1,1920
Hilding Ekman,Sweden,0,0,1,1,1920
Nils Engdahl,Sweden,0,0,1,1,1920
Lars Hedwall,Sweden,0,0,1,1,1920
Agne Holmström,Sweden,0,0,1,1,1920
Josef Holsner,Sweden,0,0,1,1,1920
Sven Emil Lundgren,Sweden,0,0,1,1,1920
Verner Magnusson,Sweden,0,0,1,1,1920
Sven Malm,Sweden,0,0,1,1,1920
Gustaf Mattsson,Sweden,0,0,1,1,1920
Bertil Ohlson,Sweden,0,0,1,1,1920
Nils Sandström,Sweden,0,0,1,1,1920
Edvin Wide,Sweden,0,0,1,1,1920
John Zander,Sweden,0,0,1,1,1920
Basil Bennett,United States,0,0,1,1,1920
Gus Desch,United States,0,0,1,1,1920
Harry Liversedge,United States,0,0,1,1,1920
Fred Murray,United States,0,0,1,1,1920
Ed Myers,United States,0,0,1,1,1920
Gus Pope,United States,0,0,1,1,1920
Richard Remer,United States,0,0,1,1,1920
Theresa Weld-Blanchard,United States,0,0,1,1,1920
Phyllis Johnson,Great Britain,0,0,1,1,1920
Karel Hartmann,Czech Republic,0,0,1,1,1920
Vilém Loos,Czech Republic,0,0,1,1,1920
Jan Palouš,Czech Republic,0,0,1,1,1920
Jan Peka,Czech Republic,0,0,1,1,1920
Karel Pešek,Czech Republic,0,0,1,1,1920
Josef Šroubek,Czech Republic,0,0,1,1,1920
Martin Stixrud,Norway,0,0,1,1,1920
Otakar Vindyš,Czech Republic,0,0,1,1,1920
Basil Williams,Great Britain,0,0,1,1,1920
Karel Wälzer,Czech Republic,0,0,1,1,1920
Maurice Bladel,Belgium,0,0,1,1,1920
Alphonse De Cuyper,Belgium,0,0,1,1,1920
Alfred Ost,Belgium,0,0,1,1,1920
Paavo Nurmi,Finland,5,0,0,5,1924
Ville Ritola,Finland,4,2,0,6,1924
Roger Ducret,France,3,2,0,5,1924
Johnny Weissmuller,United States,3,0,1,4,1924
Vinnie Richards,United States,2,1,0,3,1924
Ole Lilloe-Olsen,Norway,2,1,0,3,1924
Hazel Wightman,United States,2,0,0,2,1924
Helen Wills,United States,2,0,0,2,1924
Adolf van der Voort van Zijp,Netherlands,2,0,0,2,1924
Armand Blanchonnet,France,2,0,0,2,1924
Lucien Gaudin,France,2,0,0,2,1924
André Labatut,France,2,0,0,2,1924
Francesco Martino,Italy,2,0,0,2,1924
Leon Štukelj,Slovenia,2,0,0,2,1924
Émile Lachapelle,Switzerland,2,0,0,2,1924
Bud Fisher,United States,2,0,0,2,1924
Ethel Lackie,United States,2,0,0,2,1924
Al White,United States,2,0,0,2,1924
Bud Houser,United States,2,0,0,2,1924
Harold Osborn,United States,2,0,0,2,1924
Albert Séguin,France,1,2,0,3,1924
Cyril Mackworth-Praed,Great Britain,1,2,0,3,1924
Sándor Pósta,Hungary,1,1,1,3,1924
Otto Olsen,Norway,1,1,1,3,1924
Boy Charlton,Australia,1,1,1,3,1924
Alphonse Gemuseus,Switzerland,1,1,0,2,1924
Charles Delporte,Belgium,1,1,0,2,1924
Philippe Cattiau,France,1,1,0,2,1924
Einar Liberg,Norway,1,1,0,2,1924
Harald Natvig,Norway,1,1,0,2,1924
Betty Becker-Pinkston,United States,1,1,0,2,1924
Mariechen Wehselau,United States,1,1,0,2,1924
Elias Katz,Finland,1,1,0,2,1924
Harold Abrahams,Great Britain,1,1,0,2,1924
Jackson Scholz,United States,1,1,0,2,1924
August Güttinger,Switzerland,1,0,2,3,1924
Trudy Ederle,United States,1,0,2,3,1924
Jean Cugnot,France,1,0,1,2,1924
René Hamel,France,1,0,1,2,1924
Marcello Bertinetti,Italy,1,0,1,2,1924
Vincenzo Cuccia,Italy,1,0,1,2,1924
Oreste Moricca,Italy,1,0,1,2,1924
Giorgio Zampori,Italy,1,0,1,2,1924
Josef Wilhelm,Switzerland,1,0,1,2,1924
Bedřich Šupčík,Czech Republic,1,0,1,2,1924
Émile Albrecht,Switzerland,1,0,1,2,1924
Alfred Probst,Switzerland,1,0,1,2,1924
Eugen Sigg,Switzerland,1,0,1,2,1924
Hans Walter,Switzerland,1,0,1,2,1924
John Boles,United States,1,0,1,2,1924
Ray Coulter,United States,1,0,1,2,1924
Frank Hughes,United States,1,0,1,2,1924
Walter Stokes,United States,1,0,1,2,1924
Wally O'Connor,United States,1,0,1,2,1924
Eero Berg,Finland,1,0,1,2,1924
Eric Liddell,Great Britain,1,0,1,2,1924
Hans Nielsen,Denmark,1,0,0,1,1924
Frank Hunter,United States,1,0,0,1,1924
Dick Williams,United States,1,0,0,1,1924
Harry Mallin,Great Britain,1,0,0,1,1924
Harry Mitchell,Great Britain,1,0,0,1,1924
Otto von Porat,Norway,1,0,0,1,1924
Jean Delarge,Belgium,1,0,0,1,1924
Willie Smith,South Africa,1,0,0,1,1924
Jackie Fields,United States,1,0,0,1,1924
Fidel LaBarba,United States,1,0,0,1,1924
Guillermo Naylor,Argentina,1,0,0,1,1924
Arturo Kenny,Argentina,1,0,0,1,1924
Juan Miles,Argentina,1,0,0,1,1924
Jack Nelson,Argentina,1,0,0,1,1924
Enrique Padilla,Argentina,1,0,0,1,1924
Antonius Colenbrander,Netherlands,1,0,0,1,1924
Gerard de Kruijff,Netherlands,1,0,0,1,1924
Ernst Linder,Sweden,1,0,0,1,1924
Åge Lundström,Sweden,1,0,0,1,1924
Charles Pahud de Mortanges,Netherlands,1,0,0,1,1924
Axel Ståhle,Sweden,1,0,0,1,1924
Åke Thelning,Sweden,1,0,0,1,1924
Georg von Braun,Sweden,1,0,0,1,1924
Lucien Choury,France,1,0,0,1,1924
Angelo De Martini,Italy,1,0,0,1,1924
Alfredo Dinale,Italy,1,0,0,1,1924
André Leducq,France,1,0,0,1,1924
Aleardo Menegazzi,Italy,1,0,0,1,1924
Lucien Michard,France,1,0,0,1,1924
Georges Wambst,France,1,0,0,1,1924
Ko Willems,Netherlands,1,0,0,1,1924
Francesco Zucchetti,Italy,1,0,0,1,1924
Phil Clark,United States,1,0,0,1,1924
Norman Cleaveland,United States,1,0,0,1,1924
Dudley DeGroot,United States,1,0,0,1,1924
Bob Devereaux,United States,1,0,0,1,1924
George Dixon,United States,1,0,0,1,1924
Charlie Doe,United States,1,0,0,1,1924
Linn Farish,United States,1,0,0,1,1924
Ed Graff,United States,1,0,0,1,1924
Dick Hyland,United States,1,0,0,1,1924
Caesar Mannelli,United States,1,0,0,1,1924
John O'Neil,United States,1,0,0,1,1924
Jack Patrick,United States,1,0,0,1,1924
William Rogers,United States,1,0,0,1,1924
Rudy Scholz,United States,1,0,0,1,1924
Babe Slater,United States,1,0,0,1,1924
Norm Slater,United States,1,0,0,1,1924
Ed Turkington,United States,1,0,0,1,1924
Alan Valentine,United States,1,0,0,1,1924
Alan Williams,United States,1,0,0,1,1924
Ellen Osiier,Denmark,1,0,0,1,1924
Géo Buchard,France,1,0,0,1,1924
Jacques Coutrot,France,1,0,0,1,1924
Guy de Luget,France,1,0,0,1,1924
Henri Jobier,France,1,0,0,1,1924
Robert Liottel,France,1,0,0,1,1924
Alexandre Lippmann,France,1,0,0,1,1924
Joseph Perotaux,France,1,0,0,1,1924
Georges Tainturier,France,1,0,0,1,1924
Renato Anselmi,Italy,1,0,0,1,1924
Guido Balzarini,Italy,1,0,0,1,1924
Bino Bini,Italy,1,0,0,1,1924
Oreste Puliti,Italy,1,0,0,1,1924
Giulio Sarrocchi,Italy,1,0,0,1,1924
José Leandro Andrade,Uruguay,1,0,0,1,1924
Pedro Arispe,Uruguay,1,0,0,1,1924
Pedro Cea,Uruguay,1,0,0,1,1924
Alfredo Ghierra,Uruguay,1,0,0,1,1924
Andrés Mazali,Uruguay,1,0,0,1,1924
José Nasazzi,Uruguay,1,0,0,1,1924
José Naya,Uruguay,1,0,0,1,1924
Pedro Petrone,Uruguay,1,0,0,1,1924
Ángel Romano,Uruguay,1,0,0,1,1924
Héctor Scarone,Uruguay,1,0,0,1,1924
Humberto Tomassina,Uruguay,1,0,0,1,1924
Santos Urdinarán,Uruguay,1,0,0,1,1924
José Vidal,Uruguay,1,0,0,1,1924
Alfredo Zibechi,Uruguay,1,0,0,1,1924
Luigi Cambiaso,Italy,1,0,0,1,1924
Mario Lertora,Italy,1,0,0,1,1924
Vittorio Lucchetti,Italy,1,0,0,1,1924
Luigi Maiocco,Italy,1,0,0,1,1924
Ferdinando Mandrini,Italy,1,0,0,1,1924
Giuseppe Paris,Italy,1,0,0,1,1924
Frank Kriz,United States,1,0,0,1,1924
Bo Lindman,Sweden,1,0,0,1,1924
Jack Beresford,Great Britain,1,0,0,1,1924
Maxwell Eley,Great Britain,1,0,0,1,1924
James Macnabb,Great Britain,1,0,0,1,1924
Robert Morrison,Great Britain,1,0,0,1,1924
Terence Sanders,Great Britain,1,0,0,1,1924
Teun Beijnen,Netherlands,1,0,0,1,1924
Willy Rösingh,Netherlands,1,0,0,1,1924
Édouard Candeveau,Switzerland,1,0,0,1,1924
Alfred Felber,Switzerland,1,0,0,1,1924
Walter Loosli,Switzerland,1,0,0,1,1924
Leonard Carpenter,United States,1,0,0,1,1924
Paul Costello,United States,1,0,0,1,1924
"Jack Kelly, Sr.",United States,1,0,0,1,1924
Howard Kingsbury,United States,1,0,0,1,1924
Al Lindley,United States,1,0,0,1,1924
John Miller,United States,1,0,0,1,1924
Babe Rockefeller,United States,1,0,0,1,1924
Fred Sheffield,United States,1,0,0,1,1924
Ben Spock,United States,1,0,0,1,1924
Chick Stoddard,United States,1,0,0,1,1924
Al Wilson,United States,1,0,0,1,1924
Pierre Coquelin de Lisle,France,1,0,0,1,1924
Philip Neame,Great Britain,1,0,0,1,1924
Herbert Perry,Great Britain,1,0,0,1,1924
Allen Whitty,Great Britain,1,0,0,1,1924
Gyula Halasy,Hungary,1,0,0,1,1924
Henry Bailey,United States,1,0,0,1,1924
Joe Crockett,United States,1,0,0,1,1924
Fred Etchen,United States,1,0,0,1,1924
Sid Hinds,United States,1,0,0,1,1924
John Noel,United States,1,0,0,1,1924
Clarence Platt,United States,1,0,0,1,1924
Sam Sharman,United States,1,0,0,1,1924
Bill Silkworth,United States,1,0,0,1,1924
Dick Eve,Australia,1,0,0,1,1924
Georges Rigal,France,1,0,0,1,1924
Lucy Morton,Great Britain,1,0,0,1,1924
Sybil Bauer,United States,1,0,0,1,1924
Fraze Donnelly,United States,1,0,0,1,1924
Martha Norelius,United States,1,0,0,1,1924
Carol Smith,United States,1,0,0,1,1924
Ralph Breyer,United States,1,0,0,1,1924
Harry Glancy,United States,1,0,0,1,1924
Warren Kealoha,United States,1,0,0,1,1924
Bob Skelton,United States,1,0,0,1,1924
Albert Deborgies,France,1,0,0,1,1924
Noël Delberghe,France,1,0,0,1,1924
Robert Desmettre,France,1,0,0,1,1924
Paul Dujardin,France,1,0,0,1,1924
Albert Mayaud,France,1,0,0,1,1924
"Henri Padou, Sr.",France,1,0,0,1,1924
Edmond Décottignies,France,1,0,0,1,1924
Charles Rigoulot,France,1,0,0,1,1924
Pierino Gabetti,Italy,1,0,0,1,1924
Carlo Galimberti,Italy,1,0,0,1,1924
Giuseppe Tonani,Italy,1,0,0,1,1924
Eduard Pütsep,Estonia,1,0,0,1,1924
Kalle Anttila,Finland,1,0,0,1,1924
Oskari Friman,Finland,1,0,0,1,1924
Kustaa Pihlajamäki,Finland,1,0,0,1,1924
Edvard Westerlund,Finland,1,0,0,1,1924
Henri Deglane,France,1,0,0,1,1924
Hermann Gehri,Switzerland,1,0,0,1,1924
Fritz Hagmann,Switzerland,1,0,0,1,1924
Carl Westergren,Sweden,1,0,0,1,1924
Robin Reed,United States,1,0,0,1,1924
John Spellman,United States,1,0,0,1,1924
Harry Steel,United States,1,0,0,1,1924
Russ Vis,United States,1,0,0,1,1924
Rich Bockelie,Norway,1,0,0,1,1924
Christopher Dahl,Norway,1,0,0,1,1924
Harald Hagen,Norway,1,0,0,1,1924
Léon Huybrechts,Belgium,1,0,0,1,1924
Eugen Lunde,Norway,1,0,0,1,1924
Anders Lundgren,Norway,1,0,0,1,1924
Ingar Nielsen,Norway,1,0,0,1,1924
"August Ringvold, Jr.",Norway,1,0,0,1,1924
"August Ringvold, Sr.",Norway,1,0,0,1,1924
Nick Winter,Australia,1,0,0,1,1924
Eero Lehtonen,Finland,1,0,0,1,1924
Frej Liewendahl,Finland,1,0,0,1,1924
Heikki Liimatainen,Finland,1,0,0,1,1924
Jonni Myyrä,Finland,1,0,0,1,1924
Eino Rastas,Finland,1,0,0,1,1924
Eino Seppälä,Finland,1,0,0,1,1924
Väinö Sipilä,Finland,1,0,0,1,1924
Albin Stenroos,Finland,1,0,0,1,1924
Sameli Tala,Finland,1,0,0,1,1924
Douglas Lowe,Great Britain,1,0,0,1,1924
Ugo Frigerio,Italy,1,0,0,1,1924
Lee Barnes,United States,1,0,0,1,1924
Pinky Clarke,United States,1,0,0,1,1924
Com Cochran,United States,1,0,0,1,1924
Alan Helffrich,United States,1,0,0,1,1924
DeHart Hubbard,United States,1,0,0,1,1924
Frank Hussey,United States,1,0,0,1,1924
Dan Kinsey,United States,1,0,0,1,1924
Al LeConey,United States,1,0,0,1,1924
Oliver MacDonald,United States,1,0,0,1,1924
Loren Murchison,United States,1,0,0,1,1924
Bill Stevenson,United States,1,0,0,1,1924
Morgan Taylor,United States,1,0,0,1,1924
Fred Tootell,United States,1,0,0,1,1924
Charles Guyot,France,1,0,0,1,1924
Kostas Dimitriadis,Greece,1,0,0,1,1924
Jean Jacoby,Luxembourg,1,0,0,1,1924
Robert Pražák,Czech Republic,0,3,0,3,1924
Rik Hoevenaers,Belgium,0,2,1,3,1924
Jean Gutweniger,Switzerland,0,2,1,3,1924
Arne Borg,Sweden,0,2,1,3,1924
Henri Cochet,France,0,2,0,2,1924
Fernand de Montigny,Belgium,0,2,0,2,1924
François Gangloff,France,0,2,0,2,1924
Jean Gounot,France,0,2,0,2,1924
Joseph De Combe,Belgium,0,2,0,2,1924
Rudolf Svensson,Sweden,0,2,0,2,1924
Alf Swahn,Sweden,0,1,2,3,1924
Kitty McKane,Great Britain,0,1,1,2,1924
Tommaso Lequio di Assaba,Italy,0,1,1,2,1924
Fernand Saivé,Belgium,0,1,1,2,1924
Jean Van Den Bosch,Belgium,0,1,1,2,1924
Maurice Van Damme,Belgium,0,1,1,2,1924
László Berti,Hungary,0,1,1,2,1924
János Garay,Hungary,0,1,1,2,1924
Zoltán Schenker,Hungary,0,1,1,2,1924
Ödön Tersztyánszky,Hungary,0,1,1,2,1924
Alphonse Higelin,France,0,1,1,2,1924
Konni Huber,Finland,0,1,1,2,1924
Mauritz Johansson,Sweden,0,1,1,2,1924
Fredric Landelius,Sweden,0,1,1,2,1924
Frank Beaurepaire,Australasia,0,1,1,2,1924
Aileen Riggin,United States,0,1,1,2,1924
Edvin Wide,Sweden,0,1,1,2,1924
Earl Johnson,United States,0,1,1,2,1924
Jacques Brugnon,France,0,1,0,1,1924
Phyllis Covell,Great Britain,0,1,0,1,1924
Dezső Lauber,Hungary,0,1,0,1,1924
Søren Petersen,Denmark,0,1,0,1,1924
Thyge Petersen,Denmark,0,1,0,1,1924
Julie Vlasto,France,0,1,0,1,1924
Marion Jessup,United States,0,1,0,1,1924
Alfredo Copello,Argentina,0,1,0,1,1924
Jack Elliott,Great Britain,0,1,0,1,1924
Jim McKenzie,Great Britain,0,1,0,1,1924
Héctor Méndez,Argentina,0,1,0,1,1924
Joe Salas,United States,0,1,0,1,1924
Al Tripoli,United States,0,1,0,1,1924
Hans Bühler,Switzerland,0,1,0,1,1924
Gustaf Hagelin,Sweden,0,1,0,1,1924
Frode Kirkebjerg,Denmark,0,1,0,1,1924
Claës König,Sweden,0,1,0,1,1924
Carl Gustaf Lewenhaupt,Sweden,0,1,0,1,1924
Bertil Sandström,Sweden,0,1,0,1,1924
Werner Stuber,Switzerland,0,1,0,1,1924
Torsten Sylvan,Sweden,0,1,0,1,1924
Henri von der Weid,Switzerland,0,1,0,1,1924
Albert Alden,Great Britain,0,1,0,1,1924
Edmund Hansen,Denmark,0,1,0,1,1924
Willy Falck Hansen,Denmark,0,1,0,1,1924
Józef Lange,Poland,0,1,0,1,1924
Jan Łazarski,Poland,0,1,0,1,1924
Jaap Meijer,Netherlands,0,1,0,1,1924
Alphonse Parfondry,Belgium,0,1,0,1,1924
Tomasz Stankiewicz,Poland,0,1,0,1,1924
Franciszek Szymczyk,Poland,0,1,0,1,1924
René Araou,France,0,1,0,1,1924
Jean Bayard,France,0,1,0,1,1924
Louis Béguet,France,0,1,0,1,1924
André Béhotéguy,France,0,1,0,1,1924
Alex Bioussa,France,0,1,0,1,1924
Étienne Bonnes,France,0,1,0,1,1924
Adolphe Bousquet,France,0,1,0,1,1924
Aimé Cassayet-Armagnac,France,0,1,0,1,1924
Clément Dupont,France,0,1,0,1,1924
Albert Dupouy,France,0,1,0,1,1924
Jean Etcheberry,France,0,1,0,1,1924
Henri Galau,France,0,1,0,1,1924
Gilbert Gérintès,France,0,1,0,1,1924
Raoul Got,France,0,1,0,1,1924
Adolphe Jauréguy,France,0,1,0,1,1924
Marcel-Frédéric Lubin-Lebrère,France,0,1,0,1,1924
Étienne Piquiral,France,0,1,0,1,1924
Jean Vaysse,France,0,1,0,1,1924
Elmer Boeseke,United States,0,1,0,1,1924
Tommy Hitchcock,United States,0,1,0,1,1924
Fred Roe,United States,0,1,0,1,1924
Rod Wanamaker,United States,0,1,0,1,1924
Gladys Davis,Great Britain,0,1,0,1,1924
Paul Anspach,Belgium,0,1,0,1,1924
Désiré Beaurain,Belgium,0,1,0,1,1924
Marcel Berré,Belgium,0,1,0,1,1924
Charles Crahay,Belgium,0,1,0,1,1924
Joseph De Craecker,Belgium,0,1,0,1,1924
Albert De Roocker,Belgium,0,1,0,1,1924
Ernest Gevers,Belgium,0,1,0,1,1924
Léon Tom,Belgium,0,1,0,1,1924
József Rády,Hungary,0,1,0,1,1924
László Széchy,Hungary,0,1,0,1,1924
Jenő Uhlyárik,Hungary,0,1,0,1,1924
Xam Abegglen,Switzerland,0,1,0,1,1924
Félix Bédouret,Switzerland,0,1,0,1,1924
Walter Dietrich,Switzerland,0,1,0,1,1924
Karl Ehrenbolger,Switzerland,0,1,0,1,1924
Paul Fässler,Switzerland,0,1,0,1,1924
Edmond Kramer,Switzerland,0,1,0,1,1924
Adolphe Mengotti,Switzerland,0,1,0,1,1924
August Oberhauser,Switzerland,0,1,0,1,1924
Robert Pache,Switzerland,0,1,0,1,1924
Aron Pollitz,Switzerland,0,1,0,1,1924
Hans Pulver,Switzerland,0,1,0,1,1924
Rudolf Ramseyer,Switzerland,0,1,0,1,1924
Adolphe Reymond,Switzerland,0,1,0,1,1924
Paul Schmiedlin,Switzerland,0,1,0,1,1924
Paul Sturzenegger,Switzerland,0,1,0,1,1924
Léon Delsarte,France,0,1,0,1,1924
Arthur Hermann,France,0,1,0,1,1924
Joseph Huber,France,0,1,0,1,1924
Eugène Cordonnier,France,0,1,0,1,1924
Jan Koutný,Czech Republic,0,1,0,1,1924
Gustaf Dyrssen,Sweden,0,1,0,1,1924
Arthur Bell,Canada,0,1,0,1,1924
Archie Black,Canada,0,1,0,1,1924
Ivor Campbell,Canada,0,1,0,1,1924
Bob Hunter,Canada,0,1,0,1,1924
William Langford,Canada,0,1,0,1,1924
Harold Little,Canada,0,1,0,1,1924
George MacKay,Canada,0,1,0,1,1924
Jack Smith,Canada,0,1,0,1,1924
Warren Snyder,Canada,0,1,0,1,1924
Norman Taylor,Canada,0,1,0,1,1924
Laurie Wallace,Canada,0,1,0,1,1924
Bill Wood,Canada,0,1,0,1,1924
Maurice Monney-Bouton,France,0,1,0,1,1924
Eugène Constant,France,0,1,0,1,1924
Marc Detton,France,0,1,0,1,1924
Louis Gressier,France,0,1,0,1,1924
Georges Lecointe,France,0,1,0,1,1924
Marcel Lepan,France,0,1,0,1,1924
Georges Piot,France,0,1,0,1,1924
Jean-Pierre Stock,France,0,1,0,1,1924
Raymond Talleux,France,0,1,0,1,1924
Ercole Olgeni,Italy,0,1,0,1,1924
Giovanni Scatturin,Italy,0,1,0,1,1924
Gino Sopracordevole,Italy,0,1,0,1,1924
Garrett Gilmore,United States,0,1,0,1,1924
William Barnes,Canada,0,1,0,1,1924
George Beattie,Canada,0,1,0,1,1924
John Black,Canada,0,1,0,1,1924
James Montgomery,Canada,0,1,0,1,1924
Samuel Newton,Canada,0,1,0,1,1924
Sam Vance,Canada,0,1,0,1,1924
Paul Colas,France,0,1,0,1,1924
Albert Courquin,France,0,1,0,1,1924
Pierre Hardy,France,0,1,0,1,1924
Georges Roes,France,0,1,0,1,1924
Émile Rumeau,France,0,1,0,1,1924
Vilhelm Carlberg,Sweden,0,1,0,1,1924
Otto Hultberg,Sweden,0,1,0,1,1924
Marcus Dinwiddie,United States,0,1,0,1,1924
Carl Osburn,United States,0,1,0,1,1924
Moss Christie,Australia,0,1,0,1,1924
Ernest Henry,Australia,0,1,0,1,1924
Gérard Blitz,Belgium,0,1,0,1,1924
Jean-Pierre Vermetten,Belgium,0,1,0,1,1924
Florrie Barker,Great Britain,0,1,0,1,1924
Phyllis Harding,Great Britain,0,1,0,1,1924
Connie Jeans,Great Britain,0,1,0,1,1924
Grace McKenzie,Great Britain,0,1,0,1,1924
Vera Tanner,Great Britain,0,1,0,1,1924
Alfréd Hajós,Hungary,0,1,0,1,1924
Johan Jansson,Sweden,0,1,0,1,1924
Agnes Geraghty,United States,0,1,0,1,1924
Helen Wainwright,United States,0,1,0,1,1924
Pete Desjardins,United States,0,1,0,1,1924
Dave Fall,United States,0,1,0,1,1924
Duke Kahanamoku,United States,0,1,0,1,1924
Paul Wyatt,United States,0,1,0,1,1924
Maurice Blitz,Belgium,0,1,0,1,1924
Joseph Cludts,Belgium,0,1,0,1,1924
Pierre Dewin,Belgium,0,1,0,1,1924
Albert Durant,Belgium,0,1,0,1,1924
Georges Fleurix,Belgium,0,1,0,1,1924
Paul Gailly,Belgium,0,1,0,1,1924
Joseph Pletincx,Belgium,0,1,0,1,1924
Jules Thiry,Belgium,0,1,0,1,1924
Franz Aigner,Austria,0,1,0,1,1924
Andreas Stadler,Austria,0,1,0,1,1924
Anton Zwerina,Austria,0,1,0,1,1924
Alfred Neuland,Estonia,0,1,0,1,1924
Fritz Hünenberger,Switzerland,0,1,0,1,1924
Pierre Ollivier,Belgium,0,1,0,1,1924
Anselm Ahlfors,Finland,0,1,0,1,1924
Eino Leino,Finland,0,1,0,1,1924
Arthur Lindfors,Finland,0,1,0,1,1924
Kaarlo Mäkinen,Finland,0,1,0,1,1924
Edil Rosenqvist,Finland,0,1,0,1,1924
Aleksanteri Toivola,Finland,0,1,0,1,1924
Volmar Wikström,Finland,0,1,0,1,1924
Lajos Keresztes,Hungary,0,1,0,1,1924
Henri Wernli,Switzerland,0,1,0,1,1924
Chet Newton,United States,0,1,0,1,1924
Knud Degn,Denmark,0,1,0,1,1924
Gordon Fowler,Great Britain,0,1,0,1,1924
Edwin Jacob,Great Britain,0,1,0,1,1924
Christian Nielsen,Denmark,0,1,0,1,1924
Tom Riggs,Great Britain,0,1,0,1,1924
Walter Riggs,Great Britain,0,1,0,1,1924
Henrik Robert,Norway,0,1,0,1,1924
Ernest Roney,Great Britain,0,1,0,1,1924
Vilhelm Vett,Denmark,0,1,0,1,1924
Luis Brunetto,Argentina,0,1,0,1,1924
Vilho Niittymaa,Finland,0,1,0,1,1924
Erkka Wilén,Finland,0,1,0,1,1924
Arthur Clark,Great Britain,0,1,0,1,1924
Gordon Goodwin,Great Britain,0,1,0,1,1924
Bert Johnston,Great Britain,0,1,0,1,1924
Bert Macdonald,Great Britain,0,1,0,1,1924
Wilfred Nichol,Great Britain,0,1,0,1,1924
Walter Porter,Great Britain,0,1,0,1,1924
Walter Rangeley,Great Britain,0,1,0,1,1924
Lance Royle,Great Britain,0,1,0,1,1924
William Seagrove,Great Britain,0,1,0,1,1924
George Webber,Great Britain,0,1,0,1,1924
Elemér Somfay,Hungary,0,1,0,1,1924
Romeo Bertini,Italy,0,1,0,1,1924
Sid Atkinson,South Africa,0,1,0,1,1924
Paul Martin,Switzerland,0,1,0,1,1924
Willy Schärer,Switzerland,0,1,0,1,1924
Erik Byléhn,Sweden,0,1,0,1,1924
Nils Engdahl,Sweden,0,1,0,1,1924
Gunnar Lindström,Sweden,0,1,0,1,1924
Artur Svensson,Sweden,0,1,0,1,1924
Gustaf Wejnarth,Sweden,0,1,0,1,1924
Verne Booth,United States,0,1,0,1,1924
Leroy Brown,United States,0,1,0,1,1924
Gus Fager,United States,0,1,0,1,1924
Ray Fitch,United States,0,1,0,1,1924
Ned Gourdin,United States,0,1,0,1,1924
Glenn Graham,United States,0,1,0,1,1924
John Gray,United States,0,1,0,1,1924
Glenn Hartranft,United States,0,1,0,1,1924
Jimmy Henigan,United States,0,1,0,1,1924
Matt McGrath,United States,0,1,0,1,1924
Emerson Norton,United States,0,1,0,1,1924
Charley Paddock,United States,0,1,0,1,1924
Art Studenroth,United States,0,1,0,1,1924
Colin Finlayson,Canada,0,1,0,1,1924
Josef Petersen,Denmark,0,1,0,1,1924
Dorothy Margaret Stuart,Great Britain,0,1,0,1,1924
Jack Yeats,Ireland,0,1,0,1,1924
Frantz Heldenstein,Luxembourg,0,1,0,1,1924
Antoine Rebetez,Switzerland,0,0,2,2,1924
Ladislav Vácha,Czech Republic,0,0,2,2,1924
Hjördis Töpel,Sweden,0,0,2,2,1924
Bud Pinkston,United States,0,0,2,2,1924
Guy Butler,Great Britain,0,0,2,2,1924
Jean Borotra,France,0,0,1,1,1924
René Lacoste,France,0,0,1,1,1924
Evelyn Colyer,Great Britain,0,0,1,1,1924
Dorothy Shepherd-Barron,Great Britain,0,0,1,1,1924
Umberto De Morpurgo,Italy,0,0,1,1,1924
Kea Bouman,Netherlands,0,0,1,1,1924
Henk Timmer,Netherlands,0,0,1,1,1924
Doug Lewis,Canada,0,0,1,1,1924
Jean Ces,France,0,0,1,1,1924
Sverre Sørsdal,Norway,0,0,1,1,1924
Alfredo Porzio,Argentina,0,0,1,1,1924
Pedro Quartucci,Argentina,0,0,1,1,1924
Joseph Beecken,Belgium,0,0,1,1,1924
Fred Boylstein,United States,0,0,1,1,1924
Ray Fee,United States,0,0,1,1,1924
Erik Bjurberg,Sweden,0,0,1,1,1924
Alessandro Alvisi,Italy,0,0,1,1,1924
Aníbal de Almeida,Portugal,0,0,1,1,1924
Luís de Meneses,Portugal,0,0,1,1,1924
Hélder Martins,Portugal,0,0,1,1,1924
"Emanuele, Count Di Pralormo",Italy,0,0,1,1,1924
Sloan Doak,United States,0,0,1,1,1924
Adam Królikiewicz,Poland,0,0,1,1,1924
Xavier Lesage,France,0,0,1,1,1924
Alberto Lombardi,Italy,0,0,1,1,1924
José Mouzinho de Albuquerque,Portugal,0,0,1,1,1924
Erik Bohlin,Sweden,0,0,1,1,1924
Gerard Bosch van Drakestein,Netherlands,0,0,1,1,1924
Léonard Daghelinckx,Belgium,0,0,1,1,1924
Ragnar Malm,Sweden,0,0,1,1,1924
Maurice Peeters,Netherlands,0,0,1,1,1924
Gunnar Sköld,Sweden,0,0,1,1,1924
Harry Wyld,Great Britain,0,0,1,1,1924
Frederick Barrett,Great Britain,0,0,1,1,1924
Denis Bingham,Great Britain,0,0,1,1,1924
Freddie Guest,Great Britain,0,0,1,1,1924
Percival Wise,Great Britain,0,0,1,1,1924
Dumitru Armășel,Romania,0,0,1,1,1924
Gheorghe Benția,Romania,0,0,1,1,1924
Teodor Florian,Romania,0,0,1,1,1924
Ion Gîrleșteanu,Romania,0,0,1,1,1924
Nicolae Mărăscu,Romania,0,0,1,1,1924
Teodor Marian,Romania,0,0,1,1,1924
Sorin Mihăilescu,Romania,0,0,1,1,1924
Paul Nedelcovici,Romania,0,0,1,1,1924
Iosif Nemes,Romania,0,0,1,1,1924
Eugen Sfetescu,Romania,0,0,1,1,1924
Mircea Sfetescu,Romania,0,0,1,1,1924
Soare Sterian,Romania,0,0,1,1,1924
Atanasie Tănăsescu,Romania,0,0,1,1,1924
Mihai Vardală,Romania,0,0,1,1,1924
Paul Vidrașcu,Romania,0,0,1,1,1924
Dumitru Volvoreanu,Romania,0,0,1,1,1924
Grete Heckscher,Denmark,0,0,1,1,1924
István Lichteneckert,Hungary,0,0,1,1,1924
Giulio Basletta,Italy,0,0,1,1,1924
Giovanni Canova,Italy,0,0,1,1,1924
Virgilio Mantegazza,Italy,0,0,1,1,1924
Arie de Jong,Netherlands,0,0,1,1,1924
Jetze Doorman,Netherlands,0,0,1,1,1924
Hendrik Scherpenhuijzen,Netherlands,0,0,1,1,1924
Jan van der Wiel,Netherlands,0,0,1,1,1924
Maarten van Dulm,Netherlands,0,0,1,1,1924
Henri Wijnoldy-Daniëls,Netherlands,0,0,1,1,1924
Nils Hellsten,Sweden,0,0,1,1,1924
Axel Alfredsson,Sweden,0,0,1,1,1924
Charles Brommesson,Sweden,0,0,1,1,1924
Gustaf Carlson,Sweden,0,0,1,1,1924
Albin Dahl,Sweden,0,0,1,1,1924
Sven Friberg,Sweden,0,0,1,1,1924
Fritte Hillén,Sweden,0,0,1,1,1924
Konrad Hirsch,Sweden,0,0,1,1,1924
Gunnar Holmberg,Sweden,0,0,1,1,1924
Per Kaufeldt,Sweden,0,0,1,1,1924
Tore Keller,Sweden,0,0,1,1,1924
Putte Kock,Sweden,0,0,1,1,1924
Sigge Lindberg,Sweden,0,0,1,1,1924
Sven Lindqvist,Sweden,0,0,1,1,1924
Evert Lundquist,Sweden,0,0,1,1,1924
Sten Mellgren,Sweden,0,0,1,1,1924
Sven Rydell,Sweden,0,0,1,1,1924
Harry Sundberg,Sweden,0,0,1,1,1924
Thorsten Svensson,Sweden,0,0,1,1,1924
Magnus Wegelius,Finland,0,0,1,1,1924
Hans Grieder,Switzerland,0,0,1,1,1924
Georges Miez,Switzerland,0,0,1,1,1924
Otto Pfister,Switzerland,0,0,1,1,1924
Carl Widmer,Switzerland,0,0,1,1,1924
Bohumil Mořkovský,Czech Republic,0,0,1,1,1924
Antonio Cattalinich,Croatia,0,0,1,1,1924
Francesco Cattalinich,Croatia,0,0,1,1,1924
Simeone Cattalinich,Croatia,0,0,1,1,1924
Giuseppe Crivelli,Italy,0,0,1,1,1924
Latino Galasso,Italy,0,0,1,1,1924
Vittorio Gliubich,Croatia,0,0,1,1,1924
Pietro Ivanov,Croatia,0,0,1,1,1924
Bruno Sorich,Croatia,0,0,1,1,1924
Carlo Toniatti,Italy,0,0,1,1,1924
Rudolf Bosshard,Switzerland,0,0,1,1,1924
Josef Schneider,Switzerland,0,0,1,1,1924
Heini Thoma,Switzerland,0,0,1,1,1924
Leon Butler,United States,0,0,1,1,1924
Bob Gerhardt,United States,0,0,1,1,1924
Sid Jelinek,United States,0,0,1,1,1924
Ed Jennings,United States,0,0,1,1,1924
John Kennedy,United States,0,0,1,1,1924
Ed Mitchell,United States,0,0,1,1,1924
Henry Welsford,United States,0,0,1,1,1924
Harold Wilson,United States,0,0,1,1,1924
Niels Larsen,Denmark,0,0,1,1,1924
Werner Ekman,Finland,0,0,1,1,1924
Lennart Hannelius,Finland,0,0,1,1,1924
Robert Huber,Finland,0,0,1,1,1924
Georg Nordblad,Finland,0,0,1,1,1924
Robert Tikkanen,Finland,0,0,1,1,1924
Ludovic Augustin,Haiti,0,0,1,1,1924
Destin Destine,Haiti,0,0,1,1,1924
Eloi Metullus,Haiti,0,0,1,1,1924
Astrel Rolland,Haiti,0,0,1,1,1924
Ludovic Valborge,Haiti,0,0,1,1,1924
Josias Hartmann,Switzerland,0,0,1,1,1924
Axel Ekblom,Sweden,0,0,1,1,1924
Dennis Fenton,United States,0,0,1,1,1924
Gladys Carson,Great Britain,0,0,1,1,1924
Harold Clarke,Great Britain,0,0,1,1,1924
Károly Bartha,Hungary,0,0,1,1,1924
Aina Berg,Sweden,0,0,1,1,1924
Gulli Ewerlund,Sweden,0,0,1,1,1924
Wivan Pettersson,Sweden,0,0,1,1,1924
Åke Borg,Sweden,0,0,1,1,1924
Orvar Trolle,Sweden,0,0,1,1,1924
Georg Werner,Sweden,0,0,1,1,1924
Carol Fletcher,United States,0,0,1,1,1924
Sam Kahanamoku,United States,0,0,1,1,1924
Bill Kirschbaum,United States,0,0,1,1,1924
Art Austin,United States,0,0,1,1,1924
Oliver Horn,United States,0,0,1,1,1924
Fred Lauer,United States,0,0,1,1,1924
George Mitchell,United States,0,0,1,1,1924
John Norton,United States,0,0,1,1,1924
George Schroth,United States,0,0,1,1,1924
Herb Vollmer,United States,0,0,1,1,1924
Leopold Friedrich,Austria,0,0,1,1,1924
Jaan Kikkas,Estonia,0,0,1,1,1924
Arthur Reinmann,Switzerland,0,0,1,1,1924
Bohumil Durdis,Czech Republic,0,0,1,1,1924
Roman Steinberg,Estonia,0,0,1,1,1924
Arvo Haavisto,Finland,0,0,1,1,1924
Väinö Ikonen,Finland,0,0,1,1,1924
Vilho Pekkala,Finland,0,0,1,1,1924
Onni Pellinen,Finland,0,0,1,1,1924
Kalle Westerlund,Finland,0,0,1,1,1924
Archie MacDonald,Great Britain,0,0,1,1,1924
Rajmund Badó,Hungary,0,0,1,1,1924
Katsutoshi Naito,Japan,0,0,1,1,1924
Charles Courant,Switzerland,0,0,1,1,1924
Otto Müller,Switzerland,0,0,1,1,1924
Erik Malmberg,Sweden,0,0,1,1,1924
Bryan Hines,United States,0,0,1,1,1924
Louis Bréguet,France,0,0,1,1,1924
Joop Carp,Netherlands,0,0,1,1,1924
Hans Dittmar,Finland,0,0,1,1,1924
Pierre Gauthier,France,0,0,1,1,1924
Robert Girardet,France,0,0,1,1,1924
Anthonij Guépin,Netherlands,0,0,1,1,1924
André Guerrier,France,0,0,1,1,1924
Georges Mollard,France,0,0,1,1,1924
Jan Vreede,Netherlands,0,0,1,1,1924
Aleksander Klumberg,Estonia,0,0,1,1,1924
Harald Tammer,Estonia,0,0,1,1,1924
Ville Tuulos,Finland,0,0,1,1,1924
Paul Bontemps,France,0,0,1,1,1924
Lucien Dolquès,France,0,0,1,1,1924
Gaston Heuet,France,0,0,1,1,1924
André Lauseig,France,0,0,1,1,1924
Henri Lauvaux,France,0,0,1,1,1924
Pierre Lewden,France,0,0,1,1,1924
Robert Marchal,France,0,0,1,1,1924
Maurice Norland,France,0,0,1,1,1924
Malcolm Nokes,Great Britain,0,0,1,1,1924
George Renwick,Great Britain,0,0,1,1,1924
Richard Ripley,Great Britain,0,0,1,1,1924
Henry Stallard,Great Britain,0,0,1,1,1924
Edward Toms,Great Britain,0,0,1,1,1924
Jaap Boot,Netherlands,0,0,1,1,1924
Harry Broos,Netherlands,0,0,1,1,1924
Jan de Vries,Netherlands,0,0,1,1,1924
Rinus van den Berge,Netherlands,0,0,1,1,1924
Sverre Hansen,Norway,0,0,1,1,1924
Arthur Porritt,New Zealand,0,0,1,1,1924
Cecil McMaster,South Africa,0,0,1,1,1924
Sten Pettersson,Sweden,0,0,1,1,1924
Bertil Uggla,Sweden,0,0,1,1,1924
Jim Brooker,United States,0,0,1,1,1924
James Connolly,United States,0,0,1,1,1924
Bill Cox,United States,0,0,1,1,1924
Clarence DeMar,United States,0,0,1,1,1924
Sky Enck,United States,0,0,1,1,1924
Ralph Hills,United States,0,0,1,1,1924
Ed Kirby,United States,0,0,1,1,1924
Leo Larrivee,United States,0,0,1,1,1924
Bob LeGendre,United States,0,0,1,1,1924
Tom Lieb,United States,0,0,1,1,1924
Gene Oberst,United States,0,0,1,1,1924
Joie Ray,United States,0,0,1,1,1924
Ivan Riley,United States,0,0,1,1,1924
Willard Tibbetts,United States,0,0,1,1,1924
Jean René Gauguin,Denmark,0,0,1,1,1924
Charles Anthoine Gonnet,France,0,0,1,1,1924
Claude-Léon Mascaux,France,0,0,1,1,1924
Oliver St. John Gogarty,Ireland,0,0,1,1,1924
Julien Médécin,Monaco,0,0,1,1,1924
Johan van Hell,Netherlands,0,0,1,1,1924
Georges Miez,Switzerland,3,1,0,4,1928
Hermann Hänggi,Switzerland,2,1,1,4,1928
Lucien Gaudin,France,2,1,0,3,1928
Eugen Mack,Switzerland,2,0,1,3,1928
Charles Pahud de Mortanges,Netherlands,2,0,0,2,1928
Carl-Friedrich Freiherr von Langen,Germany,2,0,0,2,1928
Henry Hansen,Denmark,2,0,0,2,1928
Ödön Tersztyánszky,Hungary,2,0,0,2,1928
Martha Norelius,United States,2,0,0,2,1928
Albina Osipowich,United States,2,0,0,2,1928
Pete Desjardins,United States,2,0,0,2,1928
George Kojac,United States,2,0,0,2,1928
Johnny Weissmuller,United States,2,0,0,2,1928
Percy Williams,Canada,2,0,0,2,1928
Ray Barbuti,United States,2,0,0,2,1928
Ladislav Vácha,Czech Republic,1,2,0,3,1928
Paavo Nurmi,Finland,1,2,0,3,1928
Gerard de Kruijff,Netherlands,1,1,0,2,1928
Attila Petschauer,Hungary,1,1,0,2,1928
Oreste Puliti,Italy,1,1,0,2,1928
Zus Philipsen-Braun,Netherlands,1,1,0,2,1928
Eleanor Garatti-Saville,United States,1,1,0,2,1928
Walter Laufer,United States,1,1,0,2,1928
Erich Rademacher,Germany,1,1,0,2,1928
Bobby Rosenfeld,Canada,1,1,0,2,1928
Ville Ritola,Finland,1,1,0,2,1928
Betty Robinson,United States,1,1,0,2,1928
Leon Štukelj,Slovenia,1,0,2,3,1928
Willy Falck Hansen,Denmark,1,0,1,2,1928
Giulio Gaudini,Italy,1,0,1,2,1928
Arne Borg,Sweden,1,0,1,2,1928
Ethel Smith,Canada,1,0,1,2,1928
Víctor Avendaño,Argentina,1,0,0,1,1928
Antal Kocsis,Hungary,1,0,0,1,1928
Carlo Orlandi,Italy,1,0,0,1,1928
Vittorio Tamagnini,Italy,1,0,0,1,1928
Piero Toscani,Italy,1,0,0,1,1928
Bep van Klaveren,Netherlands,1,0,0,1,1928
Ted Morgan,New Zealand,1,0,0,1,1928
Arturo Rodríguez,Argentina,1,0,0,1,1928
José Álvarez,Spain,1,0,0,1,1928
Julio García Fernández,Spain,1,0,0,1,1928
Hermann Linkenbach,Germany,1,0,0,1,1928
José Navarro,Spain,1,0,0,1,1928
Adolf van der Voort van Zijp,Netherlands,1,0,0,1,1928
František Ventura,Czech Republic,1,0,0,1,1928
Eugen von Lotzbeck,Germany,1,0,0,1,1928
Roger Beaufrand,France,1,0,0,1,1928
Cesare Facciani,Italy,1,0,0,1,1928
Giacomo Gaioni,Italy,1,0,0,1,1928
Orla Jørgensen,Denmark,1,0,0,1,1928
Bernard Leene,Netherlands,1,0,0,1,1928
Mario Lusiani,Italy,1,0,0,1,1928
Leo Nielsen,Denmark,1,0,0,1,1928
Poul Sørensen,Denmark,1,0,0,1,1928
Luigi Tasselli,Italy,1,0,0,1,1928
Daan van Dijk,Netherlands,1,0,0,1,1928
Richard Allen,India,1,0,0,1,1928
Dhyan Chand,India,1,0,0,1,1928
Willie Goodsir-Cullen,India,1,0,0,1,1928
Michael Gateley,India,1,0,0,1,1928
Leslie Hammond,India,1,0,0,1,1928
Feroze Khan,India,1,0,0,1,1928
George Marthins,India,1,0,0,1,1928
Rex Norris,India,1,0,0,1,1928
Eric Pinniger,India,1,0,0,1,1928
Michael Rocque,India,1,0,0,1,1928
Frederick Seaman,India,1,0,0,1,1928
Shaukat Ali,India,1,0,0,1,1928
Jaipal Singh,India,1,0,0,1,1928
Sayed Yusuf,India,1,0,0,1,1928
Helene Mayer,Germany,1,0,0,1,1928
János Garay,Hungary,1,0,0,1,1928
Gyula Glykais,Hungary,1,0,0,1,1928
Sándor Gombos,Hungary,1,0,0,1,1928
József Rády,Hungary,1,0,0,1,1928
Carlo Agostoni,Italy,1,0,0,1,1928
Giulio Basletta,Italy,1,0,0,1,1928
Marcello Bertinetti,Italy,1,0,0,1,1928
Giorgio Chiavacci,Italy,1,0,0,1,1928
Giancarlo Cornaggia-Medici,Italy,1,0,0,1,1928
Gioacchino Guaragna,Italy,1,0,0,1,1928
Renzo Minoli,Italy,1,0,0,1,1928
Giorgio Pessina,Italy,1,0,0,1,1928
Ugo Pignotti,Italy,1,0,0,1,1928
Franco Riccardi,Italy,1,0,0,1,1928
Sven Thofelt,Sweden,1,0,0,1,1928
José Leandro Andrade,Uruguay,1,0,0,1,1928
Pedro Arispe,Uruguay,1,0,0,1,1928
Juan Pedro Arremón,Uruguay,1,0,0,1,1928
René Borjas,Uruguay,1,0,0,1,1928
Antonio Cámpolo,Uruguay,1,0,0,1,1928
Adhemar Canavessi,Uruguay,1,0,0,1,1928
Héctor Castro,Uruguay,1,0,0,1,1928
Pedro Cea,Uruguay,1,0,0,1,1928
Lorenzo Fernández,Uruguay,1,0,0,1,1928
Roberto Figueroa,Uruguay,1,0,0,1,1928
Alvaro Gestido,Uruguay,1,0,0,1,1928
Andrés Mazali,Uruguay,1,0,0,1,1928
José Nasazzi,Uruguay,1,0,0,1,1928
Pedro Petrone,Uruguay,1,0,0,1,1928
Juan Píriz,Uruguay,1,0,0,1,1928
Héctor Scarone,Uruguay,1,0,0,1,1928
Santos Urdinarán,Uruguay,1,0,0,1,1928
Stella Agsteribbe,Netherlands,1,0,0,1,1928
Elka de Levie,Netherlands,1,0,0,1,1928
Lea Nordheim,Netherlands,1,0,0,1,1928
Ans Polak,Netherlands,1,0,0,1,1928
Co Stelma,Netherlands,1,0,0,1,1928
Mien van den Berg,Netherlands,1,0,0,1,1928
Alie van den Bos,Netherlands,1,0,0,1,1928
Annie van der Vegt,Netherlands,1,0,0,1,1928
Nel van Randwijk,Netherlands,1,0,0,1,1928
Hendrika van Rumt,Netherlands,1,0,0,1,1928
Hans Grieder,Switzerland,1,0,0,1,1928
August Güttinger,Switzerland,1,0,0,1,1928
Otto Pfister,Switzerland,1,0,0,1,1928
Edi Steinemann,Switzerland,1,0,0,1,1928
Melchior Wezel,Switzerland,1,0,0,1,1928
Bobby Pearce,Australia,1,0,0,1,1928
Richard Beesly,Great Britain,1,0,0,1,1928
Edward Bevan,Great Britain,1,0,0,1,1928
John Lander,Great Britain,1,0,0,1,1928
Michael Warriner,Great Britain,1,0,0,1,1928
Bruno Müller,Germany,1,0,0,1,1928
Kurt Moeschter,Germany,1,0,0,1,1928
Giliante D'Este,Italy,1,0,0,1,1928
Giovanni Delise,Italy,1,0,0,1,1928
Valerio Perentin,Italy,1,0,0,1,1928
Renato Petronio,Italy,1,0,0,1,1928
Nicolò Vittori,Italy,1,0,0,1,1928
Hans Bourquin,Switzerland,1,0,0,1,1928
Karl Schöchlin,Switzerland,1,0,0,1,1928
Hans Schöchlin,Switzerland,1,0,0,1,1928
Don Blessing,United States,1,0,0,1,1928
Jack Brinck,United States,1,0,0,1,1928
Hubert Caldwell,United States,1,0,0,1,1928
Paul Costello,United States,1,0,0,1,1928
Bill Dally,United States,1,0,0,1,1928
Peter Donlon,United States,1,0,0,1,1928
Frank Frederick,United States,1,0,0,1,1928
Charley McIlvaine,United States,1,0,0,1,1928
Marvin Stalder,United States,1,0,0,1,1928
Bill Thompson,United States,1,0,0,1,1928
Jim Workman,United States,1,0,0,1,1928
Alberto Zorrilla,Argentina,1,0,0,1,1928
Hilde Schrader,Germany,1,0,0,1,1928
Yoshiyuki Tsuruta,Japan,1,0,0,1,1928
Betty Becker-Pinkston,United States,1,0,0,1,1928
Adelaide Lambert,United States,1,0,0,1,1928
Helen Meany,United States,1,0,0,1,1928
Austin Clapp,United States,1,0,0,1,1928
Max Amann,Germany,1,0,0,1,1928
Emil Benecke,Germany,1,0,0,1,1928
Johann Blank,Germany,1,0,0,1,1928
Karl Bähre,Germany,1,0,0,1,1928
Otto Cordes,Germany,1,0,0,1,1928
Itze Gunst,Germany,1,0,0,1,1928
Joachim Rademacher,Germany,1,0,0,1,1928
Franz Andrysek,Austria,1,0,0,1,1928
Hans Haas,Austria,1,0,0,1,1928
Sayed Nosseir,Egypt,1,0,0,1,1928
Roger François,France,1,0,0,1,1928
Kurt Helbig,Germany,1,0,0,1,1928
Josef Straßberger,Germany,1,0,0,1,1928
Ibrahim Moustafa,Egypt,1,0,0,1,1928
Osvald Käpp,Estonia,1,0,0,1,1928
Voldemar Väli,Estonia,1,0,0,1,1928
Arvo Haavisto,Finland,1,0,0,1,1928
Väinö Kokkinen,Finland,1,0,0,1,1928
Kaarlo Mäkinen,Finland,1,0,0,1,1928
Kurt Leucht,Germany,1,0,0,1,1928
Lajos Keresztes,Hungary,1,0,0,1,1928
Ernst Kyburz,Switzerland,1,0,0,1,1928
Johan Richthoff,Sweden,1,0,0,1,1928
Thure Sjöstedt,Sweden,1,0,0,1,1928
Rudolf Svensson,Sweden,1,0,0,1,1928
Allie Morrison,United States,1,0,0,1,1928
Virginie Hériot,France,1,0,0,1,1928
Erik Anker,Norway,1,0,0,1,1928
Johan Anker,Norway,1,0,0,1,1928
Donatien Bouché,France,1,0,0,1,1928
Haakon Bryhn,Norway,1,0,0,1,1928
Carl de la Sablière,France,1,0,0,1,1928
André Derrien,France,1,0,0,1,1928
André Lesauvage,France,1,0,0,1,1928
Jean Lesieur,France,1,0,0,1,1928
Crown Prince Olav,Norway,1,0,0,1,1928
Sven Thorell,Sweden,1,0,0,1,1928
Jane Bell,Canada,1,0,0,1,1928
Ethel Catherwood,Canada,1,0,0,1,1928
Myrtle Cook,Canada,1,0,0,1,1928
Harri Larva,Finland,1,0,0,1,1928
Toivo Loukola,Finland,1,0,0,1,1928
Paavo Yrjölä,Finland,1,0,0,1,1928
Boughera El Ouafi,Algeria,1,0,0,1,1928
"David, Lord Burghley",Great Britain,1,0,0,1,1928
Douglas Lowe,Great Britain,1,0,0,1,1928
Lina Radke-Batschauer,Germany,1,0,0,1,1928
Pat O'Callaghan,Ireland,1,0,0,1,1928
Mikio Oda,Japan,1,0,0,1,1928
Halina Konopacka,Poland,1,0,0,1,1928
Sid Atkinson,South Africa,1,0,0,1,1928
Erik Lundqvist,Sweden,1,0,0,1,1928
Fred Alderman,United States,1,0,0,1,1928
George Baird,United States,1,0,0,1,1928
Charley Borah,United States,1,0,0,1,1928
Sabin Carr,United States,1,0,0,1,1928
Ed Hamm,United States,1,0,0,1,1928
Bud Houser,United States,1,0,0,1,1928
Bob King,United States,1,0,0,1,1928
Johnny Kuck,United States,1,0,0,1,1928
Jimmy Quinn,United States,1,0,0,1,1928
Hank Russell,United States,1,0,0,1,1928
Bud Spencer,United States,1,0,0,1,1928
Frank Wykoff,United States,1,0,0,1,1928
Edwin Grienauer,Austria,1,0,0,1,1928
Paul Landowski,France,1,0,0,1,1928
William Nicholson,Great Britain,1,0,0,1,1928
Alfred Hensel,Germany,1,0,0,1,1928
Ferenc Mező,Hungary,1,0,0,1,1928
Jean Jacoby,Luxembourg,1,0,0,1,1928
Isaac Israëls,Netherlands,1,0,0,1,1928
Jan Wils,Netherlands,1,0,0,1,1928
Kazimierz Wierzyński,Poland,1,0,0,1,1928
Emanuel Löffler,Czech Republic,0,2,1,3,1928
Gerard Bosch van Drakestein,Netherlands,0,2,0,2,1928
Frank Southall,Great Britain,0,2,0,2,1928
Géo Buchard,France,0,2,0,2,1928
Boy Charlton,Australia,0,2,0,2,1928
Ellen King,Great Britain,0,2,0,2,1928
Joyce Cooper,Great Britain,0,1,2,3,1928
Michał Antoniewicz,Poland,0,1,1,2,1928
Ragnar Olson,Sweden,0,1,1,2,1928
Bino Bini,Italy,0,1,1,2,1928
Jože Primožič,Slovenia,0,1,1,2,1928
Farid Simaika,Egypt,0,1,1,2,1928
Katsuo Takaishi,Japan,0,1,1,2,1928
Georgia Coleman,United States,0,1,1,2,1928
Mickey Galitzen,United States,0,1,1,2,1928
Jimmy Ball,Canada,0,1,1,2,1928
Jack London,Great Britain,0,1,1,2,1928
Walter Rangeley,Great Britain,0,1,1,2,1928
Hermann Engelhard,Germany,0,1,1,2,1928
Helmut Körnig,Germany,0,1,1,2,1928
Georg Lammers,Germany,0,1,1,2,1928
Jacques Lambert,France,0,1,1,2,1928
Armand Apell,France,0,1,0,1,1928
Ernst Pistulla,Germany,0,1,0,1,1928
Raúl Landini,Argentina,0,1,0,1,1928
Víctor Peralta,Argentina,0,1,0,1,1928
Nils Ramm,Sweden,0,1,0,1,1928
Jan Heřmánek,Czech Republic,0,1,0,1,1928
John Daley,United States,0,1,0,1,1928
Steve Halaiko,United States,0,1,0,1,1928
Pierre Bertran de Balanda,France,0,1,0,1,1928
"Carl, Count Bonde",Sweden,0,1,0,1,1928
Kazimierz Gzowski,Poland,0,1,0,1,1928
Eugen Johansen,Norway,0,1,0,1,1928
Janne Lundblad,Sweden,0,1,0,1,1928
Charles Marion,France,0,1,0,1,1928
Bjart Ording,Norway,0,1,0,1,1928
Arthur Qvist,Norway,0,1,0,1,1928
Kazimierz Szosland,Poland,0,1,0,1,1928
Janus Braspennincx,Netherlands,0,1,0,1,1928
Ernest Chambers,Great Britain,0,1,0,1,1928
Jack Lauterwasser,Great Britain,0,1,0,1,1928
Charles Marshall,Great Britain,0,1,0,1,1928
Antoine Mazairac,Netherlands,0,1,0,1,1928
Jack Middleton,Great Britain,0,1,0,1,1928
Jan Maas,Netherlands,0,1,0,1,1928
Jan Pijnenburg,Netherlands,0,1,0,1,1928
Jack Sibbit,Great Britain,0,1,0,1,1928
Piet van der Horst,Netherlands,0,1,0,1,1928
Jan Ankerman,Netherlands,0,1,0,1,1928
Jan Brand,Netherlands,0,1,0,1,1928
Rein de Waal,Netherlands,0,1,0,1,1928
Emile Duson,Netherlands,0,1,0,1,1928
Gerrit Jannink,Netherlands,0,1,0,1,1928
Adriaan Katte,Netherlands,0,1,0,1,1928
August Kop,Netherlands,0,1,0,1,1928
Ab Tresling,Netherlands,0,1,0,1,1928
Paul van de Rovaart,Netherlands,0,1,0,1,1928
Robert van der Veen,Netherlands,0,1,0,1,1928
Haas Visser 't Hooft,Netherlands,0,1,0,1,1928
Muriel Freeman,Great Britain,0,1,0,1,1928
Gaston Amson,France,0,1,0,1,1928
René Barbier,France,0,1,0,1,1928
Philippe Cattiau,France,0,1,0,1,1928
Émile Cornic,France,0,1,0,1,1928
Roger Ducret,France,0,1,0,1,1928
Raymond Flacher,France,0,1,0,1,1928
André Gaboriaud,France,0,1,0,1,1928
André Labatut,France,0,1,0,1,1928
Armand Massard,France,0,1,0,1,1928
Bernard Schmetz,France,0,1,0,1,1928
Erwin Casmir,Germany,0,1,0,1,1928
Renato Anselmi,Italy,0,1,0,1,1928
Gustavo Marzi,Italy,0,1,0,1,1928
Emilio Salafia,Italy,0,1,0,1,1928
Giulio Sarrocchi,Italy,0,1,0,1,1928
Ludovico Bidoglio,Argentina,0,1,0,1,1928
Ángel Bossio,Argentina,0,1,0,1,1928
Saúl Calandra,Argentina,0,1,0,1,1928
Alfredo Carricaberry,Argentina,0,1,0,1,1928
Roberto Cherro,Argentina,0,1,0,1,1928
Octavio Díaz,Argentina,0,1,0,1,1928
Juan Evaristo,Argentina,0,1,0,1,1928
Manuel Ferreira,Argentina,0,1,0,1,1928
Enrique Gainzarain,Argentina,0,1,0,1,1928
Ángel Segundo Médici,Argentina,0,1,0,1,1928
Luis Felipe Monti,Argentina,0,1,0,1,1928
Rodolfo Orlandini,Argentina,0,1,0,1,1928
Raimundo Orsi,Argentina,0,1,0,1,1928
Fernando Paternoster,Argentina,0,1,0,1,1928
Feliciano Perducca,Argentina,0,1,0,1,1928
Domingo Tarasconi,Argentina,0,1,0,1,1928
Bianca Ambrosetti,Italy,0,1,0,1,1928
Lavinia Gianoni,Italy,0,1,0,1,1928
Luigina Giavotti,Italy,0,1,0,1,1928
Virginia Giorgi,Italy,0,1,0,1,1928
Germana Malabarba,Italy,0,1,0,1,1928
Carla Marangoni,Italy,0,1,0,1,1928
Luigina Perversi,Italy,0,1,0,1,1928
Diana Pizzavini,Italy,0,1,0,1,1928
Anna Luisa Tanzini,Italy,0,1,0,1,1928
Carolina Tronconi,Italy,0,1,0,1,1928
Ines Vercesi,Italy,0,1,0,1,1928
Rita Vittadini,Italy,0,1,0,1,1928
Romeo Neri,Italy,0,1,0,1,1928
Josef Effenberger,Czech Republic,0,1,0,1,1928
Jan Gajdoš,Czech Republic,0,1,0,1,1928
Jan Koutný,Czech Republic,0,1,0,1,1928
Bedřich Šupčík,Czech Republic,0,1,0,1,1928
Ladislav Tikal,Czech Republic,0,1,0,1,1928
Václav Veselý,Czech Republic,0,1,0,1,1928
Bo Lindman,Sweden,0,1,0,1,1928
Jack Guest,Canada,0,1,0,1,1928
"Joe Wright, Jr.",Canada,0,1,0,1,1928
Armand Marcelle,France,0,1,0,1,1928
Édouard Marcelle,France,0,1,0,1,1928
Henri Préaux,France,0,1,0,1,1928
Felix Badcock,Great Britain,0,1,0,1,1928
Jack Beresford,Great Britain,0,1,0,1,1928
Donald Gollan,Great Britain,0,1,0,1,1928
Jamie Hamilton,Great Britain,0,1,0,1,1928
Gordon Killick,Great Britain,0,1,0,1,1928
Harold Lane,Great Britain,0,1,0,1,1928
Guy O. Nickalls,Great Britain,0,1,0,1,1928
Archie Nisbet,Great Britain,0,1,0,1,1928
Terence O'Brien,Great Britain,0,1,0,1,1928
Arthur Sulley,Great Britain,0,1,0,1,1928
Harold West,Great Britain,0,1,0,1,1928
Otto Bucher,Switzerland,0,1,0,1,1928
Fritz Bösch,Switzerland,0,1,0,1,1928
Ernst Haas,Switzerland,0,1,0,1,1928
Joseph Meyer,Switzerland,0,1,0,1,1928
Karl Schwegler,Switzerland,0,1,0,1,1928
Ernest Bayer,United States,0,1,0,1,1928
George Healis,United States,0,1,0,1,1928
Charles Karle,United States,0,1,0,1,1928
Bill Miller,United States,0,1,0,1,1928
Ken Myers,United States,0,1,0,1,1928
Cissie Stewart,Great Britain,0,1,0,1,1928
Vera Tanner,Great Britain,0,1,0,1,1928
István Bárány,Hungary,0,1,0,1,1928
Nobuo Arai,Japan,0,1,0,1,1928
Tokuhei Sata,Japan,0,1,0,1,1928
Hiroshi Yoneyama,Japan,0,1,0,1,1928
Marie Baron,Netherlands,0,1,0,1,1928
Dorothy Poynton-Hill,United States,0,1,0,1,1928
István Barta,Hungary,0,1,0,1,1928
Olivér Halassy,Hungary,0,1,0,1,1928
Márton Homonnai,Hungary,0,1,0,1,1928
Sándor Ivády,Hungary,0,1,0,1,1928
Alajos Keserű,Hungary,0,1,0,1,1928
Ferenc Keserű,Hungary,0,1,0,1,1928
József Vértesy,Hungary,0,1,0,1,1928
Arnold Luhaäär,Estonia,0,1,0,1,1928
Louis Hostin,France,0,1,0,1,1928
Pierino Gabetti,Italy,0,1,0,1,1928
Carlo Galimberti,Italy,0,1,0,1,1928
Edmond Spapen,Belgium,0,1,0,1,1928
Donald Stockton,Canada,0,1,0,1,1928
Hjalmar Nyström,Finland,0,1,0,1,1928
Kustaa Pihlajamäki,Finland,0,1,0,1,1928
Aukusti Sihvola,Finland,0,1,0,1,1928
Charles Pacôme,France,0,1,0,1,1928
Adolf Rieger,Germany,0,1,0,1,1928
Ede Sperling,Germany,0,1,0,1,1928
László Papp,Hungary,0,1,0,1,1928
Arnold Bögli,Switzerland,0,1,0,1,1928
Erik Malmberg,Sweden,0,1,0,1,1928
Jindřich Maudr,Czech Republic,0,1,0,1,1928
Lloyd Appleton,United States,0,1,0,1,1928
Gerard de Vries Lentsch,Netherlands,0,1,0,1,1928
Maarten de Wit,Netherlands,0,1,0,1,1928
Lambertus Doedes,Netherlands,0,1,0,1,1928
Henk Kersken,Netherlands,0,1,0,1,1928
Niels Otto Møller,Denmark,0,1,0,1,1928
Aage Høy-Pedersen,Denmark,0,1,0,1,1928
Henrik Robert,Norway,0,1,0,1,1928
Peter Schlütter,Denmark,0,1,0,1,1928
Johannes van Hoolwerff,Netherlands,0,1,0,1,1928
Cornelis van Staveren,Netherlands,0,1,0,1,1928
Vilhelm Vett,Denmark,0,1,0,1,1928
Manuel Plaza,Chile,0,1,0,1,1928
Akilles Järvinen,Finland,0,1,0,1,1928
Antero Kivi,Finland,0,1,0,1,1928
Jules Ladoumègue,France,0,1,0,1,1928
Richard Corts,Germany,0,1,0,1,1928
Hubert Houben,Germany,0,1,0,1,1928
Richard Krebs,Germany,0,1,0,1,1928
Otto Neumann,Germany,0,1,0,1,1928
Harry Storz,Germany,0,1,0,1,1928
Sylvio Cator,Haiti,0,1,0,1,1928
Kinue Hitomi,Japan,0,1,0,1,1928
Lien Gisolf,Netherlands,0,1,0,1,1928
Erik Byléhn,Sweden,0,1,0,1,1928
Ossian Skiöld,Sweden,0,1,0,1,1928
Lillian Copeland,United States,0,1,0,1,1928
Jessie Cross,United States,0,1,0,1,1928
Loretta McNeil,United States,0,1,0,1,1928
Mary Washburn,United States,0,1,0,1,1928
Steve Anderson,United States,0,1,0,1,1928
Herman Brix,United States,0,1,0,1,1928
Lee Casey,United States,0,1,0,1,1928
Frank Cuhel,United States,0,1,0,1,1928
Bill Droegemueller,United States,0,1,0,1,1928
Ben Hedges,United States,0,1,0,1,1928
Béla Szepes,Hungary,0,1,0,1,1928
Ejnar Mindedal Rasmussen,Denmark,0,1,0,1,1928
Alex Virot,France,0,1,0,1,1928
Laura Knight,Great Britain,0,1,0,1,1928
Rudolf Binding,Germany,0,1,0,1,1928
Ernst Weiß,Germany,0,1,0,1,1928
Lauro De Bosis,Italy,0,1,0,1,1928
Chris van der Hoef,Netherlands,0,1,0,1,1928
Milo Martin,Switzerland,0,1,0,1,1928
Carl Moos,Switzerland,0,1,0,1,1928
Gösta Carlsson,Sweden,0,0,2,2,1928
Stane Derganc,Slovenia,0,0,2,2,1928
Edvin Wide,Sweden,0,0,2,2,1928
Ray Smillie,Canada,0,0,1,1,1928
Jakob Michaelsen,Denmark,0,0,1,1,1928
Carlo Cavagnoli,Italy,0,0,1,1,1928
Karel Miljon,Netherlands,0,0,1,1,1928
Leonard Steyaert,Belgium,0,0,1,1,1928
Harry Isaacs,South Africa,0,0,1,1,1928
Gunnar Berggren,Sweden,0,0,1,1,1928
Harry Devine,United States,0,0,1,1,1928
Carl Björnstjerna,Sweden,0,0,1,1,1928
Karol von Rómmel,Poland,0,0,1,1,1928
Ernst Hallberg,Sweden,0,0,1,1,1928
Karl Hansen,Sweden,0,0,1,1,1928
Charles Kuhn,Switzerland,0,0,1,1,1928
Gerard le Heux,Netherlands,0,0,1,1,1928
Bruno Neumann,Germany,0,0,1,1,1928
Józef Trenkwald,Poland,0,0,1,1,1928
Jan van Reede,Netherlands,0,0,1,1,1928
Pierre Versteegh,Netherlands,0,0,1,1,1928
Hans Bernhardt,Germany,0,0,1,1,1928
Dunc Gray,Australia,0,0,1,1,1928
Erik Jansson,Sweden,0,0,1,1,1928
Georg Johnsson,Sweden,0,0,1,1,1928
Karl Köther,Germany,0,0,1,1,1928
Hjalmar Pettersson,Sweden,0,0,1,1,1928
Monty Southall,Great Britain,0,0,1,1,1928
Harry Wyld,Great Britain,0,0,1,1,1928
Lew Wyld,Great Britain,0,0,1,1,1928
Percy Wyld,Great Britain,0,0,1,1,1928
Benno Boche,Germany,0,0,1,1,1928
Georg Brunner,Germany,0,0,1,1,1928
Erwin Franzkowiak,Germany,0,0,1,1,1928
Werner Freyberg,Germany,0,0,1,1,1928
Heinz Foerstendorf,Germany,0,0,1,1,1928
Hans Haußmann,Germany,0,0,1,1,1928
Kurt Haverbeck,Germany,0,0,1,1,1928
Herbert Hobein,Germany,0,0,1,1,1928
Fritz Horn,Germany,0,0,1,1,1928
Theo Haag,Germany,0,0,1,1,1928
Karl-Heinz Irmer,Germany,0,0,1,1,1928
Herbert Kemmer,Germany,0,0,1,1,1928
Herbert Müller,Germany,0,0,1,1,1928
Werner Proft,Germany,0,0,1,1,1928
Gerd Strantzen,Germany,0,0,1,1,1928
Rolf Wollner,Germany,0,0,1,1,1928
Heinz Wöltje,Germany,0,0,1,1,1928
Erich Zander,Germany,0,0,1,1,1928
Olga Oelkers,Germany,0,0,1,1,1928
Raúl Anganuzzi,Argentina,0,0,1,1,1928
Carmelo Camet,Argentina,0,0,1,1,1928
Roberto Larraz,Argentina,0,0,1,1,1928
Héctor Lucchetti,Argentina,0,0,1,1,1928
Luis Lucchetti,Argentina,0,0,1,1,1928
Tadeusz Friedrich,Poland,0,0,1,1,1928
Kazimierz Laskowski,Poland,0,0,1,1,1928
Aleksander Małecki,Poland,0,0,1,1,1928
Adam Papée,Poland,0,0,1,1,1928
Władysław Segda,Poland,0,0,1,1,1928
Jerzy Zabielski,Poland,0,0,1,1,1928
Henrique da Silveira,Portugal,0,0,1,1,1928
Mário de Noronha,Portugal,0,0,1,1,1928
Jorge de Paiva,Portugal,0,0,1,1,1928
Paulo Leal,Portugal,0,0,1,1,1928
Frederico Paredes,Portugal,0,0,1,1,1928
João Sassetti,Portugal,0,0,1,1,1928
George Calnan,United States,0,0,1,1,1928
Adolfo Baloncieri,Italy,0,0,1,1,1928
Elvio Banchero,Italy,0,0,1,1,1928
Delfo Bellini,Italy,0,0,1,1,1928
Fulvio Bernardini,Italy,0,0,1,1,1928
Umberto Caligaris,Italy,0,0,1,1,1928
Gianpiero Combi,Italy,0,0,1,1,1928
Giovanni De Prà,Italy,0,0,1,1,1928
Pietro Genovesi,Italy,0,0,1,1,1928
Antonio Janni,Italy,0,0,1,1,1928
Virgilio Levratto,Italy,0,0,1,1,1928
Mario Magnozzi,Italy,0,0,1,1,1928
Silvio Pietroboni,Italy,0,0,1,1,1928
Alfredo Pitto,Italy,0,0,1,1,1928
Enrico Rivolta,Italy,0,0,1,1,1928
Virginio Rosetta,Italy,0,0,1,1,1928
Gino Rossetti,Italy,0,0,1,1,1928
Angelo Schiavio,Italy,0,0,1,1,1928
Annie Broadbent,Great Britain,0,0,1,1,1928
Lucy Desmond,Great Britain,0,0,1,1,1928
Margaret Hartley,Great Britain,0,0,1,1,1928
Amy Jagger,Great Britain,0,0,1,1,1928
Queenie Judd,Great Britain,0,0,1,1,1928
Jessie Kite,Great Britain,0,0,1,1,1928
Midge Moreman,Great Britain,0,0,1,1,1928
Carrie Pickles,Great Britain,0,0,1,1,1928
Ethel Seymour,Great Britain,0,0,1,1,1928
Ada Smith,Great Britain,0,0,1,1,1928
Hilda Smith,Great Britain,0,0,1,1,1928
Doris Woods,Great Britain,0,0,1,1,1928
Heikki Savolainen,Finland,0,0,1,1,1928
Aribert Heymann,Germany,0,0,1,1,1928
Edvard Antonijevič,Slovenia,0,0,1,1,1928
Drago Ciotti,Croatia,0,0,1,1,1928
Boris Gregorka,Slovenia,0,0,1,1,1928
Anton Malej,Slovenia,0,0,1,1,1928
Janez Porenta,Slovenia,0,0,1,1,1928
Helmut Kahl,Germany,0,0,1,1,1928
Viktor Flessl,Austria,0,0,1,1,1928
Leo Losert,Austria,0,0,1,1,1928
Georges Anthony,Belgium,0,0,1,1,1928
François De Coninck,Belgium,0,0,1,1,1928
Léon Flament,Belgium,0,0,1,1,1928
John Donnelly,Canada,0,0,1,1,1928
Frank Fiddes,Canada,0,0,1,1,1928
Jack Hand,Canada,0,0,1,1,1928
Frederick Hedges,Canada,0,0,1,1,1928
Athol Meech,Canada,0,0,1,1,1928
Jack Murdoch,Canada,0,0,1,1,1928
Edgar Norris,Canada,0,0,1,1,1928
Bert Richardson,Canada,0,0,1,1,1928
Bill Ross,Canada,0,0,1,1,1928
David Collet,Great Britain,0,0,1,1,1928
Umberto Bonadè,Italy,0,0,1,1,1928
Pietro Freschi,Italy,0,0,1,1,1928
Paolo Gennari,Italy,0,0,1,1,1928
Cesare Rossi,Italy,0,0,1,1,1928
Leon Birkholc,Poland,0,0,1,1,1928
Franciszek Bronikowski,Poland,0,0,1,1,1928
Bolesław Drewek,Poland,0,0,1,1,1928
Edmund Jankowski,Poland,0,0,1,1,1928
Bernard Ormanowski,Poland,0,0,1,1,1928
Paul McDowell,United States,0,0,1,1,1928
John Schmitt,United States,0,0,1,1,1928
Garnet Ault,Canada,0,0,1,1,1928
Munroe Bourne,Canada,0,0,1,1,1928
Walter Spence,Canada,0,0,1,1,1928
Jimmy Thompson,Canada,0,0,1,1,1928
Albert Vandeplancke,France,0,0,1,1,1928
Lotte Mühe,Germany,0,0,1,1,1928
Teófilo Yldefonso,Philippines,0,0,1,1,1928
Mary Bedford,South Africa,0,0,1,1,1928
Rhoda Rennie,South Africa,0,0,1,1,1928
Kathleen Russell,South Africa,0,0,1,1,1928
Freddie van der Goes,South Africa,0,0,1,1,1928
Lala Sjöqvist,Sweden,0,0,1,1,1928
Josephine McKim,United States,0,0,1,1,1928
Buster Crabbe,United States,0,0,1,1,1928
Paul Wyatt,United States,0,0,1,1,1928
Émile Bulteel,France,0,0,1,1,1928
Henri Cuvelier,France,0,0,1,1,1928
Paul Dujardin,France,0,0,1,1,1928
Jules Keignaert,France,0,0,1,1,1928
"Henri Padou, Sr.",France,0,0,1,1,1928
Ernest Rogez,France,0,0,1,1,1928
Albert Thévenon,France,0,0,1,1,1928
Achille Tribouillet,France,0,0,1,1,1928
Fernand Arnout,France,0,0,1,1,1928
Hans Wölpert,Germany,0,0,1,1,1928
Guus Scheffer,Netherlands,0,0,1,1,1928
Jan Verheijen,Netherlands,0,0,1,1,1928
Jaroslav Skobla,Czech Republic,0,0,1,1,1928
Maurice Letchford,Canada,0,0,1,1,1928
Jim Trifunov,Canada,0,0,1,1,1928
Albert Kusnets,Estonia,0,0,1,1,1928
Eino Leino,Finland,0,0,1,1,1928
Onni Pellinen,Finland,0,0,1,1,1928
Edvard Westerlund,Finland,0,0,1,1,1928
Edmond Dame,France,0,0,1,1,1928
Henri Lefèbvre,France,0,0,1,1,1928
Sam Rabin,Great Britain,0,0,1,1,1928
Georg Gehring,Germany,0,0,1,1,1928
Giovanni Gozzi,Italy,0,0,1,1,1928
Gerolamo Quaglia,Italy,0,0,1,1,1928
Hans Minder,Switzerland,0,0,1,1,1928
Bertel Broman,Finland,0,0,1,1,1928
Andreas Faehlmann,Estonia,0,0,1,1,1928
Georg Faehlmann,Estonia,0,0,1,1,1928
Clarence Hammar,Sweden,0,0,1,1,1928
Tore Holm,Sweden,0,0,1,1,1928
Carl Sandblom,Sweden,0,0,1,1,1928
John Sandblom,Sweden,0,0,1,1,1928
Philip Sandblom,Sweden,0,0,1,1,1928
Wilhelm Törsleff,Sweden,0,0,1,1,1928
Nikolai Vekšin,Estonia,0,0,1,1,1928
Eberhard Vogdt,Estonia,0,0,1,1,1928
William von Wirén,Estonia,0,0,1,1,1928
Phil Edwards,Canada,0,0,1,1,1928
Stan Glover,Canada,0,0,1,1,1928
Alex Wilson,Canada,0,0,1,1,1928
Ove Andersen,Finland,0,0,1,1,1928
Martti Marttelin,Finland,0,0,1,1,1928
Eino Purje,Finland,0,0,1,1,1928
Ville Tuulos,Finland,0,0,1,1,1928
Claude Ménard,France,0,0,1,1,1928
Cyril Gill,Great Britain,0,0,1,1,1928
Teddy Smouha,Great Britain,0,0,1,1,1928
Anni Holdmann,Germany,0,0,1,1,1928
Leni Junker,Germany,0,0,1,1,1928
Rosa Kellner,Germany,0,0,1,1,1928
Leni Schmidt,Germany,0,0,1,1,1928
Jochen Büchner,Germany,0,0,1,1,1928
Emil Hirschfeld,Germany,0,0,1,1,1928
Olav Sunde,Norway,0,0,1,1,1928
Inga Gentzel,Sweden,0,0,1,1,1928
Ruth Svedberg,Sweden,0,0,1,1,1928
Mildred Wiley,United States,0,0,1,1,1928
Al Bates,United States,0,0,1,1,1928
Ed Black,United States,0,0,1,1,1928
John Collier,United States,0,0,1,1,1928
Jim Corson,United States,0,0,1,1,1928
Ken Doherty,United States,0,0,1,1,1928
Charles McGinnis,United States,0,0,1,1,1928
Morgan Taylor,United States,0,0,1,1,1928
Rudolf Simonsen,Denmark,0,0,1,1,1928
Johannes Weltzer,Denmark,0,0,1,1,1928
Max Feldbauer,Germany,0,0,1,1,1928
Walther Klemm,Germany,0,0,1,1,1928
Max Laeuger,Germany,0,0,1,1,1928
Edwin Scharff,Germany,0,0,1,1,1928
Renée Sintenis,Germany,0,0,1,1,1928
Carel Scharten,Netherlands,0,0,1,1,1928
Margo Scharten-Antink,Netherlands,0,0,1,1,1928
Władysław Skoczylas,Poland,0,0,1,1,1928
Romeo Neri,Italy,3,0,0,3,1932
Helene Madison,United States,3,0,0,3,1932
István Pelle,Hungary,2,2,0,4,1932
Babe Didrikson,United States,2,1,0,3,1932
Xavier Lesage,France,2,0,0,2,1932
Attilio Pavesi,Italy,2,0,0,2,1932
Philippe Cattiau,France,2,0,0,2,1932
Jean Piot,France,2,0,0,2,1932
György Piller,Hungary,2,0,0,2,1932
Savino Guglielmetti,Italy,2,0,0,2,1932
Hugh Edwards,Great Britain,2,0,0,2,1932
Yasuji Miyazaki,Japan,2,0,0,2,1932
Ivar Johansson,Sweden,2,0,0,2,1932
Bill Carr,United States,2,0,0,2,1932
Eddie Tolan,United States,2,0,0,2,1932
Gustavo Marzi,Italy,1,2,0,3,1932
Harry Chamberlin,United States,1,1,0,2,1932
Charles Marion,France,1,1,0,2,1932
Charles Pahud de Mortanges,Netherlands,1,1,0,2,1932
Earl Thomson,United States,1,1,0,2,1932
Louis Chaillot,France,1,1,0,2,1932
Guglielmo Segato,Italy,1,1,0,2,1932
Jacques van Egmond,Netherlands,1,1,0,2,1932
Géo Buchard,France,1,1,0,2,1932
Giancarlo Cornaggia-Medici,Italy,1,1,0,2,1932
Georgia Coleman,United States,1,1,0,2,1932
Mickey Galitzen,United States,1,1,0,2,1932
Harold Smith,United States,1,1,0,2,1932
Volmari Iso-Hollo,Finland,1,1,0,2,1932
Tommy Hampson,Great Britain,1,1,0,2,1932
Endre Kabos,Hungary,1,0,1,2,1932
Mario Lertora,Italy,1,0,1,2,1932
Eleanor Garatti-Saville,United States,1,0,1,2,1932
Chuhei Nanbu,Japan,1,0,1,2,1932
Billie von Bremen,United States,1,0,1,2,1932
Lefty Gwynne,Canada,1,0,0,1,1932
István Énekes,Hungary,1,0,0,1,1932
Alberto Lovell,Argentina,1,0,0,1,1932
Carmelo Robledo,Argentina,1,0,0,1,1932
Dave Carstens,South Africa,1,0,0,1,1932
Laurie Stevens,South Africa,1,0,0,1,1932
Carmen Barth,United States,1,0,0,1,1932
Eddie Flynn,United States,1,0,0,1,1932
Eddie Argo,United States,1,0,0,1,1932
André Jousseaumé,France,1,0,0,1,1932
"Takeichi, Baron Nishi",Japan,1,0,0,1,1932
Nino Borsari,Italy,1,0,0,1,1932
Marco Cimatti,Italy,1,0,0,1,1932
Alberto Ghilardi,Italy,1,0,0,1,1932
Dunc Gray,Australia,1,0,0,1,1932
Giuseppe Olmo,Italy,1,0,0,1,1932
Paolo Pedretti,Italy,1,0,0,1,1932
Maurice Perrin,France,1,0,0,1,1932
Richard Allen,India,1,0,0,1,1932
Dhyan Chand,India,1,0,0,1,1932
Roop Singh,India,1,0,0,1,1932
Lal Shah Bokhari,India,1,0,0,1,1932
Dickie Carr,India,1,0,0,1,1932
Leslie Hammond,India,1,0,0,1,1932
Arthur Hind,India,1,0,0,1,1932
Sayed Jaffar,India,1,0,0,1,1932
Masude Minhas,India,1,0,0,1,1932
Eric Pinniger,India,1,0,0,1,1932
Gurmit Singh,India,1,0,0,1,1932
Carlyle Tapsell,India,1,0,0,1,1932
Ellen Müller-Preis,Austria,1,0,0,1,1932
René Bondoux,France,1,0,0,1,1932
René Bougnol,France,1,0,0,1,1932
Edward Gardère,France,1,0,0,1,1932
Fernand Jourdant,France,1,0,0,1,1932
René Lemoine,France,1,0,0,1,1932
Bernard Schmetz,France,1,0,0,1,1932
Georges Tainturier,France,1,0,0,1,1932
Aladár Gerevich,Hungary,1,0,0,1,1932
Gyula Glykais,Hungary,1,0,0,1,1932
Ernő Nagy,Hungary,1,0,0,1,1932
Attila Petschauer,Hungary,1,0,0,1,1932
Oreste Capuzzo,Italy,1,0,0,1,1932
Franco Tognini,Italy,1,0,0,1,1932
Benny Bass,United States,1,0,0,1,1932
Dallas Bixler,United States,1,0,0,1,1932
George Gulack,United States,1,0,0,1,1932
George Roth,United States,1,0,0,1,1932
Rowland Wolfe,United States,1,0,0,1,1932
Johan Oxenstierna,Sweden,1,0,0,1,1932
Bobby Pearce,Australia,1,0,0,1,1932
Felix Badcock,Great Britain,1,0,0,1,1932
Jack Beresford,Great Britain,1,0,0,1,1932
Lewis Clive,Great Britain,1,0,0,1,1932
Rowland George,Great Britain,1,0,0,1,1932
Hans Eller,Germany,1,0,0,1,1932
Horst Hoeck,Germany,1,0,0,1,1932
Walter Meyer,Germany,1,0,0,1,1932
Carlheinz Neumann,Germany,1,0,0,1,1932
Joachim Spremberg,Germany,1,0,0,1,1932
Jim Blair,United States,1,0,0,1,1932
Charles Chandler,United States,1,0,0,1,1932
Dave Dunlap,United States,1,0,0,1,1932
Garrett Gilmore,United States,1,0,0,1,1932
Norey Graham,United States,1,0,0,1,1932
Duncan Gregg,United States,1,0,0,1,1932
Winslow Hall,United States,1,0,0,1,1932
Burt Jastram,United States,1,0,0,1,1932
Ed Jennings,United States,1,0,0,1,1932
Charlie Kieffer,United States,1,0,0,1,1932
Ken Myers,United States,1,0,0,1,1932
Ed Salisbury,United States,1,0,0,1,1932
Joe Schauers,United States,1,0,0,1,1932
Harold Tower,United States,1,0,0,1,1932
Renzo Morigi,Italy,1,0,0,1,1932
Bertil Rönnmark,Sweden,1,0,0,1,1932
Clare Dennis,Australia,1,0,0,1,1932
Kuzuo Kitamura,Japan,1,0,0,1,1932
Masaji Kiyokawa,Japan,1,0,0,1,1932
Hisakichi Toyoda,Japan,1,0,0,1,1932
Yoshiyuki Tsuruta,Japan,1,0,0,1,1932
Takashi Yokoyama,Japan,1,0,0,1,1932
Masanori Yusa,Japan,1,0,0,1,1932
Eleanor Holm,United States,1,0,0,1,1932
Helen Johns,United States,1,0,0,1,1932
Josephine McKim,United States,1,0,0,1,1932
Dorothy Poynton-Hill,United States,1,0,0,1,1932
Buster Crabbe,United States,1,0,0,1,1932
István Barta,Hungary,1,0,0,1,1932
György Bródy,Hungary,1,0,0,1,1932
Olivér Halassy,Hungary,1,0,0,1,1932
Márton Homonnai,Hungary,1,0,0,1,1932
Sándor Ivády,Hungary,1,0,0,1,1932
Alajos Keserű,Hungary,1,0,0,1,1932
Ferenc Keserű,Hungary,1,0,0,1,1932
János Németh,Hungary,1,0,0,1,1932
Miklós Sárkány,Hungary,1,0,0,1,1932
József Vértesy,Hungary,1,0,0,1,1932
René Duverger,France,1,0,0,1,1932
Louis Hostin,France,1,0,0,1,1932
Raymond Suvigny,France,1,0,0,1,1932
Rudolf Ismayr,Germany,1,0,0,1,1932
Jaroslav Skobla,Czech Republic,1,0,0,1,1932
Väinö Kokkinen,Finland,1,0,0,1,1932
Hermanni Pihlajamäki,Finland,1,0,0,1,1932
Charles Pacôme,France,1,0,0,1,1932
Jakob Brendel,Germany,1,0,0,1,1932
Giovanni Gozzi,Italy,1,0,0,1,1932
Erik Malmberg,Sweden,1,0,0,1,1932
Johan Richthoff,Sweden,1,0,0,1,1932
Rudolf Svensson,Sweden,1,0,0,1,1932
Carl Westergren,Sweden,1,0,0,1,1932
Peter Mehringer,United States,1,0,0,1,1932
Bob Pearce,United States,1,0,0,1,1932
Jack VanBebber,United States,1,0,0,1,1932
Olle Åkerlund,Sweden,1,0,0,1,1932
Åke Bergqvist,Sweden,1,0,0,1,1932
John Biby,United States,1,0,0,1,1932
Alphonse Burnand,United States,1,0,0,1,1932
Owen Churchill,United States,1,0,0,1,1932
Bill Cooper,United States,1,0,0,1,1932
Pierpont Davis,United States,1,0,0,1,1932
Karl Dorsey,United States,1,0,0,1,1932
Gilbert Gray,United States,1,0,0,1,1932
Martin Hindorff,Sweden,1,0,0,1,1932
Tore Holm,Sweden,1,0,0,1,1932
John Huettner,United States,1,0,0,1,1932
Jacques Baptiste Lebrun,France,1,0,0,1,1932
Andrew Libano,United States,1,0,0,1,1932
Bob Sutton,United States,1,0,0,1,1932
Thomas Webster,United States,1,0,0,1,1932
Juan Carlos Zabala,Argentina,1,0,0,1,1932
Duncan McNaughton,Canada,1,0,0,1,1932
Matti Järvinen,Finland,1,0,0,1,1932
Lauri Lehtinen,Finland,1,0,0,1,1932
Tommy Green,Great Britain,1,0,0,1,1932
Pat O'Callaghan,Ireland,1,0,0,1,1932
Bob Tisdall,Ireland,1,0,0,1,1932
Luigi Beccali,Italy,1,0,0,1,1932
Stanisława Walasiewicz,Poland,1,0,0,1,1932
Janusz Kusociński,Poland,1,0,0,1,1932
Mary Carew,United States,1,0,0,1,1932
Lillian Copeland,United States,1,0,0,1,1932
Evelyn Furtsch,United States,1,0,0,1,1932
Annette Rogers,United States,1,0,0,1,1932
Jean Shiley,United States,1,0,0,1,1932
Ed Ablowich,United States,1,0,0,1,1932
John Anderson,United States,1,0,0,1,1932
Jim Bausch,United States,1,0,0,1,1932
Hec Dyer,United States,1,0,0,1,1932
Ivan Fuqua,United States,1,0,0,1,1932
Ed Gordon,United States,1,0,0,1,1932
Bob Kiesel,United States,1,0,0,1,1932
Bill Miller,United States,1,0,0,1,1932
George Saling,United States,1,0,0,1,1932
Leo Sexton,United States,1,0,0,1,1932
Emmett Toppino,United States,1,0,0,1,1932
Karl Warner,United States,1,0,0,1,1932
Frank Wykoff,United States,1,0,0,1,1932
Pat Sullivan,India,1,0,0,1,1932
Richard Moore,United States,1,0,0,1,1932
Alan Morgan,United States,1,0,0,1,1932
Kenneth Carey,United States,1,0,0,1,1932
Mohammad Aslam,India,1,0,0,1,1932
Frank Brewin,India,1,0,0,1,1932
Franz Schmid,Germany,1,0,0,1,1932
Toni Schmid,Germany,1,0,0,1,1932
Pierre Bailly,France,1,0,0,1,1932
Gustave Saacké,France,1,0,0,1,1932
John Hughes,Great Britain,1,0,0,1,1932
Paul Bauer,Germany,1,0,0,1,1932
Józef Klukowski,Poland,1,0,0,1,1932
David Wallin,Sweden,1,0,0,1,1932
Lee Blair,United States,1,0,0,1,1932
Joseph Webster Golinkin,United States,1,0,0,1,1932
Mahonri Mackintosh Young,United States,1,0,0,1,1932
Pierre Montenot,France,1,0,0,1,1932
Giulio Gaudini,Italy,0,3,1,4,1932
Ugo Pignotti,Italy,0,2,0,2,1932
Al Jochim,United States,0,2,0,2,1932
Willy den Ouden,Netherlands,0,2,0,2,1932
Hilda Strike,Canada,0,2,0,2,1932
Heikki Savolainen,Finland,0,1,3,4,1932
Alex Wilson,Canada,0,1,2,3,1932
Carlo Agostoni,Italy,0,1,1,2,1932
Joe Levis,United States,0,1,1,2,1932
Frank Haubold,United States,0,1,1,2,1932
Jerzy Braun,Poland,0,1,1,2,1932
Jerzy Skolimowski,Poland,0,1,1,2,1932
Janusz Ślązak,Poland,0,1,1,2,1932
Arthur Jonath,Germany,0,1,1,2,1932
Ralph Metcalfe,United States,0,1,1,2,1932
Amado Azar,Argentina,0,1,0,1,1932
Erich Campe,Germany,0,1,0,1,1932
Josef Schleinkofer,Germany,0,1,0,1,1932
Hans Ziglarski,Germany,0,1,0,1,1932
Gino Rossi,Italy,0,1,0,1,1932
Luigi Rovati,Italy,0,1,0,1,1932
Francisco Cabañas,Mexico,0,1,0,1,1932
Thure Ahlqvist,Sweden,0,1,0,1,1932
"Gustaf Adolf Boltenstern, Jr.",Sweden,0,1,0,1,1932
Thomas Byström,Sweden,0,1,0,1,1932
Bertil Sandström,Sweden,0,1,0,1,1932
Karel Schummelketel,Netherlands,0,1,0,1,1932
"Aernout, Jonkheer van Lennep",Netherlands,0,1,0,1,1932
Ernest Chambers,Great Britain,0,1,0,1,1932
Stan Chambers,Great Britain,0,1,0,1,1932
Paul Chocque,France,0,1,0,1,1932
Amédée Fournier,France,0,1,0,1,1932
Henry Hansen,Denmark,0,1,0,1,1932
René Le Grevès,France,0,1,0,1,1932
Henri Mouillefarine,France,0,1,0,1,1932
Leo Nielsen,Denmark,0,1,0,1,1932
Frode Sørensen,Denmark,0,1,0,1,1932
Shunkichi Hamada,Japan,0,1,0,1,1932
Junzo Inohara,Japan,0,1,0,1,1932
Sadayoshi Kobayashi,Japan,0,1,0,1,1932
Haruhiko Kon,Japan,0,1,0,1,1932
Kenichi Konishi,Japan,0,1,0,1,1932
Hiroshi Nagata,Japan,0,1,0,1,1932
Eiichi Nakamura,Japan,0,1,0,1,1932
Yoshio Sakai,Japan,0,1,0,1,1932
Katsumi Shibata,Japan,0,1,0,1,1932
Akio Soda,Japan,0,1,0,1,1932
Toshio Usami,Japan,0,1,0,1,1932
Judy Guinness Penn-Hughes,Great Britain,0,1,0,1,1932
Renato Anselmi,Italy,0,1,0,1,1932
Arturo De Vecchi,Italy,0,1,0,1,1932
Gioacchino Guaragna,Italy,0,1,0,1,1932
Renzo Minoli,Italy,0,1,0,1,1932
Giorgio Pessina,Italy,0,1,0,1,1932
Saverio Ragno,Italy,0,1,0,1,1932
Franco Riccardi,Italy,0,1,0,1,1932
Emilio Salafia,Italy,0,1,0,1,1932
Rodolfo Terlizzi,Italy,0,1,0,1,1932
Omero Bonoli,Italy,0,1,0,1,1932
Georges Miez,Switzerland,0,1,0,1,1932
Frank Cumiskey,United States,0,1,0,1,1932
Tom Denton,United States,0,1,0,1,1932
Phil Erenberg,United States,0,1,0,1,1932
Jack Galbraith,United States,0,1,0,1,1932
Ed Gross,United States,0,1,0,1,1932
Fred Meyer,United States,0,1,0,1,1932
Michael Schuler,United States,0,1,0,1,1932
Bo Lindman,Sweden,0,1,0,1,1932
Karl Aletter,Germany,0,1,0,1,1932
Herbert Buhtz,Germany,0,1,0,1,1932
Gerhard Boetzelen,Germany,0,1,0,1,1932
Walter Flinsch,Germany,0,1,0,1,1932
Ernst Gaber,Germany,0,1,0,1,1932
Hans Maier,Germany,0,1,0,1,1932
Miltiades Manno,Hungary,0,1,0,1,1932
Mario Balleri,Italy,0,1,0,1,1932
Renato Barbieri,Italy,0,1,0,1,1932
Dino Barsotti,Italy,0,1,0,1,1932
Renato Bracci,Italy,0,1,0,1,1932
Vittorio Cioni,Italy,0,1,0,1,1932
Guglielmo Del Bimbo,Italy,0,1,0,1,1932
Riccardo Divora,Italy,0,1,0,1,1932
Enrico Garzelli,Italy,0,1,0,1,1932
Cesare Milani,Italy,0,1,0,1,1932
Bruno Parovel,Italy,0,1,0,1,1932
Giovanni Plazzer,Italy,0,1,0,1,1932
Giovanni Scher,Italy,0,1,0,1,1932
Bruno Vattovaz,Italy,0,1,0,1,1932
Roberto Vestrini,Italy,0,1,0,1,1932
Bob Stiles,New Zealand,0,1,0,1,1932
Fred Thompson,New Zealand,0,1,0,1,1932
Bill Miller,United States,0,1,0,1,1932
Heinz Hax,Germany,0,1,0,1,1932
Gustavo Huet,Mexico,0,1,0,1,1932
Bonnie Mealing,Australia,0,1,0,1,1932
Jean Taris,France,0,1,0,1,1932
Heiko Schwartz,Germany,0,1,0,1,1932
Hideko Maehata,Japan,0,1,0,1,1932
Toshio Irie,Japan,0,1,0,1,1932
Tatsugo Kawaishi,Japan,0,1,0,1,1932
Reizo Koike,Japan,0,1,0,1,1932
Shozo Makino,Japan,0,1,0,1,1932
Corrie Laddé,Netherlands,0,1,0,1,1932
Puck Oversloot,Netherlands,0,1,0,1,1932
Rie Vierdag,Netherlands,0,1,0,1,1932
Lenore Kight-Wingard,United States,0,1,0,1,1932
Katherine Rawls,United States,0,1,0,1,1932
Frank Booth,United States,0,1,0,1,1932
George Fissler,United States,0,1,0,1,1932
Maiola Kalili,United States,0,1,0,1,1932
Manuella Kalili,United States,0,1,0,1,1932
Emil Benecke,Germany,0,1,0,1,1932
Otto Cordes,Germany,0,1,0,1,1932
Hans Eckstein,Germany,0,1,0,1,1932
Itze Gunst,Germany,0,1,0,1,1932
Erich Rademacher,Germany,0,1,0,1,1932
Joachim Rademacher,Germany,0,1,0,1,1932
Hans Schulze,Germany,0,1,0,1,1932
Hans Haas,Austria,0,1,0,1,1932
Svend Olsen,Denmark,0,1,0,1,1932
Hans Wölpert,Germany,0,1,0,1,1932
Carlo Galimberti,Italy,0,1,0,1,1932
"Václav Pšenička, Sr.",Czech Republic,0,1,0,1,1932
Danny McDonald,Canada,0,1,0,1,1932
Abraham Kurland,Denmark,0,1,0,1,1932
Väinö Kajander,Finland,0,1,0,1,1932
Kyösti Luukko,Finland,0,1,0,1,1932
Onni Pellinen,Finland,0,1,0,1,1932
Wolfgang Ehrl,Germany,0,1,0,1,1932
Jean Földeak,Germany,0,1,0,1,1932
Károly Kárpáti,Hungary,0,1,0,1,1932
Ödön Zombori,Hungary,0,1,0,1,1932
Marcello Nizzola,Italy,0,1,0,1,1932
Thure Sjöstedt,Sweden,0,1,0,1,1932
Josef Urban,Czech Republic,0,1,0,1,1932
Ed Nemir,United States,0,1,0,1,1932
Jack Riley,United States,0,1,0,1,1932
Temple Ashbrook,United States,0,1,0,1,1932
Bob Carlson,United States,0,1,0,1,1932
Ted Conant,United States,0,1,0,1,1932
Jack Cribb,Canada,0,1,0,1,1932
Don Douglas,United States,0,1,0,1,1932
Peter Gordon,Canada,0,1,0,1,1932
George Gyles,Canada,0,1,0,1,1932
Peter Jaffe,Great Britain,0,1,0,1,1932
Harry Jones,Canada,0,1,0,1,1932
Ronald Maitland,Canada,0,1,0,1,1932
Bob Maas,Netherlands,0,1,0,1,1932
Colin Ratsey,Great Britain,0,1,0,1,1932
Charles Smith,United States,0,1,0,1,1932
Hubert Wallace,Canada,0,1,0,1,1932
Mary Frizzell,Canada,0,1,0,1,1932
Mildred Fizzell,Canada,0,1,0,1,1932
Lillian Palmer,Canada,0,1,0,1,1932
Akilles Järvinen,Finland,0,1,0,1,1932
Ville Pörhölä,Finland,0,1,0,1,1932
Matti Sippala,Finland,0,1,0,1,1932
"David, Lord Burghley",Great Britain,0,1,0,1,1932
Jerry Cornes,Great Britain,0,1,0,1,1932
Tom Evenson,Great Britain,0,1,0,1,1932
Sam Ferris,Great Britain,0,1,0,1,1932
Godfrey Rampling,Great Britain,0,1,0,1,1932
Crew Stoneley,Great Britain,0,1,0,1,1932
Ellen Braumüller,Germany,0,1,0,1,1932
Erich Borchmeyer,Germany,0,1,0,1,1932
Fritz Hendrix,Germany,0,1,0,1,1932
Helmut Körnig,Germany,0,1,0,1,1932
Shuhei Nishida,Japan,0,1,0,1,1932
Jānis Dāliņš,Latvia,0,1,0,1,1932
Eric Svensson,Sweden,0,1,0,1,1932
Evelyne Hall,United States,0,1,0,1,1932
Ruth Osburn,United States,0,1,0,1,1932
Percy Beard,United States,0,1,0,1,1932
Ben Eastman,United States,0,1,0,1,1932
Glenn Hardin,United States,0,1,0,1,1932
Ralph Hill,United States,0,1,0,1,1932
Henri LaBorde,United States,0,1,0,1,1932
Lambert Redd,United States,0,1,0,1,1932
Harlow Rothert,United States,0,1,0,1,1932
George Simpson,United States,0,1,0,1,1932
Bob Van Osdel,United States,0,1,0,1,1932
Jens Houmøller Klemmensen,Denmark,0,1,0,1,1932
Josef Petersen,Denmark,0,1,0,1,1932
Janina Konarska-Słonimska,Poland,0,1,0,1,1932
Josef Suk,Czechoslovakia,0,1,0,1,1932
Percy Crosby,United States,0,1,0,1,1932
Frederick MacMonnies,United States,0,1,0,1,1932
Ruth Miller,United States,0,1,0,1,1932
John Russell Pope,United States,0,1,0,1,1932
Phil Edwards,Canada,0,0,3,3,1932
Hiram Tuttle,United States,0,0,2,2,1932
"Clarence von Rosen, Jr.",Sweden,0,0,2,2,1932
Bernhard Britz,Sweden,0,0,2,2,1932
George Calnan,United States,0,0,2,2,1932
Frank Righeimer,United States,0,0,2,2,1932
Einari Teräsvirta,Finland,0,0,2,2,1932
Valerie Davies,Great Britain,0,0,2,2,1932
Nikolaus Hirschl,Austria,0,0,2,2,1932
Lasse Virtanen,Finland,0,0,2,2,1932
Peter Jørgensen,Denmark,0,0,1,1,1932
Bruno Ahlberg,Finland,0,0,1,1,1932
José Luis Villanueva,Philippines,0,0,1,1,1932
Eddie Peirce,South Africa,0,0,1,1,1932
Allan Carlsson,Sweden,0,0,1,1,1932
Nat Bor,United States,0,0,1,1,1932
Fred Feary,United States,0,0,1,1,1932
Lou Salica,United States,0,0,1,1,1932
Isaac Kitts,United States,0,0,1,1,1932
Alvin Moore,United States,0,0,1,1,1932
Arne Berg,Sweden,0,0,1,1,1932
Harald Christensen,Denmark,0,0,1,1,1932
Willy Gervin,Denmark,0,0,1,1,1932
Bill Harvell,Great Britain,0,0,1,1,1932
Charles Holland,Great Britain,0,0,1,1,1932
Sven Höglund,Sweden,0,0,1,1,1932
Ernest Johnson,Great Britain,0,0,1,1,1932
Bruno Pellizzari,Italy,0,0,1,1,1932
Charles Rampelberg,France,0,0,1,1,1932
Frank Southall,Great Britain,0,0,1,1,1932
Bill Boddington,United States,0,0,1,1,1932
Harold Brewster,United States,0,0,1,1,1932
Amos Deacon,United States,0,0,1,1,1932
Horace Disston,United States,0,0,1,1,1932
Sam Ewing,United States,0,0,1,1,1932
Jimmy Gentle,United States,0,0,1,1,1932
Henry Greer,United States,0,0,1,1,1932
Larry Knapp,United States,0,0,1,1,1932
Dave McMullin,United States,0,0,1,1,1932
Leonard O'Brien,United States,0,0,1,1,1932
Charles Sheaffer,United States,0,0,1,1,1932
Fred Wolters,United States,0,0,1,1,1932
Erna Bogen,Hungary,0,0,1,1,1932
Tadeusz Friedrich,Poland,0,0,1,1,1932
Leszek Lubicz-Nycz,Poland,0,0,1,1,1932
Adam Papée,Poland,0,0,1,1,1932
Władysław Segda,Poland,0,0,1,1,1932
Marian Suski,Poland,0,0,1,1,1932
Hugh Alessandroni,United States,0,0,1,1,1932
Miguel de Capriles,United States,0,0,1,1,1932
Dernell Every,United States,0,0,1,1,1932
Gustave Heiss,United States,0,0,1,1,1932
Tracy Jaeckel,United States,0,0,1,1,1932
Curtis Shears,United States,0,0,1,1,1932
Richard Steere,United States,0,0,1,1,1932
Mauri Noroma,Finland,0,0,1,1,1932
Ilmari Pakarinen,Finland,0,0,1,1,1932
Martti Uosikkinen,Finland,0,0,1,1,1932
Giovanni Lattuada,Italy,0,0,1,1,1932
Ed Carmichael,United States,0,0,1,1,1932
Tom Connolly,United States,0,0,1,1,1932
Bill Hermann,United States,0,0,1,1,1932
Bill Kuhlemeier,United States,0,0,1,1,1932
Richard Mayo,United States,0,0,1,1,1932
Don Boal,Canada,0,0,1,1,1932
Noël de Mille,Canada,0,0,1,1,1932
Earl Eastwood,Canada,0,0,1,1,1932
Harry Fry,Canada,0,0,1,1,1932
Joe Harris,Canada,0,0,1,1,1932
Cedric Liddell,Canada,0,0,1,1,1932
Les MacDonald,Canada,0,0,1,1,1932
Ned Pratt,Canada,0,0,1,1,1932
Stan Stanyar,Canada,0,0,1,1,1932
Al Taylor,Canada,0,0,1,1,1932
Bill Thoburn,Canada,0,0,1,1,1932
Pierre Brunet,France,0,0,1,1,1932
Ansèlme Brusa,France,0,0,1,1,1932
André Giriat,France,0,0,1,1,1932
Francesco Cossu,Italy,0,0,1,1,1932
Giliante D'Este,Italy,0,0,1,1,1932
Antonio Ghiardello,Italy,0,0,1,1,1932
Antonio Provenzani Garzoni,Italy,0,0,1,1,1932
Henryk Budziński,Poland,0,0,1,1,1932
Edward Kobyliński,Poland,0,0,1,1,1932
Jan Mikołajczak,Poland,0,0,1,1,1932
Stanisław Urban,Poland,0,0,1,1,1932
Guillermo Douglas,Uruguay,0,0,1,1,1932
Zoltán Soós-Ruszka Hradetzky,Hungary,0,0,1,1,1932
Domenico Matteucci,Italy,0,0,1,1,1932
Else Jacobsen,Denmark,0,0,1,1,1932
Joyce Cooper,Great Britain,0,0,1,1,1932
Edna Hughes,Great Britain,0,0,1,1,1932
Helen Varcoe,Great Britain,0,0,1,1,1932
István Bárány,Hungary,0,0,1,1,1932
László Szabados,Hungary,0,0,1,1,1932
András Székely,Hungary,0,0,1,1,1932
András Wanié,Hungary,0,0,1,1,1932
Kentaro Kawatsu,Japan,0,0,1,1,1932
Tsutomi Oyokota,Japan,0,0,1,1,1932
Teófilo Yldefonso,Philippines,0,0,1,1,1932
Jenny Maakal,South Africa,0,0,1,1,1932
Jane Fauntz,United States,0,0,1,1,1932
Marion Roper,United States,0,0,1,1,1932
Austin Clapp,United States,0,0,1,1,1932
Jim Cristy,United States,0,0,1,1,1932
Dick Degener,United States,0,0,1,1,1932
Frank Kurtz,United States,0,0,1,1,1932
Albert Schwartz,United States,0,0,1,1,1932
Phil Daubenspeck,United States,0,0,1,1,1932
Charley Finn,United States,0,0,1,1,1932
Harold McCallister,United States,0,0,1,1,1932
Wally O'Connor,United States,0,0,1,1,1932
Cal Strong,United States,0,0,1,1,1932
Herb Wildman,United States,0,0,1,1,1932
Karl Hipfinger,Austria,0,0,1,1,1932
Josef Straßberger,Germany,0,0,1,1,1932
Gastone Pierini,Italy,0,0,1,1,1932
Henry Duey,United States,0,0,1,1,1932
Tony Terlazzo,United States,0,0,1,1,1932
Eddie Scarf,Australia,0,0,1,1,1932
Aatos Jaskari,Finland,0,0,1,1,1932
Lauri Koskela,Finland,0,0,1,1,1932
Eino Leino,Finland,0,0,1,1,1932
Louis François,France,0,0,1,1,1932
Ede Sperling,Germany,0,0,1,1,1932
József Tunyogi,Hungary,0,0,1,1,1932
Ercole Gallegati,Italy,0,0,1,1,1932
Mario Gruppioni,Italy,0,0,1,1,1932
Axel Cadier,Sweden,0,0,1,1,1932
Einar Karlsson,Sweden,0,0,1,1,1932
Gustaf Klarén,Sweden,0,0,1,1,1932
Santiago Amat,Spain,0,0,1,1,1932
Gunnar Asther,Sweden,0,0,1,1,1932
Gardner Boultbee,Canada,0,0,1,1,1932
Ken Glass,Canada,0,0,1,1,1932
Philip Rogers,Canada,0,0,1,1,1932
Dan Sundén-Cullberg,Sweden,0,0,1,1,1932
Gerald Wilson,Canada,0,0,1,1,1932
Eva Dawes,Canada,0,0,1,1,1932
Jimmy Ball,Canada,0,0,1,1,1932
Ray Lewis,Canada,0,0,1,1,1932
Eino Penttilä,Finland,0,0,1,1,1932
Armas Toivonen,Finland,0,0,1,1,1932
Paul Winter,France,0,0,1,1,1932
Nellie Halstead,Great Britain,0,0,1,1,1932
Eileen Hiscock,Great Britain,0,0,1,1,1932
Gwen Porter,Great Britain,0,0,1,1,1932
Violet Webb,Great Britain,0,0,1,1,1932
Don Finlay,Great Britain,0,0,1,1,1932
Tilly Fleischer,Germany,0,0,1,1,1932
Wolrad Eberle,Germany,0,0,1,1,1932
Giuseppe Castelli,Italy,0,0,1,1,1932
Ugo Frigerio,Italy,0,0,1,1,1932
Ruggero Maregatti,Italy,0,0,1,1,1932
Gabriele Salviati,Italy,0,0,1,1,1932
Edgardo Toetti,Italy,0,0,1,1,1932
Kenkichi Oshima,Japan,0,0,1,1,1932
Simeon Toribio,Philippines,0,0,1,1,1932
Jadwiga Wajs-Marcinkiewicz,Poland,0,0,1,1,1932
Władysław Dobrowolski,Poland,0,0,1,1,1932
Marjorie Clark,South Africa,0,0,1,1,1932
František Douda,Czech Republic,0,0,1,1,1932
George Jefferson,United States,0,0,1,1,1932
Joe McCluskey,United States,0,0,1,1,1932
Morgan Taylor,United States,0,0,1,1,1932
Pete Zaremba,United States,0,0,1,1,1932
Warren Ingersoll,United States,0,0,1,1,1932
Roy Coffin,United States,0,0,1,1,1932
André Verbeke,Belgium,0,0,1,1,1932
Tait McKenzie,Canada,0,0,1,1,1932
Joachim Karsch,Germany,0,0,1,1,1932
Richard Konwiarz,Germany,0,0,1,1,1932
Gerard Westermann,Netherlands,0,0,1,1,1932
Jakub Obrovský,Czechoslovakia,0,0,1,1,1932
Jesse Owens,United States,4,0,0,4,1936
Konrad Frey,Germany,3,1,2,6,1936
Rie Mastenbroek,Netherlands,3,1,0,4,1936
Alfred Schwarzmann,Germany,3,0,2,5,1936
Robert Charpentier,France,3,0,0,3,1936
Guy Lapébie,France,2,1,0,3,1936
Giulio Gaudini,Italy,2,1,0,3,1936
Gregor Hradetzky,Austria,2,0,0,2,1936
Kurt Hasse,Germany,2,0,0,2,1936
Heinz Pollay,Germany,2,0,0,2,1936
Ludwig Stubbendorff,Germany,2,0,0,2,1936
Jean Goujon,France,2,0,0,2,1936
Endre Kabos,Hungary,2,0,0,2,1936
Franco Riccardi,Italy,2,0,0,2,1936
Kristjan Palusalu,Estonia,2,0,0,2,1936
Helen Stephens,United States,2,0,0,2,1936
Gustavo Marzi,Italy,1,2,0,3,1936
Jack Medica,United States,1,2,0,3,1936
Friedrich Gerhard,Germany,1,1,0,2,1936
Arie van Vliet,Netherlands,1,1,0,2,1936
Saverio Ragno,Italy,1,1,0,2,1936
Georges Miez,Switzerland,1,1,0,2,1936
Masanori Yusa,Japan,1,1,0,2,1936
Marshall Wayne,United States,1,1,0,2,1936
Godfrey Brown,Great Britain,1,1,0,2,1936
Ralph Metcalfe,United States,1,1,0,2,1936
Werner March,Germany,1,1,0,2,1936
Matthias Volz,Germany,1,0,2,3,1936
Aladár Gerevich,Hungary,1,0,1,2,1936
Giorgio Bocchino,Italy,1,0,1,2,1936
Giancarlo Cornaggia-Medici,Italy,1,0,1,2,1936
Aleksanteri Saarvala,Finland,1,0,1,2,1936
Torsten Ullman,Sweden,1,0,1,2,1936
Ferenc Csík,Hungary,1,0,1,2,1936
Shigeo Arai,Japan,1,0,1,2,1936
Dorothy Poynton-Hill,United States,1,0,1,2,1936
Volmari Iso-Hollo,Finland,1,0,1,2,1936
Gerhard Stöck,Germany,1,0,1,2,1936
Naoto Tajima,Japan,1,0,1,2,1936
Sten Suvio,Finland,1,0,0,1,1936
Jean Despeaux,France,1,0,0,1,1936
Roger Michelot,France,1,0,0,1,1936
Óscar Casanovas,Argentina,1,0,0,1,1936
Willi Kaiser,Germany,1,0,0,1,1936
Herbert Runge,Germany,1,0,0,1,1936
Imre Harangi,Hungary,1,0,0,1,1936
Ulderico Sergo,Italy,1,0,0,1,1936
Sam Balter,United States,1,0,0,1,1936
Ralph Bishop,United States,1,0,0,1,1936
Joe Fortenberry,United States,1,0,0,1,1936
Tex Gibbons,United States,1,0,0,1,1936
Francis Johnson,United States,1,0,0,1,1936
Carl Knowles,United States,1,0,0,1,1936
Frank Lubin,United States,1,0,0,1,1936
Art Mollner,United States,1,0,0,1,1936
Don Piper,United States,1,0,0,1,1936
Jack Ragland,United States,1,0,0,1,1936
Willard Schmidt,United States,1,0,0,1,1936
Carl Shy,United States,1,0,0,1,1936
Duane Swanson,United States,1,0,0,1,1936
Bill Wheatley,United States,1,0,0,1,1936
Alfons Dorfner,Austria,1,0,0,1,1936
Adi Kainz,Austria,1,0,0,1,1936
Frank Amyot,Canada,1,0,0,1,1936
Ernst Krebs,Germany,1,0,0,1,1936
Ludwig Landen,Germany,1,0,0,1,1936
Paul Wevers,Germany,1,0,0,1,1936
Erik Bladström,Sweden,1,0,0,1,1936
Sven Johansson,Sweden,1,0,0,1,1936
Jan Brzák-Felix,Czech Republic,1,0,0,1,1936
Václav Mottl,Czech Republic,1,0,0,1,1936
Zdeněk Škrland,Czech Republic,1,0,0,1,1936
Vladimír Syrovátka,Czech Republic,1,0,0,1,1936
Manuel Andrada,Argentina,1,0,0,1,1936
Roberto Cavanagh,Argentina,1,0,0,1,1936
Luis Duggan,Argentina,1,0,0,1,1936
Andrés Gazzotti,Argentina,1,0,0,1,1936
Heinz Brandt,Germany,1,0,0,1,1936
Rudolf Lippert,Germany,1,0,0,1,1936
Marten von Barnekow,Germany,1,0,0,1,1936
Hermann von Oppeln-Bronikowski,Germany,1,0,0,1,1936
Konrad von Wangenheim,Germany,1,0,0,1,1936
Robert Dorgebray,France,1,0,0,1,1936
Ernst Ihbe,Germany,1,0,0,1,1936
Roger Le Nizerhy,France,1,0,0,1,1936
Carl Lorenz,Germany,1,0,0,1,1936
Toni Merkens,Germany,1,0,0,1,1936
Richard Allen,India,1,0,0,1,1936
Dhyan Chand,India,1,0,0,1,1936
Roop Singh,India,1,0,0,1,1936
Ernie Goodsir-Cullen,India,1,0,0,1,1936
Ali Dara,India,1,0,0,1,1936
Lionel Emmett,India,1,0,0,1,1936
Peter Paul Fernandes,India,1,0,0,1,1936
Joe Galibardy,India,1,0,0,1,1936
Sayed Muhammad Hussain,India,1,0,0,1,1936
Sayed Jaffar,India,1,0,0,1,1936
Ahmed Sher Khan,India,1,0,0,1,1936
Ahsan Muhammad Khan,India,1,0,0,1,1936
Mirza Nasir-ud-Din Masood,India,1,0,0,1,1936
Cyril Michie,India,1,0,0,1,1936
Baboo Nimal,India,1,0,0,1,1936
Joe Phillips,India,1,0,0,1,1936
Shabban Shahab-ud-Din,India,1,0,0,1,1936
Gurcharan Singh,India,1,0,0,1,1936
Carlyle Tapsell,India,1,0,0,1,1936
Ilona Elek-Schacherer,Hungary,1,0,0,1,1936
Tibor Berczelly,Hungary,1,0,0,1,1936
Pál Kovács,Hungary,1,0,0,1,1936
László Rajcsányi,Hungary,1,0,0,1,1936
Imre Rajczy,Hungary,1,0,0,1,1936
Giancarlo Brusati,Italy,1,0,0,1,1936
Manlio Di Rosa,Italy,1,0,0,1,1936
Gioacchino Guaragna,Italy,1,0,0,1,1936
Edoardo Mangiarotti,Italy,1,0,0,1,1936
Alfredo Pezzana,Italy,1,0,0,1,1936
Ciro Verratti,Italy,1,0,0,1,1936
Giuseppe Baldo,Italy,1,0,0,1,1936
Sergio Bertoni,Italy,1,0,0,1,1936
Carlo Biagi,Italy,1,0,0,1,1936
Giulio Cappelli,Italy,1,0,0,1,1936
Alfredo Foni,Italy,1,0,0,1,1936
Annibale Frossi,Italy,1,0,0,1,1936
Francesco Gabriotti,Italy,1,0,0,1,1936
Ugo Locatelli,Italy,1,0,0,1,1936
Libero Marchini,Italy,1,0,0,1,1936
Alfonso Negro,Italy,1,0,0,1,1936
Achille Piccini,Italy,1,0,0,1,1936
Pietro Rava,Italy,1,0,0,1,1936
Luigi Scarabello,Italy,1,0,0,1,1936
Bruno Venturini,Italy,1,0,0,1,1936
Erna Bürger,Germany,1,0,0,1,1936
Anita Bärwirth,Germany,1,0,0,1,1936
Isolde Frölian,Germany,1,0,0,1,1936
Friedl Iby,Germany,1,0,0,1,1936
Trudi Meyer,Germany,1,0,0,1,1936
Paula Pöhlsen,Germany,1,0,0,1,1936
Julie Schmitt,Germany,1,0,0,1,1936
Käthe Sohnemann,Germany,1,0,0,1,1936
Franz Beckert,Germany,1,0,0,1,1936
Willi Stadel,Germany,1,0,0,1,1936
Innozenz Stangl,Germany,1,0,0,1,1936
Walter Steffens,Germany,1,0,0,1,1936
Ernst Winter,Germany,1,0,0,1,1936
Alois Hudec,Czech Republic,1,0,0,1,1936
Willy Bandholz,Germany,1,0,0,1,1936
Wilhelm Baumann,Germany,1,0,0,1,1936
Helmut Berthold,Germany,1,0,0,1,1936
Helmut Braselmann,Germany,1,0,0,1,1936
Willi Brinkmann,Germany,1,0,0,1,1936
Georg Dascher,Germany,1,0,0,1,1936
Kurt Dossin,Germany,1,0,0,1,1936
Fritz Fromm,Germany,1,0,0,1,1936
Hannes Hansen,Germany,1,0,0,1,1936
Erich Herrmann,Germany,1,0,0,1,1936
Heinrich Keimig,Germany,1,0,0,1,1936
Hans Keiter,Germany,1,0,0,1,1936
Alfred Klingler,Germany,1,0,0,1,1936
Arthur Knautz,Germany,1,0,0,1,1936
Karl Kreutzberg,Germany,1,0,0,1,1936
Heinz Körvers,Germany,1,0,0,1,1936
Wilhelm Müller,Germany,1,0,0,1,1936
Günther Ortmann,Germany,1,0,0,1,1936
Edgar Reinhardt,Germany,1,0,0,1,1936
Fritz Spengler,Germany,1,0,0,1,1936
Rudolf Stahl,Germany,1,0,0,1,1936
Hans Theilig,Germany,1,0,0,1,1936
Gotthard Handrick,Germany,1,0,0,1,1936
Jack Beresford,Great Britain,1,0,0,1,1936
Dick Southwood,Great Britain,1,0,0,1,1936
Herbert Adamski,Germany,1,0,0,1,1936
Dieter Arend,Germany,1,0,0,1,1936
Fritz Bauer,Germany,1,0,0,1,1936
Rudolf Eckstein,Germany,1,0,0,1,1936
Willi Eichhorn,Germany,1,0,0,1,1936
Ernst Gaber,Germany,1,0,0,1,1936
Gerhard Gustmann,Germany,1,0,0,1,1936
Martin Karl,Germany,1,0,0,1,1936
Hans Maier,Germany,1,0,0,1,1936
Willi Menne,Germany,1,0,0,1,1936
Toni Rom,Germany,1,0,0,1,1936
Gustav Schäfer,Germany,1,0,0,1,1936
Hugo Strauß,Germany,1,0,0,1,1936
Paul Söllner,Germany,1,0,0,1,1936
Walter Volle,Germany,1,0,0,1,1936
Gordy Adam,United States,1,0,0,1,1936
Chuck Day,United States,1,0,0,1,1936
Don Hume,United States,1,0,0,1,1936
Shorty Hunt,United States,1,0,0,1,1936
Jim McMillin,United States,1,0,0,1,1936
Bob Moch,United States,1,0,0,1,1936
Roger Morris,United States,1,0,0,1,1936
Joe Rantz,United States,1,0,0,1,1936
Johnny White,United States,1,0,0,1,1936
Cornelius van Oyen,Germany,1,0,0,1,1936
Willy Røgeberg,Norway,1,0,0,1,1936
Hideko Maehata,Japan,1,0,0,1,1936
Tetsuo Hamuro,Japan,1,0,0,1,1936
Shigeo Sugiura,Japan,1,0,0,1,1936
Masaharu Taguchi,Japan,1,0,0,1,1936
Noboru Terada,Japan,1,0,0,1,1936
Willy den Ouden,Netherlands,1,0,0,1,1936
Jopie Selbach,Netherlands,1,0,0,1,1936
Nida Senff,Netherlands,1,0,0,1,1936
Tini Wagner,Netherlands,1,0,0,1,1936
Marjorie Gestring,United States,1,0,0,1,1936
Dick Degener,United States,1,0,0,1,1936
Adolph Kiefer,United States,1,0,0,1,1936
Mihály Bozsi,Hungary,1,0,0,1,1936
Jenő Brandi,Hungary,1,0,0,1,1936
György Bródy,Hungary,1,0,0,1,1936
Olivér Halassy,Hungary,1,0,0,1,1936
Kálmán Hazai,Hungary,1,0,0,1,1936
Márton Homonnai,Hungary,1,0,0,1,1936
György Kutasi,Hungary,1,0,0,1,1936
István Molnár,Hungary,1,0,0,1,1936
János Németh,Hungary,1,0,0,1,1936
Miklós Sárkány,Hungary,1,0,0,1,1936
Sándor Tarics,Hungary,1,0,0,1,1936
Robert Fein,Austria,1,0,0,1,1936
Khadr El-Touni,Egypt,1,0,0,1,1936
Anwar Mousbah,Egypt,1,0,0,1,1936
Louis Hostin,France,1,0,0,1,1936
Josef Manger,Germany,1,0,0,1,1936
Tony Terlazzo,United States,1,0,0,1,1936
Lauri Koskela,Finland,1,0,0,1,1936
Kustaa Pihlajamäki,Finland,1,0,0,1,1936
Émile Poilvé,France,1,0,0,1,1936
Károly Kárpáti,Hungary,1,0,0,1,1936
Márton Lőrincz,Hungary,1,0,0,1,1936
Ödön Zombori,Hungary,1,0,0,1,1936
Axel Cadier,Sweden,1,0,0,1,1936
Knut Fridell,Sweden,1,0,0,1,1936
Ivar Johansson,Sweden,1,0,0,1,1936
Rudolf Svedberg,Sweden,1,0,0,1,1936
Yaşar Erkan,Turkey,1,0,0,1,1936
Frank Lewis,United States,1,0,0,1,1936
Miles Bellville,Great Britain,1,0,0,1,1936
Bruno Bianchi,Italy,1,0,0,1,1936
Peter Bischoff,Germany,1,0,0,1,1936
Christopher Boardman,Great Britain,1,0,0,1,1936
Luigi De Manincor,Italy,1,0,0,1,1936
Russell Harmer,Great Britain,1,0,0,1,1936
Daan Kagchelland,Netherlands,1,0,0,1,1936
Charles Leaf,Great Britain,1,0,0,1,1936
Leonard Martin,Great Britain,1,0,0,1,1936
Domenico Mordini,Italy,1,0,0,1,1936
Luigi Mino Poggi,Italy,1,0,0,1,1936
Enrico Poggi,Italy,1,0,0,1,1936
Giovanni Leone Reggio,Italy,1,0,0,1,1936
Hans-Joachim Weise,Germany,1,0,0,1,1936
Gunnar Höckert,Finland,1,0,0,1,1936
Ilmari Salminen,Finland,1,0,0,1,1936
Godfrey Rampling,Great Britain,1,0,0,1,1936
Bill Roberts,Great Britain,1,0,0,1,1936
Harold Whitlock,Great Britain,1,0,0,1,1936
Freddie Wolff,Great Britain,1,0,0,1,1936
Tilly Fleischer,Germany,1,0,0,1,1936
Gisela Mauermayer,Germany,1,0,0,1,1936
Karl Hein,Germany,1,0,0,1,1936
Hans Woellke,Germany,1,0,0,1,1936
Ibolya Csák,Hungary,1,0,0,1,1936
Ondina Valla,Italy,1,0,0,1,1936
Son Gi-Jeong,Japan,1,0,0,1,1936
Jack Lovelock,New Zealand,1,0,0,1,1936
Harriet Bland,United States,1,0,0,1,1936
Betty Robinson,United States,1,0,0,1,1936
Annette Rogers,United States,1,0,0,1,1936
Ken Carpenter,United States,1,0,0,1,1936
Foy Draper,United States,1,0,0,1,1936
Glenn Hardin,United States,1,0,0,1,1936
Corny Johnson,United States,1,0,0,1,1936
Earle Meadows,United States,1,0,0,1,1936
Glenn Morris,United States,1,0,0,1,1936
Forrest Towns,United States,1,0,0,1,1936
Archie Williams,United States,1,0,0,1,1936
John Woodruff,United States,1,0,0,1,1936
Frank Wykoff,United States,1,0,0,1,1936
Hermann Schreiber,Switzerland,1,0,0,1,1936
Günter Oskar Dyhrenfurth,Switzerland,1,0,0,1,1936
Hettie Dyhrenfurth,Switzerland,1,0,0,1,1936
Hermann Kutschera,Austria,1,0,0,1,1936
Urho Karhumäki,Finland,1,0,0,1,1936
Franz Sondinger,Germany,1,0,0,1,1936
Werner Mayer,Germany,1,0,0,1,1936
Paul Höffer,Germany,1,0,0,1,1936
Walter March,Germany,1,0,0,1,1936
Emil Sutor,Germany,1,0,0,1,1936
Farpi Vignoli,Italy,1,0,0,1,1936
Alex Walter Diggelmann,Switzerland,1,0,0,1,1936
Eugen Mack,Switzerland,0,4,1,5,1936
Edward Gardère,France,0,2,0,2,1936
Michael Reusch,Switzerland,0,2,0,2,1936
Josef Walter,Switzerland,0,2,0,2,1936
Karl Proisl,Austria,0,1,1,2,1936
Rupert Weinstabl,Austria,0,1,1,2,1936
Harvey Charters,Canada,0,1,1,2,1936
Warren Saker,Canada,0,1,1,2,1936
Pierre Georget,France,0,1,1,2,1936
Ernst Nievergelt,Switzerland,0,1,1,2,1936
Albert Bachmann,Switzerland,0,1,1,2,1936
Hermann Betschart,Switzerland,0,1,1,2,1936
Alex Homberger,Switzerland,0,1,1,2,1936
Hans Homberger,Switzerland,0,1,1,2,1936
Karl Schmid,Switzerland,0,1,1,2,1936
Gisela Jacob-Arendt,Germany,0,1,1,2,1936
Shunpei Uto,Japan,0,1,1,2,1936
Katherine Rawls,United States,0,1,1,2,1936
August Neo,Estonia,0,1,1,2,1936
Nikolai Stepulov,Estonia,0,1,0,1,1936
Michael Murach,Germany,0,1,0,1,1936
Richard Vogt,Germany,0,1,0,1,1936
Gavino Matta,Italy,0,1,0,1,1936
Henry Tiller,Norway,0,1,0,1,1936
Guillermo Lovell,Argentina,0,1,0,1,1936
Gord Aitchison,Canada,0,1,0,1,1936
Ian Allison,Canada,0,1,0,1,1936
Art Chapman,Canada,0,1,0,1,1936
Chuck Chapman,Canada,0,1,0,1,1936
Ed Dawson,Canada,0,1,0,1,1936
Toots Meretsky,Canada,0,1,0,1,1936
Doug Peden,Canada,0,1,0,1,1936
Jimmy Stewart,Canada,0,1,0,1,1936
Red Wiseman,Canada,0,1,0,1,1936
Charlie Catterall,South Africa,0,1,0,1,1936
Jackie Wilson,United States,0,1,0,1,1936
Viktor Kalisch,Austria,0,1,0,1,1936
Fritz Landertinger,Austria,0,1,0,1,1936
Karl Steinhuber,Austria,0,1,0,1,1936
Henri Eberhardt,France,0,1,0,1,1936
Fritz Bondroit,Germany,0,1,0,1,1936
Helmut Cämmerer,Germany,0,1,0,1,1936
Erich Hanisch,Germany,0,1,0,1,1936
Willi Horn,Germany,0,1,0,1,1936
Ewald Tilker,Germany,0,1,0,1,1936
Bohuslav Karlík,Czech Republic,0,1,0,1,1936
Gérard de Balorre,France,0,1,0,1,1936
Jan de Bruine,Netherlands,0,1,0,1,1936
Daniel Gillois,France,0,1,0,1,1936
Johan Greter,Netherlands,0,1,0,1,1936
André Jousseaumé,France,0,1,0,1,1936
Zdzisław Kawecki,Poland,0,1,0,1,1936
Seweryn Kulesza,Poland,0,1,0,1,1936
Henri Rang,Romania,0,1,0,1,1936
Henryk Leliwa-Roycewicz,Poland,0,1,0,1,1936
Earl Thomson,United States,0,1,0,1,1936
Henri van Schaik,Netherlands,0,1,0,1,1936
Bianco Bianchi,Italy,0,1,0,1,1936
Edgar Buchwalder,Switzerland,0,1,0,1,1936
Mario Gentili,Italy,0,1,0,1,1936
Armando Latini,Italy,0,1,0,1,1936
Bernard Leene,Netherlands,0,1,0,1,1936
Henk Ooms,Netherlands,0,1,0,1,1936
Kurt Ott,Switzerland,0,1,0,1,1936
Severino Rigoni,Italy,0,1,0,1,1936
Gottlieb Weber,Switzerland,0,1,0,1,1936
David Dawnay,Great Britain,0,1,0,1,1936
Bryan Fowler,Great Britain,0,1,0,1,1936
Humphrey Guinness,Great Britain,0,1,0,1,1936
William Hinde,Great Britain,0,1,0,1,1936
Hermann auf der Heide,Germany,0,1,0,1,1936
Ludwig Beisiegel,Germany,0,1,0,1,1936
Erich Cuntz,Germany,0,1,0,1,1936
Karl Dröse,Germany,0,1,0,1,1936
Fredy Gerdes,Germany,0,1,0,1,1936
Werner Hamel,Germany,0,1,0,1,1936
Harald Huffmann,Germany,0,1,0,1,1936
Erwin Keller,Germany,0,1,0,1,1936
Herbert Kemmer,Germany,0,1,0,1,1936
Werner Kubitzki,Germany,0,1,0,1,1936
Paul Mehlitz,Germany,0,1,0,1,1936
Carl Menke,Germany,0,1,0,1,1936
Fritz Messner,Germany,0,1,0,1,1936
Detlef Okrent,Germany,0,1,0,1,1936
Heinrich Peter,Germany,0,1,0,1,1936
Carl Ruck,Germany,0,1,0,1,1936
Heinz Raack,Germany,0,1,0,1,1936
Hans Scherbart,Germany,0,1,0,1,1936
Heinz Schmalix,Germany,0,1,0,1,1936
Tito Warnholtz,Germany,0,1,0,1,1936
Kutti Weiß,Germany,0,1,0,1,1936
Erich Zander,Germany,0,1,0,1,1936
Helene Mayer,Germany,0,1,0,1,1936
René Bondoux,France,0,1,0,1,1936
René Bougnol,France,0,1,0,1,1936
Jacques Coutrot,France,0,1,0,1,1936
André Gardère,France,0,1,0,1,1936
René Lemoine,France,0,1,0,1,1936
Aldo Masciotta,Italy,0,1,0,1,1936
Aldo Montano,Italy,0,1,0,1,1936
Vincenzo Pinton,Italy,0,1,0,1,1936
Athos Tanzini,Italy,0,1,0,1,1936
Gösta Almgren,Sweden,0,1,0,1,1936
Birger Cederin,Sweden,0,1,0,1,1936
Hans Drakenberg,Sweden,0,1,0,1,1936
Hans Granfelt,Sweden,0,1,0,1,1936
Sven Thofelt,Sweden,0,1,0,1,1936
Franz Fuchsberger,Austria,0,1,0,1,1936
Max Hofmeister,Austria,0,1,0,1,1936
Edi Kainberger,Austria,0,1,0,1,1936
Karl Kainberger,Austria,0,1,0,1,1936
Martin Kargl,Austria,0,1,0,1,1936
Josef Kitzmüller,Austria,0,1,0,1,1936
Anton Krenn,Austria,0,1,0,1,1936
Adolf Laudon,Austria,0,1,0,1,1936
Franz Mandl,Austria,0,1,0,1,1936
Klement Steinmetz,Austria,0,1,0,1,1936
Karl Wahlmüller,Austria,0,1,0,1,1936
Walter Werginz,Austria,0,1,0,1,1936
Jaroslava Bajerová,Czech Republic,0,1,0,1,1936
Vlasta Děkanová,Czech Republic,0,1,0,1,1936
Božena Dobešová,Czech Republic,0,1,0,1,1936
Vlasta Foltová,Czech Republic,0,1,0,1,1936
Anna Hřebřinová,Czech Republic,0,1,0,1,1936
Matylda Pálfyová,Czechoslovakia,0,1,0,1,1936
Zdena Veřmiřovská,Czech Republic,0,1,0,1,1936
Marie Větrovská,Czech Republic,0,1,0,1,1936
Walter Bach,Switzerland,0,1,0,1,1936
Walter Beck,Switzerland,0,1,0,1,1936
Edi Steinemann,Switzerland,0,1,0,1,1936
Leon Štukelj,Slovenia,0,1,0,1,1936
Franz Bartl,Austria,0,1,0,1,1936
Franz Berghammer,Austria,0,1,0,1,1936
Franz Bistricky,Austria,0,1,0,1,1936
Franz Brunner,Austria,0,1,0,1,1936
Hans Houschka,Austria,0,1,0,1,1936
Emil Juracka,Austria,0,1,0,1,1936
Ferdinand Kiefler,Austria,0,1,0,1,1936
Josef Krejci,Austria,0,1,0,1,1936
Otto Licha,Austria,0,1,0,1,1936
Fritz Maurer,Austria,0,1,0,1,1936
Anton Perwein,Austria,0,1,0,1,1936
Siegfried Powolny,Austria,0,1,0,1,1936
Siegfried Purner,Austria,0,1,0,1,1936
Walter Reisp,Austria,0,1,0,1,1936
Alfred Schmalzer,Austria,0,1,0,1,1936
Alois Schnabel,Austria,0,1,0,1,1936
Ludwig Schuberth,Austria,0,1,0,1,1936
Hans Tauscher,Austria,0,1,0,1,1936
Jaroslav Volak,Austria,0,1,0,1,1936
Poldl Wohlrab,Austria,0,1,0,1,1936
Fritz Wurmböck,Austria,0,1,0,1,1936
Hans Zehetner,Austria,0,1,0,1,1936
Gustaf Dyrssen,Sweden,0,1,0,1,1936
Charles Leonard,United States,0,1,0,1,1936
Josef Hasenöhrl,Austria,0,1,0,1,1936
Harry Julius Larsen,Denmark,0,1,0,1,1936
Richard Olsen,Denmark,0,1,0,1,1936
Alan Barrett,Great Britain,0,1,0,1,1936
Martin Bristow,Great Britain,0,1,0,1,1936
Peter Jackson,Great Britain,0,1,0,1,1936
Jan Sturrock,Great Britain,0,1,0,1,1936
Willi Kaidel,Germany,0,1,0,1,1936
Joachim Pirsch,Germany,0,1,0,1,1936
Dino Barsotti,Italy,0,1,0,1,1936
Enzo Bartolini,Italy,0,1,0,1,1936
Almiro Bergamo,Italy,0,1,0,1,1936
Mario Checcacci,Italy,0,1,0,1,1936
Guglielmo Del Bimbo,Italy,0,1,0,1,1936
Enrico Garzelli,Italy,0,1,0,1,1936
Oreste Grossi,Italy,0,1,0,1,1936
Cesare Milani,Italy,0,1,0,1,1936
Luciano Negrini,Italy,0,1,0,1,1936
Ottorino Quaglierini,Italy,0,1,0,1,1936
Guido Santin,Italy,0,1,0,1,1936
Dante Secchi,Italy,0,1,0,1,1936
Rolf Spring,Switzerland,0,1,0,1,1936
Heinz Hax,Germany,0,1,0,1,1936
Erich Krempel,Germany,0,1,0,1,1936
Ralph Berzsenyi,Hungary,0,1,0,1,1936
Jeanette Campbell,Argentina,0,1,0,1,1936
Ragnhild Hveger,Denmark,0,1,0,1,1936
Martha Genenger,Germany,0,1,0,1,1936
Ruth Halbsguth,Germany,0,1,0,1,1936
Leni Lohmar,Germany,0,1,0,1,1936
Inge Schmitz,Germany,0,1,0,1,1936
Erwin Sietas,Germany,0,1,0,1,1936
Velma Dunn,United States,0,1,0,1,1936
Ralph Flanagan,United States,0,1,0,1,1936
John Macionis,United States,0,1,0,1,1936
Elbert Root,United States,0,1,0,1,1936
Al Vande Weghe,United States,0,1,0,1,1936
Paul Wolf,United States,0,1,0,1,1936
Bernhard Baier,Germany,0,1,0,1,1936
Itze Gunst,Germany,0,1,0,1,1936
Josef Hauser,Germany,0,1,0,1,1936
Alfred Kienzle,Germany,0,1,0,1,1936
Paul Klingenburg,Germany,0,1,0,1,1936
Heinrich Krug,Germany,0,1,0,1,1936
Hans Schneider,Germany,0,1,0,1,1936
Hans Schulze,Germany,0,1,0,1,1936
Helmut Schwenn,Germany,0,1,0,1,1936
Gustav Schürger,Germany,0,1,0,1,1936
Fritz Stolze,Germany,0,1,0,1,1936
Saleh Mohamed,Egypt,0,1,0,1,1936
Eugen Deutsch,Germany,0,1,0,1,1936
Rudolf Ismayr,Germany,0,1,0,1,1936
"Václav Pšenička, Sr.",Czech Republic,0,1,0,1,1936
Aarne Reini,Finland,0,1,0,1,1936
Wolfgang Ehrl,Germany,0,1,0,1,1936
Ludwig Schweickert,Germany,0,1,0,1,1936
Fritz Schäfer,Germany,0,1,0,1,1936
Edvīns Bietags,Latvia,0,1,0,1,1936
Thure Andersson,Sweden,0,1,0,1,1936
John Nyman,Sweden,0,1,0,1,1936
Egon Svensson,Sweden,0,1,0,1,1936
Jozef Herda,Czechoslovakia,0,1,0,1,1936
Josef Klapuch,Czech Republic,0,1,0,1,1936
Ross Flood,United States,0,1,0,1,1936
Frank Millard,United States,0,1,0,1,1936
Dick Voliva,United States,0,1,0,1,1936
John Ditlev-Simonsen,Norway,0,1,0,1,1936
Olaf Ditlev-Simonsen,Norway,0,1,0,1,1936
Karsten Konow,Norway,0,1,0,1,1936
Magnus Konow,Norway,0,1,0,1,1936
Werner Krogmann,Germany,0,1,0,1,1936
Arvid Laurin,Sweden,0,1,0,1,1936
Fredrik Meyer,Norway,0,1,0,1,1936
Vaadjuv Nyqvist,Norway,0,1,0,1,1936
Lauritz Schmidt,Norway,0,1,0,1,1936
Hans Struksnæs,Norway,0,1,0,1,1936
Alf Tveten,Norway,0,1,0,1,1936
Nordahl Wallem,Norway,0,1,0,1,1936
Uno Wallentin,Sweden,0,1,0,1,1936
Johnny Loaring,Canada,0,1,0,1,1936
Arvo Askola,Finland,0,1,0,1,1936
Sulo Bärlund,Finland,0,1,0,1,1936
Lauri Lehtinen,Finland,0,1,0,1,1936
Yrjö Nikkanen,Finland,0,1,0,1,1936
Kalle Tuominen,Finland,0,1,0,1,1936
Audrey Brown,Great Britain,0,1,0,1,1936
Barbara Burke,Great Britain,0,1,0,1,1936
Eileen Hiscock,Great Britain,0,1,0,1,1936
Dorothy Odam-Tyler,Great Britain,0,1,0,1,1936
Violet Olney,Great Britain,0,1,0,1,1936
Don Finlay,Great Britain,0,1,0,1,1936
Ernie Harper,Great Britain,0,1,0,1,1936
Lies Krüger,Germany,0,1,0,1,1936
Anni Steuer,Germany,0,1,0,1,1936
Erwin Blask,Germany,0,1,0,1,1936
Luz Long,Germany,0,1,0,1,1936
Gianni Caldana,Italy,0,1,0,1,1936
Tullio Gonnelli,Italy,0,1,0,1,1936
Mario Lanzi,Italy,0,1,0,1,1936
Orazio Mariani,Italy,0,1,0,1,1936
Elio Ragni,Italy,0,1,0,1,1936
Masao Harada,Japan,0,1,0,1,1936
Shuhei Nishida,Japan,0,1,0,1,1936
Jadwiga Wajs-Marcinkiewicz,Poland,0,1,0,1,1936
Stanisława Walasiewicz,Poland,0,1,0,1,1936
Arthur Tell Schwab,Switzerland,0,1,0,1,1936
Dave Albritton,United States,0,1,0,1,1936
Harold Cagle,United States,0,1,0,1,1936
Bob Clark,United States,0,1,0,1,1936
Glenn Cunningham,United States,0,1,0,1,1936
Gordon Dunn,United States,0,1,0,1,1936
Al Fitch,United States,0,1,0,1,1936
Eddie O'Brien,United States,0,1,0,1,1936
Mack Robinson,United States,0,1,0,1,1936
Bob Young,United States,0,1,0,1,1936
Jacob Tullin Thams,Norway,0,1,0,1,1936
Ernst Künz,Austria,0,1,0,1,1936
Rudolf Eisenmenger,Austria,0,1,0,1,1936
Arno Breker,Germany,0,1,0,1,1936
Wilhelm Ehmer,Germany,0,1,0,1,1936
Alfred Hierl,Germany,0,1,0,1,1936
Kurt Thomas,Germany,0,1,0,1,1936
Romano Dazzi,Italy,0,1,0,1,1936
Bruno Fattori,Italy,0,1,0,1,1936
Lino Liviabella,Italy,0,1,0,1,1936
Luciano Mercante,Italy,0,1,0,1,1936
Józef Klukowski,Poland,0,1,0,1,1936
Charles Downing Lay,United States,0,1,0,1,1936
Erwin Casmir,Germany,0,0,2,2,1936
Julius Eisenecker,Germany,0,0,2,2,1936
August Heim,Germany,0,0,2,2,1936
Noël Vandernotte,France,0,0,2,2,1936
Tinus Osendarp,Netherlands,0,0,2,2,1936
Gerhard Pedersen,Denmark,0,0,1,1,1936
Josef Miner,Germany,0,0,1,1,1936
Fidel Ortiz,Mexico,0,0,1,1,1936
Erling Nilsen,Norway,0,0,1,1,1936
Francisco Risiglione,Argentina,0,0,1,1,1936
Raúl Villarreal,Argentina,0,0,1,1,1936
Carlos Borja,Mexico,0,0,1,1,1936
Hugo Borja,Mexico,0,0,1,1,1936
Rodolfo Choperena,Mexico,0,0,1,1,1936
Ignacio de la Vega,Mexico,0,0,1,1,1936
Raúl Fernández,Mexico,0,0,1,1,1936
Andrés Gómez,Mexico,0,0,1,1,1936
Silvio Hernández,Mexico,0,0,1,1,1936
Francisco Martínez,Mexico,0,0,1,1,1936
Jesús Olmos,Mexico,0,0,1,1,1936
José Pamplona,Mexico,0,0,1,1,1936
Greer Skousen,Mexico,0,0,1,1,1936
Erik Ågren,Sweden,0,0,1,1,1936
Lou Laurie,United States,0,0,1,1,1936
Xaver Hörmann,Germany,0,0,1,1,1936
Erich Koschik,Germany,0,0,1,1,1936
Jaap Kraaier,Netherlands,0,0,1,1,1936
Nicolaas Tates,Netherlands,0,0,1,1,1936
Wim van der Kroft,Netherlands,0,0,1,1,1936
Cor Wijdekop,Netherlands,0,0,1,1,1936
Piet Wijdekop,Netherlands,0,0,1,1,1936
Tage Fahlborg,Sweden,0,0,1,1,1936
Helge Larsson,Sweden,0,0,1,1,1936
Ernie Riedel,United States,0,0,1,1,1936
Gregor Adlercreutz,Sweden,0,0,1,1,1936
José Beltrão,Portugal,0,0,1,1,1936
Sven Colliander,Sweden,0,0,1,1,1936
Dick Fanshawe,Great Britain,0,0,1,1,1936
Ted Howard-Vyse,Great Britain,0,0,1,1,1936
Hans Lunding,Denmark,0,0,1,1,1936
"Domingos Coutinho, Márquês do Funchal",Portugal,0,0,1,1,1936
Luís Silva,Portugal,0,0,1,1,1936
Alois Podhajsky,Austria,0,0,1,1,1936
Folke Sandström,Sweden,0,0,1,1,1936
Alec Scott,Great Britain,0,0,1,1,1936
József Platthy,Hungary,0,0,1,1,1936
Louis Chaillot,France,0,0,1,1,1936
Auguste Garrebeek,Belgium,0,0,1,1,1936
Harry Hill,Great Britain,0,0,1,1,1936
Ernest Johnson,Great Britain,0,0,1,1,1936
Rudolf Karsch,Germany,0,0,1,1,1936
Charles King,Great Britain,0,0,1,1,1936
Jef Lowagie,Belgium,0,0,1,1,1936
Georges Maton,France,0,0,1,1,1936
Ernie Mills,Great Britain,0,0,1,1,1936
Armand Putzeyse,Belgium,0,0,1,1,1936
Jean-François Van Der Motte,Belgium,0,0,1,1,1936
Juan Gracia,Mexico,0,0,1,1,1936
Julio Müller,Mexico,0,0,1,1,1936
Antonio Nava,Mexico,0,0,1,1,1936
Alberto Ramos,Mexico,0,0,1,1,1936
Henk de Looper,Netherlands,0,0,1,1,1936
Jan de Looper,Netherlands,0,0,1,1,1936
Aat de Roos,Netherlands,0,0,1,1,1936
Rein de Waal,Netherlands,0,0,1,1,1936
Piet Gunning,Netherlands,0,0,1,1,1936
Inge Heijbroek,Netherlands,0,0,1,1,1936
Hans Schnitger,Netherlands,0,0,1,1,1936
René Sparenberg,Netherlands,0,0,1,1,1936
Ernst van den Berg,Netherlands,0,0,1,1,1936
Ru van der Haar,Netherlands,0,0,1,1,1936
Tonny van Lierop,Netherlands,0,0,1,1,1936
Max Westerkamp,Netherlands,0,0,1,1,1936
Ellen Müller-Preis,Austria,0,0,1,1,1936
Géo Buchard,France,0,0,1,1,1936
Philippe Cattiau,France,0,0,1,1,1936
Henri Dulieux,France,0,0,1,1,1936
Michel Pécheux,France,0,0,1,1,1936
Bernard Schmetz,France,0,0,1,1,1936
Paul Wormser,France,0,0,1,1,1936
Otto Adam,Germany,0,0,1,1,1936
Hans Esser,Germany,0,0,1,1,1936
Hans-Georg Jörger,Germany,0,0,1,1,1936
Siegfried Lerdon,Germany,0,0,1,1,1936
Stefan Rosenbauer,Germany,0,0,1,1,1936
Richard Wahl,Germany,0,0,1,1,1936
Arne Brustad,Norway,0,0,1,1,1936
Nils Eriksen,Norway,0,0,1,1,1936
Odd Frantzen,Norway,0,0,1,1,1936
Sverre Hansen,Norway,0,0,1,1,1936
Rolf Holmberg,Norway,0,0,1,1,1936
Øivind Holmsen,Norway,0,0,1,1,1936
Fredrik Horn,Norway,0,0,1,1,1936
Magnar Isaksen,Norway,0,0,1,1,1936
Henry Johansen,Norway,0,0,1,1,1936
Jørgen Juve,Norway,0,0,1,1,1936
Reidar Kvammen,Norway,0,0,1,1,1936
Alf Martinsen,Norway,0,0,1,1,1936
Magdalon Monsen,Norway,0,0,1,1,1936
Frithjof Ulleberg,Norway,0,0,1,1,1936
Margit Csillik,Hungary,0,0,1,1,1936
Margit Kalocsai,Hungary,0,0,1,1,1936
Ilona Madary,Hungary,0,0,1,1,1936
Gabriella Mészáros,Hungary,0,0,1,1,1936
Margit Nagy-Sándor,Hungary,0,0,1,1,1936
Judit Tóth,Hungary,0,0,1,1,1936
Olga Tőrös,Hungary,0,0,1,1,1936
Eszter Voit,Hungary,0,0,1,1,1936
Mauri Noroma,Finland,0,0,1,1,1936
Ilmari Pakarinen,Finland,0,0,1,1,1936
Heikki Savolainen,Finland,0,0,1,1,1936
Esa Seeste,Finland,0,0,1,1,1936
Einari Teräsvirta,Finland,0,0,1,1,1936
Eino Tukiainen,Finland,0,0,1,1,1936
Martti Uosikkinen,Finland,0,0,1,1,1936
Max Bloesch,Switzerland,0,0,1,1,1936
Rolf Faes,Switzerland,0,0,1,1,1936
Burkhard Gantenbein,Switzerland,0,0,1,1,1936
Willy Gysi,Switzerland,0,0,1,1,1936
Erland Herkenrath,Switzerland,0,0,1,1,1936
Ernst Hufschmid,Switzerland,0,0,1,1,1936
Willy Hufschmid,Switzerland,0,0,1,1,1936
Werner Meyer,Switzerland,0,0,1,1,1936
Georg Mischon,Switzerland,0,0,1,1,1936
Werner Scheurmann,Switzerland,0,0,1,1,1936
Edy Schmid,Switzerland,0,0,1,1,1936
Erich Schmitt,Switzerland,0,0,1,1,1936
Willy Schäfer,Switzerland,0,0,1,1,1936
Eugen Seiterle,Switzerland,0,0,1,1,1936
Max Streib,Switzerland,0,0,1,1,1936
Robert Studer,Switzerland,0,0,1,1,1936
Rudolf Wirz,Switzerland,0,0,1,1,1936
Silvano Abbà,Italy,0,0,1,1,1936
Julio Curatella,Argentina,0,0,1,1,1936
Horacio Podestá,Argentina,0,0,1,1,1936
Marcel Chauvigné,France,0,0,1,1,1936
Jean Cosmat,France,0,0,1,1,1936
Marceau Fourcade,France,0,0,1,1,1936
Georges Tapie,France,0,0,1,1,1936
Fernand Vandernotte,France,0,0,1,1,1936
Marcel Vandernotte,France,0,0,1,1,1936
Hans-Joachim Hannemann,Germany,0,0,1,1,1936
Heinz Kaufmann,Germany,0,0,1,1,1936
Hans Kuschke,Germany,0,0,1,1,1936
Werner Loeckle,Germany,0,0,1,1,1936
Wilhelm Mahlow,Germany,0,0,1,1,1936
Helmut Radach,Germany,0,0,1,1,1936
Alfred Rieck,Germany,0,0,1,1,1936
Herbert Schmidt,Germany,0,0,1,1,1936
Gerd Völs,Germany,0,0,1,1,1936
Jerzy Ustupski,Poland,0,0,1,1,1936
Roger Verey,Poland,0,0,1,1,1936
Dan Barrow,United States,0,0,1,1,1936
Charles des Jammonières,France,0,0,1,1,1936
Władysław Karaś,Poland,0,0,1,1,1936
Gérard Blitz,Belgium,0,0,1,1,1936
Pierre Coppieters,Belgium,0,0,1,1,1936
Joseph De Combe,Belgium,0,0,1,1,1936
Inge Sørensen,Denmark,0,0,1,1,1936
Käthe Köhler,Germany,0,0,1,1,1936
Hermann Stork,Germany,0,0,1,1,1936
Oszkár Abay-Nemes,Hungary,0,0,1,1,1936
Ödön Gróf,Hungary,0,0,1,1,1936
Árpád Lengyel,Hungary,0,0,1,1,1936
Masaji Kiyokawa,Japan,0,0,1,1,1936
Reizo Koike,Japan,0,0,1,1,1936
Shozo Makino,Japan,0,0,1,1,1936
Alice Bridges,United States,0,0,1,1,1936
Mavis Freeman,United States,0,0,1,1,1936
Lenore Kight-Wingard,United States,0,0,1,1,1936
Bernice Lapp,United States,0,0,1,1,1936
Olive McKean,United States,0,0,1,1,1936
Al Greene,United States,0,0,1,1,1936
Albert Casteleyns,Belgium,0,0,1,1,1936
Henri De Pauw,Belgium,0,0,1,1,1936
Henri Disy,Belgium,0,0,1,1,1936
Fernand Isselé,Belgium,0,0,1,1,1936
Edmond Michiels,Belgium,0,0,1,1,1936
Henri Stoelen,Belgium,0,0,1,1,1936
Ibrahim Shams,Egypt,0,0,1,1,1936
Wasif Ibrahim,Egypt,0,0,1,1,1936
Arnold Luhaäär,Estonia,0,0,1,1,1936
Karl Jansen,Germany,0,0,1,1,1936
Adolf Wagner,Germany,0,0,1,1,1936
Joe Schleimer,Canada,0,0,1,1,1936
Voldemar Väli,Estonia,0,0,1,1,1936
Hjalmar Nyström,Finland,0,0,1,1,1936
Hermanni Pihlajamäki,Finland,0,0,1,1,1936
Eino Virtanen,Finland,0,0,1,1,1936
Jakob Brendel,Germany,0,0,1,1,1936
Johannes Herbert,Germany,0,0,1,1,1936
Kurt Hornfischer,Germany,0,0,1,1,1936
Erich Siebert,Germany,0,0,1,1,1936
József Palotás,Hungary,0,0,1,1,1936
Gösta Jönsson-Frändfors,Sweden,0,0,1,1,1936
Einar Karlsson,Sweden,0,0,1,1,1936
Ahmet Kireççi,Turkey,0,0,1,1,1936
Dagmar Salén,Sweden,0,0,1,1,1936
Fritz Bischoff,Germany,0,0,1,1,1936
Willem de Vries Lentsch,Netherlands,0,0,1,1,1936
Lennart Ekdahl,Sweden,0,0,1,1,1936
Martin Hindorff,Sweden,0,0,1,1,1936
Hans Howaldt,Germany,0,0,1,1,1936
Alfried von Bohlen und Halbach,Germany,0,0,1,1,1936
Torsten Lord,Sweden,0,0,1,1,1936
Eduard Mohr,Germany,0,0,1,1,1936
Bob Maas,Netherlands,0,0,1,1,1936
Sven Salén,Sweden,0,0,1,1,1936
Felix Scheder-Bieschin,Germany,0,0,1,1,1936
Peter Scott,Great Britain,0,0,1,1,1936
Otto Wachs,Germany,0,0,1,1,1936
Jack Metcalfe,Australia,0,0,1,1,1936
Dot Brookshaw,Canada,0,0,1,1,1936
Hilda Cameron,Canada,0,0,1,1,1936
Jeanette Dolson,Canada,0,0,1,1,1936
Aileen Meagher,Canada,0,0,1,1,1936
Betty Taylor,Canada,0,0,1,1,1936
Phil Edwards,Canada,0,0,1,1,1936
Kalervo Toivonen,Finland,0,0,1,1,1936
Elfriede Kaun,Germany,0,0,1,1,1936
Käthe Krauß,Germany,0,0,1,1,1936
Paula Mollenhauer,Germany,0,0,1,1,1936
Erich Borchmeyer,Germany,0,0,1,1,1936
Alfred Dompert,Germany,0,0,1,1,1936
Erwin Gillmeister,Germany,0,0,1,1,1936
Helmut Hamann,Germany,0,0,1,1,1936
Rudi Harbig,Germany,0,0,1,1,1936
Gerd Hornberger,Germany,0,0,1,1,1936
Wilhelm Leichum,Germany,0,0,1,1,1936
Harry Voigt,Germany,0,0,1,1,1936
Friedrich von Stülpnagel,Germany,0,0,1,1,1936
Luigi Beccali,Italy,0,0,1,1,1936
Giorgio Oberweger,Italy,0,0,1,1,1936
Nam Sung-Yong,Japan,0,0,1,1,1936
Sueo Oe,Japan,0,0,1,1,1936
Adalberts Bubenko,Latvia,0,0,1,1,1936
Miguel White,Philippines,0,0,1,1,1936
Maria Kwaśniewska,Poland,0,0,1,1,1936
Henry Jonsson,Sweden,0,0,1,1,1936
Fred Warngård,Sweden,0,0,1,1,1936
Jimmy Lu Valle,United States,0,0,1,1,1936
Jack Parker,United States,0,0,1,1,1936
Fritz Pollard,United States,0,0,1,1,1936
Delos Thurber,United States,0,0,1,1,1936
Herbert Kastinger,Austria,0,0,1,1,1936
Hermann Stiegholzer,Austria,0,0,1,1,1936
Hans Helmut Stoiber,Austria,0,0,1,1,1936
Jozuë Dupon,Belgium,0,0,1,1,1936
Harald Genzmer,Germany,0,0,1,1,1936
Theodor Nußbaum,Germany,0,0,1,1,1936
Ryuji Fujita,Japan,0,0,1,1,1936
Sujaku Suzuki,Japan,0,0,1,1,1936
Stanisław Ostoja-Chrostowski,Poland,0,0,1,1,1936
Jan Parandowski,Poland,0,0,1,1,1936
Stig Blomberg,Sweden,0,0,1,1,1936
Jaroslav Křička,Czechoslovakia,0,0,1,1,1936
Fanny Blankers-Koen,Netherlands,4,0,0,4,1948
Veikko Huhtanen,Finland,3,1,1,5,1948
Paavo Aaltonen,Finland,3,0,1,4,1948
Ann Curtis,United States,2,1,0,3,1948
Jimmy McLane,United States,2,1,0,3,1948
Humberto Mariles,Mexico,2,0,1,3,1948
Micheline Ostermeyer,France,2,0,1,3,1948
Mal Whitfield,United States,2,0,1,3,1948
Gert Fredriksson,Sweden,2,0,0,2,1948
Jéhan de Buhan,France,2,0,0,2,1948
Aladár Gerevich,Hungary,2,0,0,2,1948
Heikki Savolainen,Finland,2,0,0,2,1948
Vicki Draves,United States,2,0,0,2,1948
Wally Ris,United States,2,0,0,2,1948
Bill Smith,United States,2,0,0,2,1948
Roy Cochran,United States,2,0,0,2,1948
Harrison Dillard,United States,2,0,0,2,1948
Mel Patton,United States,2,0,0,2,1948
Frank Henry,United States,1,2,0,3,1948
Michael Reusch,Switzerland,1,2,0,3,1948
Karen Margrethe Harup,Denmark,1,2,0,3,1948
Barney Ewell,United States,1,2,0,3,1948
Sepp Stalder,Switzerland,1,1,1,3,1948
Steve Lysak,United States,1,1,0,2,1948
Steve Macknowski,United States,1,1,0,2,1948
André Jousseaumé,France,1,1,0,2,1948
Earl Thomson,United States,1,1,0,2,1948
Rubén Uriza,Mexico,1,1,0,2,1948
Christian d'Oriola,France,1,1,0,2,1948
Gino Cantone,Italy,1,1,0,2,1948
Olavi Rove,Finland,1,1,0,2,1948
Karl Frei,Switzerland,1,1,0,2,1948
Greta Andersen,Denmark,1,1,0,2,1948
Bruce Harlan,United States,1,1,0,2,1948
Arthur Wint,Jamaica,1,1,0,2,1948
Emil Zátopek,Czech Republic,1,1,0,2,1948
Ferenc Pataki,Hungary,1,0,2,3,1948
José Beyaert,France,1,0,1,2,1948
Jacques Dupont,France,1,0,1,2,1948
Lode Wouters,Belgium,1,0,1,2,1948
Pál Kovács,Hungary,1,0,1,2,1948
Sammy Lee,United States,1,0,1,2,1948
Tibor Csík,Hungary,1,0,0,1,1948
László Papp,Hungary,1,0,0,1,1948
Ernesto Formenti,Italy,1,0,0,1,1948
Rafael Iglesias,Argentina,1,0,0,1,1948
Pascual Pérez,Argentina,1,0,0,1,1948
Cliff Barker,United States,1,0,0,1,1948
Don Barksdale,United States,1,0,0,1,1948
Ralph Beard,United States,1,0,0,1,1948
Lew Beck,United States,1,0,0,1,1948
Vince Boryla,United States,1,0,0,1,1948
Gordon Carpenter,United States,1,0,0,1,1948
Alex Groza,United States,1,0,0,1,1948
Wally Jones,United States,1,0,0,1,1948
Bob Kurland,United States,1,0,0,1,1948
Ray Lumpp,United States,1,0,0,1,1948
R. C. Pitts,United States,1,0,0,1,1948
Jesse Renick,United States,1,0,0,1,1948
Jack Robinson,United States,1,0,0,1,1948
Kenny Rollins,United States,1,0,0,1,1948
Gerald Dreyer,South Africa,1,0,0,1,1948
George Hunter,South Africa,1,0,0,1,1948
Július Torma,Czechoslovakia,1,0,0,1,1948
Karen Hoff,Denmark,1,0,0,1,1948
Hans Berglund,Sweden,1,0,0,1,1948
Lennart Klingström,Sweden,1,0,0,1,1948
Hans Wetterström,Sweden,1,0,0,1,1948
Gunnar Åkerlund,Sweden,1,0,0,1,1948
Jan Brzák-Felix,Czech Republic,1,0,0,1,1948
František Čapek,Czech Republic,1,0,0,1,1948
Josef Holeček,Czech Republic,1,0,0,1,1948
Bohumil Kudrna,Czech Republic,1,0,0,1,1948
Charles Anderson,United States,1,0,0,1,1948
Maurice Buret,France,1,0,0,1,1948
Bernard Chevallier,France,1,0,0,1,1948
Hans Moser,Switzerland,1,0,0,1,1948
Jean Saint-Fort Paillard,France,1,0,0,1,1948
Alberto Valdés Ramos,Mexico,1,0,0,1,1948
Pierre Adam,France,1,0,0,1,1948
Serge Blusson,France,1,0,0,1,1948
Charles Coste,France,1,0,0,1,1948
Fernand Decanali,France,1,0,0,1,1948
Leon De Lathouwer,Belgium,1,0,0,1,1948
Mario Ghella,Italy,1,0,0,1,1948
Liévin Lerno,Belgium,1,0,0,1,1948
Renato Perona,Italy,1,0,0,1,1948
Ferdinando Terruzzi,Italy,1,0,0,1,1948
Eugène Van Roosbroeck,Belgium,1,0,0,1,1948
Leslie Claudius,India,1,0,0,1,1948
Walter de Sousa,India,1,0,0,1,1948
Keshav Dutt,India,1,0,0,1,1948
Lawrie Fernandes,India,1,0,0,1,1948
Ranganathan Francis,India,1,0,0,1,1948
Gerry Glackan,India,1,0,0,1,1948
Pat Jansen,India,1,0,0,1,1948
Amir Kumar,India,1,0,0,1,1948
Kishan Lal,India,1,0,0,1,1948
Leo Pinto,India,1,0,0,1,1948
Jaswant Rajput,India,1,0,0,1,1948
Reginald Rodrigues,India,1,0,0,1,1948
G. Nandy Singh,India,1,0,0,1,1948
Kunwar Digvijay Singh,India,1,0,0,1,1948
Tarlochan Singh Bawa,India,1,0,0,1,1948
"Balbir Singh, Sr.",India,1,0,0,1,1948
Randhir Singh Gentle,India,1,0,0,1,1948
Maxie Vaz,India,1,0,0,1,1948
Akhtar Hussain,India,1,0,0,1,1948
Latif-ur Rehman,India,1,0,0,1,1948
Ilona Elek-Schacherer,Hungary,1,0,0,1,1948
Édouard Artigas,France,1,0,0,1,1948
André Bonin,France,1,0,0,1,1948
René Bougnol,France,1,0,0,1,1948
Marcel Desprets,France,1,0,0,1,1948
Henri Guérin,France,1,0,0,1,1948
Maurice Huet,France,1,0,0,1,1948
Jacques Lataste,France,1,0,0,1,1948
Henri Lepage,France,1,0,0,1,1948
Michel Pécheux,France,1,0,0,1,1948
Adrien Rommel,France,1,0,0,1,1948
Tibor Berczelly,Hungary,1,0,0,1,1948
Rudolf Kárpáti,Hungary,1,0,0,1,1948
Bertalan Papp,Hungary,1,0,0,1,1948
László Rajcsányi,Hungary,1,0,0,1,1948
Sune Andersson,Sweden,1,0,0,1,1948
Henry Carlsson,Sweden,1,0,0,1,1948
Gunnar Gren,Sweden,1,0,0,1,1948
Börje Leander,Sweden,1,0,0,1,1948
Nils Liedholm,Sweden,1,0,0,1,1948
Torsten Lindberg,Sweden,1,0,0,1,1948
Erik Nilsson,Sweden,1,0,0,1,1948
Bertil Nordahl,Sweden,1,0,0,1,1948
Gunnar Nordahl,Sweden,1,0,0,1,1948
Knut Nordahl,Sweden,1,0,0,1,1948
Kjell Rosén,Sweden,1,0,0,1,1948
Birger Rosengren,Sweden,1,0,0,1,1948
Zdeňka Honsová,Czech Republic,1,0,0,1,1948
Marie Kovářová,Czech Republic,1,0,0,1,1948
Miloslava Misáková,Czech Republic,1,0,0,1,1948
Milena Müllerová,Czech Republic,1,0,0,1,1948
Věra Růžičková,Czech Republic,1,0,0,1,1948
Olga Šilhánová,Czech Republic,1,0,0,1,1948
Božena Srncová,Czech Republic,1,0,0,1,1948
Zdena Veřmiřovská,Czech Republic,1,0,0,1,1948
Sulo Salmi,Finland,1,0,0,1,1948
Aleksanteri Saarvala,Finland,1,0,0,1,1948
Einari Teräsvirta,Finland,1,0,0,1,1948
Wille Grut,Sweden,1,0,0,1,1948
Merv Wood,Australia,1,0,0,1,1948
Carl-Ebbe Andersen,Denmark,1,0,0,1,1948
Tage Henriksen,Denmark,1,0,0,1,1948
Finn Pedersen,Denmark,1,0,0,1,1948
Dickie Burnell,Great Britain,1,0,0,1,1948
Bert Bushnell,Great Britain,1,0,0,1,1948
Ran Laurie,Great Britain,1,0,0,1,1948
Jack Wilson,Great Britain,1,0,0,1,1948
Franco Faggi,Italy,1,0,0,1,1948
Giovanni Invernizzi,Italy,1,0,0,1,1948
Giuseppe Moioli,Italy,1,0,0,1,1948
Elio Morille,Italy,1,0,0,1,1948
George Ahlgren,United States,1,0,0,1,1948
Dave Brown,United States,1,0,0,1,1948
Lloyd Butler,United States,1,0,0,1,1948
Gordy Giovanelli,United States,1,0,0,1,1948
Jim Hardy,United States,1,0,0,1,1948
Bob Martin,United States,1,0,0,1,1948
Allen Morgan,United States,1,0,0,1,1948
Ralph Purchase,United States,1,0,0,1,1948
Justus Smith,United States,1,0,0,1,1948
John Stack,United States,1,0,0,1,1948
Dave Turner,United States,1,0,0,1,1948
Ian Turner,United States,1,0,0,1,1948
Warren Westlund,United States,1,0,0,1,1948
Bob Will,United States,1,0,0,1,1948
Károly Takács,Hungary,1,0,0,1,1948
Edwin Vásquez,Peru,1,0,0,1,1948
Emil Grünig,Switzerland,1,0,0,1,1948
Art Cook,United States,1,0,0,1,1948
Nel van Vliet,Netherlands,1,0,0,1,1948
Marie Corridon,United States,1,0,0,1,1948
Brenda Helser,United States,1,0,0,1,1948
Thelma Kalama,United States,1,0,0,1,1948
Allen Stack,United States,1,0,0,1,1948
Joe Verdeur,United States,1,0,0,1,1948
Wally Wolf,United States,1,0,0,1,1948
Gildo Arena,Italy,1,0,0,1,1948
Emilio Bulgarelli,Italy,1,0,0,1,1948
Pasquale Buonocore,Italy,1,0,0,1,1948
Aldo Ghira,Italy,1,0,0,1,1948
Mario Majoni,Italy,1,0,0,1,1948
Geminio Ognio,Italy,1,0,0,1,1948
Gianfranco Pandolfini,Italy,1,0,0,1,1948
Tullio Pandolfini,Italy,1,0,0,1,1948
Cesare Rubini,Italy,1,0,0,1,1948
Mahmoud Fayad,Egypt,1,0,0,1,1948
Ibrahim Shams,Egypt,1,0,0,1,1948
John Davis,United States,1,0,0,1,1948
Joe DePietro,United States,1,0,0,1,1948
Frank Spellman,United States,1,0,0,1,1948
Stan Stanczyk,United States,1,0,0,1,1948
Lenni Viitala,Finland,1,0,0,1,1948
Gyula Bóbis,Hungary,1,0,0,1,1948
Pietro Lombardi,Italy,1,0,0,1,1948
Gösta Andersson,Sweden,1,0,0,1,1948
Gustav Freij,Sweden,1,0,0,1,1948
Axel Grönberg,Sweden,1,0,0,1,1948
Karl-Erik Nilsson,Sweden,1,0,0,1,1948
Kurt Pettersén,Sweden,1,0,0,1,1948
Nasuh Akar,Turkey,1,0,0,1,1948
Celal Atik,Turkey,1,0,0,1,1948
Gazanfer Bilge,Turkey,1,0,0,1,1948
Yaşar Doğu,Turkey,1,0,0,1,1948
Ahmet Kireççi,Turkey,1,0,0,1,1948
Mehmet Oktav,Turkey,1,0,0,1,1948
Glen Brand,United States,1,0,0,1,1948
Henry Wittenberg,United States,1,0,0,1,1948
Hakon Barfod,Norway,1,0,0,1,1948
David Bond,Great Britain,1,0,0,1,1948
Paul Elvstrøm,Denmark,1,0,0,1,1948
Sigve Lie,Norway,1,0,0,1,1948
Lee Loomis,United States,1,0,0,1,1948
Mike Mooney,United States,1,0,0,1,1948
Stewart Morris,Great Britain,1,0,0,1,1948
Hilary Smart,United States,1,0,0,1,1948
Paul Smart,United States,1,0,0,1,1948
James Smith,United States,1,0,0,1,1948
Thor Thorvaldsen,Norway,1,0,0,1,1948
Jim Weekes,United States,1,0,0,1,1948
Herman Whiton,United States,1,0,0,1,1948
Delfo Cabrera,Argentina,1,0,0,1,1948
Jack Winter,Australia,1,0,0,1,1948
Herma Bauma,Austria,1,0,0,1,1948
Gaston Reiff,Belgium,1,0,0,1,1948
Tapio Rautavaara,Finland,1,0,0,1,1948
Olga Gyarmati,Hungary,1,0,0,1,1948
Imre Németh,Hungary,1,0,0,1,1948
Adolfo Consolini,Italy,1,0,0,1,1948
Xenia Stad-de Jong,Netherlands,1,0,0,1,1948
Gerda van der Kade-Koudijs,Netherlands,1,0,0,1,1948
Nettie Witziers-Timmer,Netherlands,1,0,0,1,1948
Arne Åhman,Sweden,1,0,0,1,1948
Henry Eriksson,Sweden,1,0,0,1,1948
John Ljunggren,Sweden,1,0,0,1,1948
John Mikaelsson,Sweden,1,0,0,1,1948
Tore Sjöstrand,Sweden,1,0,0,1,1948
Alice Coachman,United States,1,0,0,1,1948
Cliff Bourland,United States,1,0,0,1,1948
Art Harnden,United States,1,0,0,1,1948
Bob Mathias,United States,1,0,0,1,1948
Bill Porter,United States,1,0,0,1,1948
Guinn Smith,United States,1,0,0,1,1948
Willie Steele,United States,1,0,0,1,1948
Wilbur Thompson,United States,1,0,0,1,1948
Lorenzo Wright,United States,1,0,0,1,1948
Kalevi Laitinen,Finland,1,0,0,1,1948
Adolf Hoch,Austria,1,0,0,1,1948
Yrjö Lindegren,Finland,1,0,0,1,1948
Aale Tynni,Finland,1,0,0,1,1948
Albert Decaris,France,1,0,0,1,1948
Alfred Thomson,Great Britain,1,0,0,1,1948
Giani Stùparich,Italy,1,0,0,1,1948
Zbigniew Turski,Poland,1,0,0,1,1948
Gustaf Nordahl,Sweden,1,0,0,1,1948
Walter Lehmann,Switzerland,0,3,0,3,1948
Edoardo Mangiarotti,Italy,0,2,1,3,1948
Reg Harris,Great Britain,0,2,0,2,1948
Renzo Nostini,Italy,0,2,0,2,1948
Vincenzo Pinton,Italy,0,2,0,2,1948
János Mogyorósi-Klencs,Hungary,0,1,2,3,1948
Shirley Strickland de la Hunty,Australia,0,1,2,3,1948
Robert Selfelt,Sweden,0,1,1,2,1948
Christian Kipfer,Switzerland,0,1,1,2,1948
John Marshall,Australia,0,1,1,2,1948
Géza Kádas,Hungary,0,1,1,2,1948
György Mitró,Hungary,0,1,1,2,1948
Patsy Elsener,United States,0,1,1,2,1948
Alex Walter Diggelmann,Switzerland,0,1,1,2,1948
Don Scott,Great Britain,0,1,0,1,1948
Johnny Wright,Great Britain,0,1,0,1,1948
Spartaco Bandinelli,Italy,0,1,0,1,1948
Gianni Zuddas,Italy,0,1,0,1,1948
André Barrais,France,0,1,0,1,1948
Michel Bonnevie,France,0,1,0,1,1948
André Buffière,France,0,1,0,1,1948
René Chocat,France,0,1,0,1,1948
René Dérency,France,0,1,0,1,1948
Maurice Desaymonet,France,0,1,0,1,1948
André Even,France,0,1,0,1,1948
Maurice Girardot,France,0,1,0,1,1948
Fernand Guillou,France,0,1,0,1,1948
Raymond Offner,France,0,1,0,1,1948
Jacques Perrier,France,0,1,0,1,1948
Yvan Quénin,France,0,1,0,1,1948
Lucien Rebuffic,France,0,1,0,1,1948
Pierre Thiolon,France,0,1,0,1,1948
Jos Vissers,Belgium,0,1,0,1,1948
Dennis Shepherd,South Africa,0,1,0,1,1948
Gunnar Nilsson,Sweden,0,1,0,1,1948
Hank Herring,United States,0,1,0,1,1948
Douglas Bennett,Canada,0,1,0,1,1948
Frederik Kobberup Andersen,Denmark,0,1,0,1,1948
Ejvind Hansen,Denmark,0,1,0,1,1948
Bernhard Jensen,Denmark,0,1,0,1,1948
Kurt Wires,Finland,0,1,0,1,1948
Lida van der Anker-Doedens,Netherlands,0,1,0,1,1948
Ivar Mathisen,Norway,0,1,0,1,1948
Knut Østby,Norway,0,1,0,1,1948
Václav Havel,Czech Republic,0,1,0,1,1948
Jiří Pecka,Czech Republic,0,1,0,1,1948
Frank Havens,United States,0,1,0,1,1948
Bob Borg,United States,0,1,0,1,1948
Jaime García,Spain,0,1,0,1,1948
Marcelino Gavilán,Spain,0,1,0,1,1948
José Navarro,Spain,0,1,0,1,1948
Olof Stahre,Sweden,0,1,0,1,1948
Sigurd Svensson,Sweden,0,1,0,1,1948
Rino Pucci,Italy,0,1,0,1,1948
Alan Bannister,Great Britain,0,1,0,1,1948
Arnaldo Benfenati,Italy,0,1,0,1,1948
Guido Bernardi,Italy,0,1,0,1,1948
Anselmo Citterio,Italy,0,1,0,1,1948
Ernie Clements,Great Britain,0,1,0,1,1948
Bob Maitland,Great Britain,0,1,0,1,1948
Pierre Nihant,Belgium,0,1,0,1,1948
Ian Scott,Great Britain,0,1,0,1,1948
Tiny Thomas,Great Britain,0,1,0,1,1948
Gerrit Voorting,Netherlands,0,1,0,1,1948
Bob Adlard,Great Britain,0,1,0,1,1948
Norman Borrett,Great Britain,0,1,0,1,1948
Dave Brodie,Great Britain,0,1,0,1,1948
Ronald Davies,Great Britain,0,1,0,1,1948
Bill Griffiths,Great Britain,0,1,0,1,1948
Robin Lindsay,Great Britain,0,1,0,1,1948
William Lindsay,Great Britain,0,1,0,1,1948
John Peake,Great Britain,0,1,0,1,1948
Frank Reynolds,Great Britain,0,1,0,1,1948
George Sime,Great Britain,0,1,0,1,1948
Micky Walford,Great Britain,0,1,0,1,1948
Neil White,Great Britain,0,1,0,1,1948
Karen Lachmann,Denmark,0,1,0,1,1948
Carlo Agostoni,Italy,0,1,0,1,1948
Gastone Darè,Italy,0,1,0,1,1948
Manlio Di Rosa,Italy,0,1,0,1,1948
Marco Antonio Mandruzzato,Italy,0,1,0,1,1948
Dario Mangiarotti,Italy,0,1,0,1,1948
Fiorenzo Marini,Italy,0,1,0,1,1948
Aldo Montano,Italy,0,1,0,1,1948
Giuliano Nostini,Italy,0,1,0,1,1948
Giorgio Pellini,Italy,0,1,0,1,1948
Mauro Racca,Italy,0,1,0,1,1948
Saverio Ragno,Italy,0,1,0,1,1948
Carlo Turcato,Italy,0,1,0,1,1948
Oswald Zappelli,Switzerland,0,1,0,1,1948
Aleksandar Atanacković,Serbia,0,1,0,1,1948
Stjepan Bobek,Croatia,0,1,0,1,1948
Miroslav Brozović,Yugoslavia,0,1,0,1,1948
Željko Čajkovski,Croatia,0,1,0,1,1948
Zlatko Čajkovski,Croatia,0,1,0,1,1948
Zvonko Cimermančić,Croatia,0,1,0,1,1948
Miodrag Jovanović,Serbia,0,1,0,1,1948
Ljubomir Lovrić,Serbia,0,1,0,1,1948
Prvoslav Mihajlović,Serbia,0,1,0,1,1948
Rajko Mitić,Serbia,0,1,0,1,1948
Franjo Šoštarić,Croatia,0,1,0,1,1948
Branko Stanković,Serbia,0,1,0,1,1948
Kosta Tomašević,Serbia,0,1,0,1,1948
Bernard Vukas,Croatia,0,1,0,1,1948
Franjo Velfl,Croatia,0,1,0,1,1948
Erzsébet Balázs,Hungary,0,1,0,1,1948
Anna Fehér,Hungary,0,1,0,1,1948
Erzsébet Gulyás-Köteles,Hungary,0,1,0,1,1948
Irén Karcsics-Daruházi,Hungary,0,1,0,1,1948
Mária Kövi-Zalai,Hungary,0,1,0,1,1948
Margit Nagy-Sándor,Hungary,0,1,0,1,1948
Olga Tass-Lemhényi,Hungary,0,1,0,1,1948
Edit Weckinger-Perényi,Hungary,0,1,0,1,1948
Robert Lucy,Switzerland,0,1,0,1,1948
Emil Studer,Switzerland,0,1,0,1,1948
Melchior Thalmann,Switzerland,0,1,0,1,1948
George Moore,United States,0,1,0,1,1948
Aksel Bonde,Denmark,0,1,0,1,1948
Helge Halkjær,Denmark,0,1,0,1,1948
Aage Larsen,Denmark,0,1,0,1,1948
Ib Storm Larsen,Denmark,0,1,0,1,1948
Ebbe Parsner,Denmark,0,1,0,1,1948
Helge Muxoll Schröder,Denmark,0,1,0,1,1948
Chris Barton,Great Britain,0,1,0,1,1948
Paul Bircher,Great Britain,0,1,0,1,1948
Jack Dearlove,Great Britain,0,1,0,1,1948
Michael Lapage,Great Britain,0,1,0,1,1948
Brian Lloyd,Great Britain,0,1,0,1,1948
Paul Massey,Great Britain,0,1,0,1,1948
Paul Mellows,Great Britain,0,1,0,1,1948
John Meyrick,Great Britain,0,1,0,1,1948
Guy Richardson,Great Britain,0,1,0,1,1948
Alberto Radi,Italy,0,1,0,1,1948
Giovanni Steffè,Italy,0,1,0,1,1948
Aldo Tarlao,Italy,0,1,0,1,1948
Hans Kalt,Switzerland,0,1,0,1,1948
Josef Kalt,Switzerland,0,1,0,1,1948
Emil Knecht,Switzerland,0,1,0,1,1948
André Moccand,Switzerland,0,1,0,1,1948
Rudolf Reichling,Switzerland,0,1,0,1,1948
Erich Schriever,Switzerland,0,1,0,1,1948
Peter Stebler,Switzerland,0,1,0,1,1948
Eduardo Risso,Uruguay,0,1,0,1,1948
Carlos Enrique Díaz Sáenz Valiente,Argentina,0,1,0,1,1948
Pauli Janhonen,Finland,0,1,0,1,1948
Rudolf Schnyder,Switzerland,0,1,0,1,1948
Walter Tomsen,United States,0,1,0,1,1948
Nancy Lyons,Australia,0,1,0,1,1948
Eva Arndt-Riise,Denmark,0,1,0,1,1948
Fritze Carstensen,Denmark,0,1,0,1,1948
Imre Nyéki,Hungary,0,1,0,1,1948
Elemér Szathmáry,Hungary,0,1,0,1,1948
Zoe Ann Olsen-Jensen,United States,0,1,0,1,1948
Suzanne Zimmerman,United States,0,1,0,1,1948
Miller Anderson,United States,0,1,0,1,1948
Keith Carter,United States,0,1,0,1,1948
Bob Cowell,United States,0,1,0,1,1948
Alan Ford,United States,0,1,0,1,1948
Jenő Brandi,Hungary,0,1,0,1,1948
Oszkár Csuvik,Hungary,0,1,0,1,1948
Dezső Fábián,Hungary,0,1,0,1,1948
Dezső Gyarmati,Hungary,0,1,0,1,1948
Endre Győrfi,Hungary,0,1,0,1,1948
Miklós Holop,Hungary,0,1,0,1,1948
László Jeney,Hungary,0,1,0,1,1948
Dezső Lemhényi,Hungary,0,1,0,1,1948
Károly Szittya,Hungary,0,1,0,1,1948
"István Szívós, Sr.",Hungary,0,1,0,1,1948
Attia Mohammed,Egypt,0,1,0,1,1948
Julian Creus,Great Britain,0,1,0,1,1948
Rodney Wilkes,Trinidad and Tobago,0,1,0,1,1948
Pete George,United States,0,1,0,1,1948
Harold Sakata,United States,0,1,0,1,1948
Norb Schemansky,United States,0,1,0,1,1948
Dick Garrard,Australia,0,1,0,1,1948
Mahmoud Hassan,Egypt,0,1,0,1,1948
Kelpo Gröndahl,Finland,0,1,0,1,1948
Miklós Szilvásy,Hungary,0,1,0,1,1948
Aage Eriksen,Norway,0,1,0,1,1948
Fritz Stöckli,Switzerland,0,1,0,1,1948
Olle Anderberg,Sweden,0,1,0,1,1948
Bertil Antonsson,Sweden,0,1,0,1,1948
Gösta Jönsson-Frändfors,Sweden,0,1,0,1,1948
Tor Nilsson,Sweden,0,1,0,1,1948
Ivar Sjölin,Sweden,0,1,0,1,1948
Halit Balamir,Turkey,0,1,0,1,1948
Adil Candemir,Turkey,0,1,0,1,1948
Kenan Olcay,Turkey,0,1,0,1,1948
Muhlis Tayfur,Turkey,0,1,0,1,1948
Gerry Leeman,United States,0,1,0,1,1948
Duarte Manuel Bello,Portugal,0,1,0,1,1948
Fernando Bello,Portugal,0,1,0,1,1948
Folke Bohlin,Sweden,0,1,0,1,1948
Gösta Brodin,Sweden,0,1,0,1,1948
Carlos de Cárdenas Culmell,Cuba,0,1,0,1,1948
Carlos de Cárdenas Plá,Cuba,0,1,0,1,1948
Ralph Evans,United States,0,1,0,1,1948
Emilio Homps,Argentina,0,1,0,1,1948
Hugo Johnson,Sweden,0,1,0,1,1948
Rodolfo Rivademar,Argentina,0,1,0,1,1948
Rufino Rodríguez de la Torre,Argentina,0,1,0,1,1948
Julio Sieburger,Argentina,0,1,0,1,1948
Enrique Sieburger Hadler,Argentina,0,1,0,1,1948
Noemí Simonetto de Portela,Argentina,0,1,0,1,1948
Joyce King,Australia,0,1,0,1,1948
June Maston,Australia,0,1,0,1,1948
Betty McKinnon,Australia,0,1,0,1,1948
George Avery,Australia,0,1,0,1,1948
Bill Bruce,Australia,0,1,0,1,1948
Kaisa Parviainen,Finland,0,1,0,1,1948
Erkki Kataja,Finland,0,1,0,1,1948
Robert Chef d'Hôtel,France,0,1,0,1,1948
Ignace Heinrich,France,0,1,0,1,1948
Jean Kérébel,France,0,1,0,1,1948
Jacques Lunis,France,0,1,0,1,1948
Alain Mimoun,Algeria,0,1,0,1,1948
Francis Schewetta,France,0,1,0,1,1948
Maureen Gardner,Great Britain,0,1,0,1,1948
Dorothy Manley,Great Britain,0,1,0,1,1948
Dorothy Odam-Tyler,Great Britain,0,1,0,1,1948
Audrey Williamson,Great Britain,0,1,0,1,1948
Jack Archer,Great Britain,0,1,0,1,1948
Jack Gregory,Great Britain,0,1,0,1,1948
Ken Jones,Great Britain,0,1,0,1,1948
Alastair McCorquodale,Great Britain,0,1,0,1,1948
Tom Richards,Great Britain,0,1,0,1,1948
Edera Cordiale-Gentile,Italy,0,1,0,1,1948
Amelia Piccinini,Italy,0,1,0,1,1948
Giuseppe Tosi,Italy,0,1,0,1,1948
Herb McKenley,Jamaica,0,1,0,1,1948
Bjørn Paulson,Norway,0,1,0,1,1948
Duncan White,Sri Lanka,0,1,0,1,1948
Gaston Godel,Switzerland,0,1,0,1,1948
Ingemar Johansson,Sweden,0,1,0,1,1948
Lennart Strand,Sweden,0,1,0,1,1948
Jim Delaney,United States,0,1,0,1,1948
Clyde Scott,United States,0,1,0,1,1948
Steve Seymour,United States,0,1,0,1,1948
Ivan Gubijan,Croatia,0,1,0,1,1948
Erik Elmsäter,Sweden,0,1,0,1,1948
Pál Pók,Hungary,0,1,0,1,1948
Alfred Rinesch,Austria,0,1,0,1,1948
Oskar Thiede,Austria,0,1,0,1,1948
John Weinzweig,Canada,0,1,0,1,1948
Josef Petersen,Denmark,0,1,0,1,1948
Kalervo Tuukkanen,Finland,0,1,0,1,1948
John Copley,Great Britain,0,1,0,1,1948
Chintamoni Kar,Great Britain,0,1,0,1,1948
Giovanni Stradone,Italy,0,1,0,1,1948
Ernst Van Heerden,South Africa,0,1,0,1,1948
Edy Knupfer,Switzerland,0,1,0,1,1948
Werner Schindler,Switzerland,0,1,0,1,1948
Ture Axelsson,Finland,0,0,2,2,1948
Nils Björklöf,Finland,0,0,2,2,1948
Georges Dransart,France,0,0,2,2,1948
Georges Gandil,France,0,0,2,2,1948
Tommy Godwin,Great Britain,0,0,2,2,1948
Zdeněk Růžička,Czech Republic,0,0,2,2,1948
Marie-Louise Linssen-Vaessen,Netherlands,0,0,2,2,1948
Wim Slijkhuis,Netherlands,0,0,2,2,1948
Lloyd LaBeach,Panama,0,0,2,2,1948
Rune Larsson,Sweden,0,0,2,2,1948
Svend Vad,Denmark,0,0,1,1,1948
Mauro Cía,Argentina,0,0,1,1,1948
Alessandro D'Ottavio,Italy,0,0,1,1,1948
Ivano Fontana,Italy,0,0,1,1,1948
Han Su-An,Republic of Korea,0,0,1,1,1948
Afonso Évora,Brazil,0,0,1,1,1948
Bráz,Brazil,0,0,1,1,1948
Algodão,Brazil,0,0,1,1,1948
Ruy de Freitas,Brazil,0,0,1,1,1948
Marcus Vinícius Dias,Brazil,0,0,1,1,1948
Alexandre Gemignani,Brazil,0,0,1,1,1948
Alberto Marson,Brazil,0,0,1,1,1948
Nilton Pacheco,Brazil,0,0,1,1,1948
Alfredo da Motta,Brazil,0,0,1,1,1948
Massinet Sorcinelli,Brazil,0,0,1,1,1948
Aleksy Antkiewicz,Poland,0,0,1,1,1948
Juan Venegas,Puerto Rico,0,0,1,1,1948
Johnny Arthur,South Africa,0,0,1,1,1948
Fritzi Schwingl,Austria,0,0,1,1,1948
Norm Lane,Canada,0,0,1,1,1948
Robert Boutigny,France,0,0,1,1,1948
Henri Eberhardt,France,0,0,1,1,1948
Eivind Skabo,Norway,0,0,1,1,1948
"Gustaf Adolf Boltenstern, Jr.",Sweden,0,0,1,1,1948
Raúl Campero,Mexico,0,0,1,1,1948
Arthur Carr,Great Britain,0,0,1,1,1948
"Jean, Marquis d'Orgeix",France,0,0,1,1,1948
Harry Llewellyn,Great Britain,0,0,1,1,1948
Luís Silva,Portugal,0,0,1,1,1948
Harry Nicoll,Great Britain,0,0,1,1,1948
Fernando Paes,Portugal,0,0,1,1,1948
Joaquín Solano,Mexico,0,0,1,1,1948
Francisco Valadas Júnior,Portugal,0,0,1,1,1948
Gaston Dron,France,0,0,1,1,1948
René Faye,France,0,0,1,1,1948
Alan Geldard,Great Britain,0,0,1,1,1948
Alain Moineau,France,0,0,1,1,1948
Dave Ricketts,Great Britain,0,0,1,1,1948
René Rouffeteau,France,0,0,1,1,1948
Axel Schandorff,Denmark,0,0,1,1,1948
Wilf Waters,Great Britain,0,0,1,1,1948
André Boerstra,Netherlands,0,0,1,1,1948
Henk Bouwman,Netherlands,0,0,1,1,1948
Piet Bromberg,Netherlands,0,0,1,1,1948
Harry Derckx,Netherlands,0,0,1,1,1948
Han Drijver,Netherlands,0,0,1,1,1948
Dick Esser,Netherlands,0,0,1,1,1948
Roepie Kruize,Netherlands,0,0,1,1,1948
Jenne Langhout,Netherlands,0,0,1,1,1948
Dick Loggere,Netherlands,0,0,1,1,1948
Ton Richter,Netherlands,0,0,1,1,1948
Eddy Tiel,Netherlands,0,0,1,1,1948
Wim van Heel,Netherlands,0,0,1,1,1948
Ellen Müller-Preis,Austria,0,0,1,1,1948
Raymond Bru,Belgium,0,0,1,1,1948
Georges de Bourguignon,Belgium,0,0,1,1,1948
Henri Paternóster,Belgium,0,0,1,1,1948
Paul Valcke,Belgium,0,0,1,1,1948
André Van De Werve De Vorsselaer,Belgium,0,0,1,1,1948
Édouard Yves,Belgium,0,0,1,1,1948
Lajos Maszlay,Hungary,0,0,1,1,1948
Per Carleson,Sweden,0,0,1,1,1948
Frank Cervell,Sweden,0,0,1,1,1948
Carl Forssell,Sweden,0,0,1,1,1948
Bengt Ljungquist,Sweden,0,0,1,1,1948
Sven Thofelt,Sweden,0,0,1,1,1948
Arne Tollbom,Sweden,0,0,1,1,1948
Dean Cetrulo,United States,0,0,1,1,1948
Norman Cohn-Armitage,United States,0,0,1,1,1948
Miguel de Capriles,United States,0,0,1,1,1948
James Flynn,United States,0,0,1,1,1948
Tibor Nyilas,United States,0,0,1,1,1948
George Worth,United States,0,0,1,1,1948
John Hansen,Denmark,0,0,1,1,1948
Karl Aage Hansen,Denmark,0,0,1,1,1948
Viggo Jensen,Denmark,0,0,1,1,1948
Ivan Jensen,Denmark,0,0,1,1,1948
Knud Lundberg,Denmark,0,0,1,1,1948
Eigil Nielsen,Denmark,0,0,1,1,1948
Knud Børge Overgaard,Denmark,0,0,1,1,1948
Axel Pilmark,Denmark,0,0,1,1,1948
Johannes Pløger,Denmark,0,0,1,1,1948
Carl Aage Præst,Denmark,0,0,1,1,1948
Holger Seebach,Denmark,0,0,1,1,1948
Jørgen Leschly Sørensen,Denmark,0,0,1,1,1948
Dion Ørnvold,Denmark,0,0,1,1,1948
Laddie Bakanic,United States,0,0,1,1,1948
Marian Barone,United States,0,0,1,1,1948
Connie Caruccio-Lenz,United States,0,0,1,1,1948
Dorothy Dalton,United States,0,0,1,1,1948
Meta Elste,United States,0,0,1,1,1948
Helen Schifano,United States,0,0,1,1,1948
Clara Schroth-Lomady,United States,0,0,1,1,1948
Anita Simonis,United States,0,0,1,1,1948
László Baranyai,Hungary,0,0,1,1,1948
József Fekete,Hungary,0,0,1,1,1948
Győző Mogyorossy,Hungary,0,0,1,1,1948
Lajos Sántha,Hungary,0,0,1,1,1948
Lajos Tóth,Hungary,0,0,1,1,1948
Ferenc Várkői,Hungary,0,0,1,1,1948
Leo Sotorník,Czech Republic,0,0,1,1,1948
Gösta Gärdin,Sweden,0,0,1,1,1948
Harry Knudsen,Denmark,0,0,1,1,1948
Erik Larsen,Denmark,0,0,1,1,1948
Henry Larsen,Denmark,0,0,1,1,1948
Børge Raahauge Nielsen,Denmark,0,0,1,1,1948
Ib Olsen,Denmark,0,0,1,1,1948
Antal Szendey,Hungary,0,0,1,1,1948
"Béla Zsitnik, Sr.",Hungary,0,0,1,1,1948
Bruno Boni,Italy,0,0,1,1,1948
Felice Fanetti,Italy,0,0,1,1,1948
Halfdan Gran-Olsen,Norway,0,0,1,1,1948
Hans Egill Hansen,Norway,0,0,1,1,1948
Harald Kråkenes,Norway,0,0,1,1,1948
Torstein Kråkenes,Norway,0,0,1,1,1948
Kristoffer Lepsøe,Norway,0,0,1,1,1948
Carl Monssen,Norway,0,0,1,1,1948
Sigurd Monssen,Norway,0,0,1,1,1948
Leif Næss,Norway,0,0,1,1,1948
Thor Pedersen,Norway,0,0,1,1,1948
William Jones,Uruguay,0,0,1,1,1948
Juan Rodríguez,Uruguay,0,0,1,1,1948
Greg Gates,United States,0,0,1,1,1948
Stu Griffing,United States,0,0,1,1,1948
Fred Kingsbury,United States,0,0,1,1,1948
Bob Perew,United States,0,0,1,1,1948
Róbert Zimonyi,Hungary,0,0,1,1,1948
Willy Røgeberg,Norway,0,0,1,1,1948
Jonas Jonsson,Sweden,0,0,1,1,1948
Sven Lundquist,Sweden,0,0,1,1,1948
Torsten Ullman,Sweden,0,0,1,1,1948
Judy-Joy Davies,Australia,0,0,1,1,1948
Éva Gérard-Novák,Belgium,0,0,1,1,1948
Ilmari Niemeläinen,Finland,0,0,1,1,1948
Jo Bernardo,France,0,0,1,1,1948
René Cornu,France,0,0,1,1,1948
Alex Jany,France,0,0,1,1,1948
"Henri Padou, Jr.",France,0,0,1,1,1948
"Georges Vallerey, Jr.",France,0,0,1,1,1948
Cathie Gibson,Great Britain,0,0,1,1,1948
Joaquín Capilla,Mexico,0,0,1,1,1948
Irma Heijting-Schuhmacher,Netherlands,0,0,1,1,1948
Margot Marsman,Netherlands,0,0,1,1,1948
Hannie Termeulen,Netherlands,0,0,1,1,1948
Birte Christoffersen-Hanson,Denmark,0,0,1,1,1948
Bob Sohl,United States,0,0,1,1,1948
Cor Braasem,Netherlands,0,0,1,1,1948
Hennie Keetelaar,Netherlands,0,0,1,1,1948
Nijs Korevaar,Netherlands,0,0,1,1,1948
Joop Rohner,Netherlands,0,0,1,1,1948
Albert Ruimschotel,Netherlands,0,0,1,1,1948
Piet Salomons,Netherlands,0,0,1,1,1948
Frits Smol,Netherlands,0,0,1,1,1948
Hans Stam,Netherlands,0,0,1,1,1948
Ruud van Feggelen,Netherlands,0,0,1,1,1948
Jim Halliday,Great Britain,0,0,1,1,1948
Jafar Salmasi,Islamic Republic of Iran,0,0,1,1,1948
Kim Seong-Jip,Republic of Korea,0,0,1,1,1948
Bram Charité,Netherlands,0,0,1,1,1948
Gösta Magnusson,Sweden,0,0,1,1,1948
Rich Tom,United States,0,0,1,1,1948
Jim Armstrong,Australia,0,0,1,1,1948
Henrik Hansen,Denmark,0,0,1,1,1948
Ibrahim Orabi,Egypt,0,0,1,1,1948
Reino Kangasmäki,Finland,0,0,1,1,1948
Charles Kouyos,France,0,0,1,1,1948
Károly Ferencz,Hungary,0,0,1,1,1948
Ferenc Tóth,Hungary,0,0,1,1,1948
Guido Fantoni,Italy,0,0,1,1,1948
Ercole Gallegati,Italy,0,0,1,1,1948
Hermann Baumann,Switzerland,0,0,1,1,1948
Adolf Müller,Switzerland,0,0,1,1,1948
Bengt Fahlkvist,Sweden,0,0,1,1,1948
Thure Johansson,Sweden,0,0,1,1,1948
Erik Lindén,Sweden,0,0,1,1,1948
Halil Kaya,Turkey,0,0,1,1,1948
Lee Merrill,United States,0,0,1,1,1948
Karl-Robert Ameln,Sweden,0,0,1,1,1948
Klaus Baess,Denmark,0,0,1,1,1948
Ole Berntsen,Denmark,0,0,1,1,1948
William Berntsen,Denmark,0,0,1,1,1948
Koos de Jong,Netherlands,0,0,1,1,1948
Martin Hindorff,Sweden,0,0,1,1,1948
Tore Holm,Sweden,0,0,1,1,1948
Torsten Lord,Sweden,0,0,1,1,1948
Bob Maas,Netherlands,0,0,1,1,1948
Woody Pirie,United States,0,0,1,1,1948
Gösta Salén,Sweden,0,0,1,1,1948
Eddy Stutterheim,Netherlands,0,0,1,1,1948
Owen Torrey,United States,0,0,1,1,1948
Ine Schäffer,Austria,0,0,1,1,1948
Étienne Gailly,Belgium,0,0,1,1,1948
Diane Foster,Canada,0,0,1,1,1948
Pat Jones,Canada,0,0,1,1,1948
Nancy Mackay,Canada,0,0,1,1,1948
Viola Myers,Canada,0,0,1,1,1948
Lily Carlstedt-Kelsby,Denmark,0,0,1,1,1948
Jacqueline Mazéas,France,0,0,1,1,1948
Marcel Hansenne,France,0,0,1,1,1948
Lloyd Johnson,Great Britain,0,0,1,1,1948
József Várszegi,Hungary,0,0,1,1,1948
Carlo Monti,Italy,0,0,1,1,1948
Enrico Perucconi,Italy,0,0,1,1,1948
Antonio Siddi,Italy,0,0,1,1,1948
Michele Tito,Italy,0,0,1,1,1948
Fritz Schwab,Switzerland,0,0,1,1,1948
Ann-Britt Leyman,Sweden,0,0,1,1,1948
Bertil Albertsson,Sweden,0,0,1,1,1948
Folke Alnevik,Sweden,0,0,1,1,1948
Göte Hagström,Sweden,0,0,1,1,1948
Kurt Lundquist,Sweden,0,0,1,1,1948
Lars-Erik Wolfbrandt,Sweden,0,0,1,1,1948
Ruhi Sarıalp,Turkey,0,0,1,1,1948
Mickey Patterson,United States,0,0,1,1,1948
Bob Bennett,United States,0,0,1,1,1948
Craig Dixon,United States,0,0,1,1,1948
Herb Douglas,United States,0,0,1,1,1948
Jim Fuchs,United States,0,0,1,1,1948
Fortune Gordien,United States,0,0,1,1,1948
Bob Richards,United States,0,0,1,1,1948
Floyd Simmons,United States,0,0,1,1,1948
George Stanich,United States,0,0,1,1,1948
Romolo Catasta,Italy,0,0,1,1,1948
Edwin Grienauer,Austria,0,0,1,1,1948
Erling Brene,Denmark,0,0,1,1,1948
Gilbert Prouteau,France,0,0,1,1,1948
Hubert Yencesse,France,0,0,1,1,1948
Rosamund Fletcher,Great Britain,0,0,1,1,1948
Éva Földes,Hungary,0,0,1,1,1948
Letitia Hamilton,Ireland,0,0,1,1,1948
Gabriele Bianchi,Italy,0,0,1,1,1948
Sergio Lauricella,Italy,0,0,1,1,1948
Walter Battiss,South Africa,0,0,1,1,1948
Nils Olsson,Sweden,0,0,1,1,1948
Viktor Chukarin,Soviet Union,4,2,0,6,1952
Emil Zátopek,Czech Republic,3,0,0,3,1952
Mariya Gorokhovskaya,Soviet Union,2,5,0,7,1952
Edoardo Mangiarotti,Italy,2,2,0,4,1952
Nina Bocharova,Soviet Union,2,2,0,4,1952
Hrant Shahinyan,Armenia,2,2,0,4,1952
Yekaterina Kalinchuk,Russian Federation,2,1,0,3,1952
Ford Konno,United States,2,1,0,3,1952
Yrjö Hietanen,Finland,2,0,0,2,1952
Kurt Wires,Finland,2,0,0,2,1952
Henri Saint Cyr,Sweden,2,0,0,2,1952
"Hans von Blixen-Finecke, Jr.",Sweden,2,0,0,2,1952
Russell Mockridge,Australia,2,0,0,2,1952
André Noyelle,Belgium,2,0,0,2,1952
Christian d'Oriola,France,2,0,0,2,1952
Pál Kovács,Hungary,2,0,0,2,1952
Katalin Szőke,Hungary,2,0,0,2,1952
Pat McCormick,United States,2,0,0,2,1952
Marjorie Jackson,Australia,2,0,0,2,1952
George Rhoden,Jamaica,2,0,0,2,1952
Harrison Dillard,United States,2,0,0,2,1952
Lindy Remigino,United States,2,0,0,2,1952
Andy Stanfield,United States,2,0,0,2,1952
Éva Gérard-Novák,Belgium,1,2,0,3,1952
Herb McKenley,Jamaica,1,2,0,3,1952
Margit Korondi,Hungary,1,1,4,6,1952
Ágnes Keleti,Hungary,1,1,2,4,1952
Aladár Gerevich,Hungary,1,1,1,3,1952
Galina Minaicheva,Russian Federation,1,1,1,3,1952
Hans Eugster,Switzerland,1,1,1,3,1952
Thorvald Strömberg,Finland,1,1,0,2,1952
Gert Fredriksson,Sweden,1,1,0,2,1952
Lionel Cox,Australia,1,1,0,2,1952
Robert Grondelaers,Belgium,1,1,0,2,1952
Marino Morettini,Italy,1,1,0,2,1952
Dario Mangiarotti,Italy,1,1,0,2,1952
Pelageya Danilova,Russian Federation,1,1,0,2,1952
Medeya Jugeli,Georgia,1,1,0,2,1952
Galina Shamray,Soviet Union,1,1,0,2,1952
Galina Urbanovich,Russian Federation,1,1,0,2,1952
Jack Günthard,Switzerland,1,1,0,2,1952
Yevgeny Korolkov,Russian Federation,1,1,0,2,1952
Gábor Benedek,Hungary,1,1,0,2,1952
Lars Hall,Sweden,1,1,0,2,1952
Arthur Wint,Jamaica,1,1,0,2,1952
Charlie Moore,United States,1,1,0,2,1952
Mal Whitfield,United States,1,1,0,2,1952
Tibor Berczelly,Hungary,1,0,2,3,1952
Dmitry Leonkin,Soviet Union,1,0,1,2,1952
István Szondy,Hungary,1,0,1,2,1952
Jean Boiteux,France,1,0,1,2,1952
Judit Temes,Hungary,1,0,1,2,1952
Shirley Strickland de la Hunty,Australia,1,0,1,2,1952
Pentti Hämäläinen,Finland,1,0,0,1,1952
László Papp,Hungary,1,0,0,1,1952
Aureliano Bolognesi,Italy,1,0,0,1,1952
Ron Bontemps,United States,1,0,0,1,1952
Marc Freiberger,United States,1,0,0,1,1952
Wayne Glasgow,United States,1,0,0,1,1952
Charlie Hoag,United States,1,0,0,1,1952
Bill Hougland,United States,1,0,0,1,1952
John Keller,United States,1,0,0,1,1952
Dean Kelley,United States,1,0,0,1,1952
Bob Kenney,United States,1,0,0,1,1952
Bob Kurland,United States,1,0,0,1,1952
Bill Lienhard,United States,1,0,0,1,1952
Clyde Lovellette,United States,1,0,0,1,1952
Frank McCabe,United States,1,0,0,1,1952
Dan Pippin,United States,1,0,0,1,1952
Howie Williams,United States,1,0,0,1,1952
Zygmunt Chychła,Poland,1,0,0,1,1952
Ján Zachara,Czechoslovakia,1,0,0,1,1952
Chuck Adkins,United States,1,0,0,1,1952
Nate Brooks,United States,1,0,0,1,1952
Norvel Lee,United States,1,0,0,1,1952
Floyd Patterson,United States,1,0,0,1,1952
Ed Sanders,United States,1,0,0,1,1952
Finn Haunstoft,Denmark,1,0,0,1,1952
Peder Rasch,Denmark,1,0,0,1,1952
Sylvi Saimo,Finland,1,0,0,1,1952
Jean Laudet,France,1,0,0,1,1952
Georges Turlier,France,1,0,0,1,1952
Josef Holeček,Czech Republic,1,0,0,1,1952
Frank Havens,United States,1,0,0,1,1952
"Gustaf Adolf Boltenstern, Jr.",Sweden,1,0,0,1,1952
Folke Frölén,Sweden,1,0,0,1,1952
Pierre Jonquères d'Oriola,France,1,0,0,1,1952
Harry Llewellyn,Great Britain,1,0,0,1,1952
Gehnäll Persson,Sweden,1,0,0,1,1952
Olof Stahre,Sweden,1,0,0,1,1952
Duggie Stewart,Great Britain,1,0,0,1,1952
Wilf White,Great Britain,1,0,0,1,1952
Loris Campana,Italy,1,0,0,1,1952
Mino De Rossi,Italy,1,0,0,1,1952
Guido Messina,Italy,1,0,0,1,1952
Enzo Sacchi,Italy,1,0,0,1,1952
Rik Van Looy,Belgium,1,0,0,1,1952
Lucien Victor,Belgium,1,0,0,1,1952
Leslie Claudius,India,1,0,0,1,1952
Meldric daLuz,India,1,0,0,1,1952
Chinadorai Deshmutu,India,1,0,0,1,1952
Keshav Dutt,India,1,0,0,1,1952
Ranganathan Francis,India,1,0,0,1,1952
Raghbir Lal,India,1,0,0,1,1952
Govind Perumal,India,1,0,0,1,1952
Muniswamy Rajagopal,India,1,0,0,1,1952
Dharam Singh Gill,India,1,0,0,1,1952
G. Nandy Singh,India,1,0,0,1,1952
Kunwar Digvijay Singh,India,1,0,0,1,1952
"Balbir Singh, Sr.",India,1,0,0,1,1952
Randhir Singh Gentle,India,1,0,0,1,1952
Udham Singh,India,1,0,0,1,1952
Irene Camber-Corno,Italy,1,0,0,1,1952
Jéhan de Buhan,France,1,0,0,1,1952
Jacques Lataste,France,1,0,0,1,1952
Claude Netter,France,1,0,0,1,1952
Jacques Noël,France,1,0,0,1,1952
Adrien Rommel,France,1,0,0,1,1952
Rudolf Kárpáti,Hungary,1,0,0,1,1952
Bertalan Papp,Hungary,1,0,0,1,1952
László Rajcsányi,Hungary,1,0,0,1,1952
Roberto Battaglia,Italy,1,0,0,1,1952
Franco Bertinetti,Italy,1,0,0,1,1952
Giuseppe Delfino,Italy,1,0,0,1,1952
Carlo Pavesi,Italy,1,0,0,1,1952
József Bozsik,Hungary,1,0,0,1,1952
László Budai,Hungary,1,0,0,1,1952
Jenő Buzánszky,Hungary,1,0,0,1,1952
Lajos Csordás,Hungary,1,0,0,1,1952
Zoltán Czibor,Hungary,1,0,0,1,1952
Jenő Dalnoki,Hungary,1,0,0,1,1952
Gyula Grosics,Hungary,1,0,0,1,1952
Nándor Hidegkuti,Hungary,1,0,0,1,1952
Sándor Kocsis,Hungary,1,0,0,1,1952
Imre Kovács,Hungary,1,0,0,1,1952
Mihály Lantos,Hungary,1,0,0,1,1952
Gyula Lóránt,Hungary,1,0,0,1,1952
Péter Palotás,Hungary,1,0,0,1,1952
Ferenc Puskás,Hungary,1,0,0,1,1952
József Zakariás,Hungary,1,0,0,1,1952
Evy Berggren,Sweden,1,0,0,1,1952
Vanja Blomberg,Sweden,1,0,0,1,1952
Ann-Sofi Pettersson-Colling,Sweden,1,0,0,1,1952
Karin Lindberg,Sweden,1,0,0,1,1952
Hjördis Nordin,Sweden,1,0,0,1,1952
Göta Pettersson,Sweden,1,0,0,1,1952
Gun Röring,Sweden,1,0,0,1,1952
Ingrid Sandahl,Sweden,1,0,0,1,1952
William Thoresson,Sweden,1,0,0,1,1952
Vladimir Belyakov,Russian Federation,1,0,0,1,1952
Iosif Berdiyev,Russian Federation,1,0,0,1,1952
Valentin Muratov,Russian Federation,1,0,0,1,1952
Mikhail Perlman,Russian Federation,1,0,0,1,1952
Aladár Kovácsi,Hungary,1,0,0,1,1952
Tranquilo Capozzo,Argentina,1,0,0,1,1952
Eduardo Guerrero,Argentina,1,0,0,1,1952
Bernard Malivoir,France,1,0,0,1,1952
Gaston Mercier,France,1,0,0,1,1952
Raymond Salles,France,1,0,0,1,1952
Jiří Havlis,Czech Republic,1,0,0,1,1952
Jan Jindra,Czech Republic,1,0,0,1,1952
Miroslav Koranda,Czech Republic,1,0,0,1,1952
Stanislav Lusk,Czech Republic,1,0,0,1,1952
"Karel Mejta, Sr.",Czech Republic,1,0,0,1,1952
Yury Tyukalov,Russian Federation,1,0,0,1,1952
Bob Detweiler,United States,1,0,0,1,1952
Jim Dunbar,United States,1,0,0,1,1952
Bill Fields,United States,1,0,0,1,1952
Wayne Frye,United States,1,0,0,1,1952
Charlie Logg,United States,1,0,0,1,1952
Charley Manring,United States,1,0,0,1,1952
Dick Murphy,United States,1,0,0,1,1952
Tom Price,United States,1,0,0,1,1952
Henry Proctor,United States,1,0,0,1,1952
Frank Shakespeare,United States,1,0,0,1,1952
Ed Stevens,United States,1,0,0,1,1952
Duje Bonačić,Croatia,1,0,0,1,1952
Petar Šegvić,Croatia,1,0,0,1,1952
Mate Trojanović,Croatia,1,0,0,1,1952
Velimir Valenta,Croatia,1,0,0,1,1952
George Genereux,Canada,1,0,0,1,1952
Károly Takács,Hungary,1,0,0,1,1952
Erling Kongshaug,Norway,1,0,0,1,1952
"John H. Larsen, Sr.",Norway,1,0,0,1,1952
Iosif Sîrbu,Romania,1,0,0,1,1952
Anatoly Bogdanov,Russian Federation,1,0,0,1,1952
Joe Benner,United States,1,0,0,1,1952
John Davies,Australia,1,0,0,1,1952
Valéria Gyenge,Hungary,1,0,0,1,1952
Ilona Novák,Hungary,1,0,0,1,1952
Éva Székely,Hungary,1,0,0,1,1952
Joan Harrison,South Africa,1,0,0,1,1952
Skippy Browning,United States,1,0,0,1,1952
Sammy Lee,United States,1,0,0,1,1952
Jimmy McLane,United States,1,0,0,1,1952
Wayne Moore,United States,1,0,0,1,1952
Yoshi Oyakawa,United States,1,0,0,1,1952
Clarke Scholes,United States,1,0,0,1,1952
Bill Woolsey,United States,1,0,0,1,1952
Róbert Antal,Hungary,1,0,0,1,1952
Antal Bolvári,Hungary,1,0,0,1,1952
Dezső Fábián,Hungary,1,0,0,1,1952
Dezső Gyarmati,Hungary,1,0,0,1,1952
István Hasznos,Hungary,1,0,0,1,1952
László Jeney,Hungary,1,0,0,1,1952
György Kárpáti,Hungary,1,0,0,1,1952
Dezső Lemhényi,Hungary,1,0,0,1,1952
Kálmán Markovits,Hungary,1,0,0,1,1952
Miklós Martin,Hungary,1,0,0,1,1952
Károly Szittya,Hungary,1,0,0,1,1952
"István Szívós, Sr.",Hungary,1,0,0,1,1952
György Vízvári,Hungary,1,0,0,1,1952
Trofim Lomakin,Russian Federation,1,0,0,1,1952
Rapael Chimishk'iani,Georgia,1,0,0,1,1952
Ivan Udodov,Russian Federation,1,0,0,1,1952
John Davis,United States,1,0,0,1,1952
Pete George,United States,1,0,0,1,1952
Tommy Kono,United States,1,0,0,1,1952
Norb Schemansky,United States,1,0,0,1,1952
Kelpo Gröndahl,Finland,1,0,0,1,1952
Imre Hódos,Hungary,1,0,0,1,1952
Miklós Szilvásy,Hungary,1,0,0,1,1952
Shohachi Ishii,Japan,1,0,0,1,1952
Olle Anderberg,Sweden,1,0,0,1,1952
Axel Grönberg,Sweden,1,0,0,1,1952
Viking Palm,Sweden,1,0,0,1,1952
Hasan Gemici,Turkey,1,0,0,1,1952
Bayram Şit,Turkey,1,0,0,1,1952
Boris Gurevich,Russian Federation,1,0,0,1,1952
Johannes Kotkas,Estonia,1,0,0,1,1952
Arsen Mek'ok'ishvili,Georgia,1,0,0,1,1952
Yakov Punkin,Soviet Union,1,0,0,1,1952
Shazam Safin,Russian Federation,1,0,0,1,1952
Davit Tsimak'uridze,Georgia,1,0,0,1,1952
Bill Smith,United States,1,0,0,1,1952
Emelyn Whiton,United States,1,0,0,1,1952
Hakon Barfod,Norway,1,0,0,1,1952
Britton Chance,United States,1,0,0,1,1952
Paul Elvstrøm,Denmark,1,0,0,1,1952
Everard Endt,United States,1,0,0,1,1952
Sigve Lie,Norway,1,0,0,1,1952
John Morgan,United States,1,0,0,1,1952
Eric Ridder,United States,1,0,0,1,1952
Nico Rode,Italy,1,0,0,1,1952
Julian Roosevelt,United States,1,0,0,1,1952
Michael Schoettle,United States,1,0,0,1,1952
Agostino Straulino,Italy,1,0,0,1,1952
Thor Thorvaldsen,Norway,1,0,0,1,1952
Sumner White,United States,1,0,0,1,1952
Ed White,United States,1,0,0,1,1952
Herman Whiton,United States,1,0,0,1,1952
Adhemar da Silva,Brazil,1,0,0,1,1952
József Csermák,Hungary,1,0,0,1,1952
Pino Dordoni,Italy,1,0,0,1,1952
Les Laing,Jamaica,1,0,0,1,1952
Josy Barthel,Luxembourg,1,0,0,1,1952
Yvette Williams,New Zealand,1,0,0,1,1952
Esther Brand,South Africa,1,0,0,1,1952
John Mikaelsson,Sweden,1,0,0,1,1952
Dana Ingrová-Zátopková,Czech Republic,1,0,0,1,1952
Nina Romashkova-Ponomaryova,Russian Federation,1,0,0,1,1952
Galina Zybina,Russian Federation,1,0,0,1,1952
Mae Faggs,United States,1,0,0,1,1952
Cathy Hardy,United States,1,0,0,1,1952
Barbara Jones,United States,1,0,0,1,1952
Janet Moreau,United States,1,0,0,1,1952
Horace Ashenfelter,United States,1,0,0,1,1952
Jerome Biffle,United States,1,0,0,1,1952
Buddy Davis,United States,1,0,0,1,1952
Sim Iness,United States,1,0,0,1,1952
Bob Mathias,United States,1,0,0,1,1952
Parry O'Brien,United States,1,0,0,1,1952
Bob Richards,United States,1,0,0,1,1952
Dean Smith,United States,1,0,0,1,1952
Cy Young,United States,1,0,0,1,1952
Sepp Stalder,Switzerland,0,2,2,4,1952
Aleksandra Chudina,Russian Federation,0,2,1,3,1952
Óscar Cristi,Chile,0,2,0,2,1952
Tommy Shardelow,South Africa,0,2,0,2,1952
Renzo Nostini,Italy,0,2,0,2,1952
Giorgio Pellini,Italy,0,2,0,2,1952
Hiroshi Suzuki,Japan,0,2,0,2,1952
Hannie Termeulen,Netherlands,0,2,0,2,1952
Alain Mimoun,Algeria,0,2,0,2,1952
Willi Büsing,Germany,0,1,1,2,1952
Ray Robinson,South Africa,0,1,1,2,1952
Manlio Di Rosa,Italy,0,1,1,2,1952
Andrea Bodó-Molnár,Hungary,0,1,1,2,1952
Erzsébet Gulyás-Köteles,Hungary,0,1,1,2,1952
Irén Karcsics-Daruházi,Hungary,0,1,1,2,1952
Mária Kövi-Zalai,Hungary,0,1,1,2,1952
Olga Tass-Lemhényi,Hungary,0,1,1,2,1952
Edit Weckinger-Perényi,Hungary,0,1,1,2,1952
Tadao Uesako,Japan,0,1,1,2,1952
Boris Andreyev,Russian Federation,0,1,1,2,1952
Maria Sander,Germany,0,1,1,2,1952
Ollie Matson,United States,0,1,1,2,1952
Ilmar Kullam,Estonia,0,1,0,1,1952
Justinas Lagunavičius,Lithuania,0,1,0,1,1952
Edgar Basel,Germany,0,1,0,1,1952
John McNally,Ireland,0,1,0,1,1952
Sergio Caprari,Italy,0,1,0,1,1952
Antonio Pacenza,Argentina,0,1,0,1,1952
Aleksandr Moiseyev,Russian Federation,0,1,0,1,1952
Stepas Butautas,Cuba,0,1,0,1,1952
Nodar Jorjik'ia,Georgia,0,1,0,1,1952
Anatoly Konev,Russian Federation,0,1,0,1,1952
Otar Korkia,Georgia,0,1,0,1,1952
Heino Kruus,Estonia,0,1,0,1,1952
Joann Lõssov,Estonia,0,1,0,1,1952
Yury Ozerov,Russian Federation,0,1,0,1,1952
Kazys Petkevičius,Lithuania,0,1,0,1,1952
Stasys Stonkus,Lithuania,0,1,0,1,1952
Maigonis Valdmanis,Latvia,0,1,0,1,1952
Viktor Vlasov,Russian Federation,0,1,0,1,1952
Aleksy Antkiewicz,Poland,0,1,0,1,1952
Vasile Tiță,Romania,0,1,0,1,1952
Theunis van Schalkwyk,South Africa,0,1,0,1,1952
Ingemar Johansson,Sweden,0,1,0,1,1952
Viktor Mednov,Russian Federation,0,1,0,1,1952
Sergey Shcherbakov,Russian Federation,0,1,0,1,1952
Gertrude Liebhart,Austria,0,1,0,1,1952
Don Hawgood,Canada,0,1,0,1,1952
Ken Lane,Canada,0,1,0,1,1952
Gábor Novák,Hungary,0,1,0,1,1952
János Parti,Hungary,0,1,0,1,1952
Lars Glassér,Sweden,0,1,0,1,1952
Ingemar Hedberg,Sweden,0,1,0,1,1952
Hans Wetterström,Sweden,0,1,0,1,1952
Gunnar Åkerlund,Sweden,0,1,0,1,1952
Jan Brzák-Felix,Czech Republic,0,1,0,1,1952
Bohumil Kudrna,Czech Republic,0,1,0,1,1952
Lis Hartel,Denmark,0,1,0,1,1952
Henri Chammartin,Switzerland,0,1,0,1,1952
Ricardo Echeverría,Chile,0,1,0,1,1952
Gustav Fischer,Switzerland,0,1,0,1,1952
Guy Lefrant,France,0,1,0,1,1952
César Mendoza,Chile,0,1,0,1,1952
Otto Rothe,Germany,0,1,0,1,1952
Gottfried Trachsel,Switzerland,0,1,0,1,1952
Klaus Wagner,Germany,0,1,0,1,1952
Dino Bruni,Italy,0,1,0,1,1952
George Estman,South Africa,0,1,0,1,1952
Bobby Fowler,South Africa,0,1,0,1,1952
Gianni Ghidini,Italy,0,1,0,1,1952
Bruno Monti,Italy,0,1,0,1,1952
Jimmy Swift,South Africa,0,1,0,1,1952
Vincenzo Zucconelli,Italy,0,1,0,1,1952
Jules Ancion,Netherlands,0,1,0,1,1952
André Boerstra,Netherlands,0,1,0,1,1952
Harry Derckx,Netherlands,0,1,0,1,1952
Han Drijver,Netherlands,0,1,0,1,1952
Dick Esser,Netherlands,0,1,0,1,1952
Roepie Kruize,Netherlands,0,1,0,1,1952
Dick Loggere,Netherlands,0,1,0,1,1952
Lau Mulder,Netherlands,0,1,0,1,1952
Eddy Tiel,Netherlands,0,1,0,1,1952
Wim van Heel,Netherlands,0,1,0,1,1952
Leo Wery,Netherlands,0,1,0,1,1952
Ilona Elek-Schacherer,Hungary,0,1,0,1,1952
Giancarlo Bergamini,Italy,0,1,0,1,1952
Gastone Darè,Italy,0,1,0,1,1952
Roberto Ferrari,Italy,0,1,0,1,1952
Vincenzo Pinton,Italy,0,1,0,1,1952
Mauro Racca,Italy,0,1,0,1,1952
Antonio Spallino,Italy,0,1,0,1,1952
Per Carleson,Sweden,0,1,0,1,1952
Sven Fahlman,Sweden,0,1,0,1,1952
Carl Forssell,Sweden,0,1,0,1,1952
Bengt Ljungquist,Sweden,0,1,0,1,1952
Lennart Magnusson,Sweden,0,1,0,1,1952
Berndt-Otto Rehbinder,Sweden,0,1,0,1,1952
Vladimir Beara,Croatia,0,1,0,1,1952
Stjepan Bobek,Croatia,0,1,0,1,1952
Vujadin Boškov,Serbia,0,1,0,1,1952
Zlatko Čajkovski,Croatia,0,1,0,1,1952
Tomislav Crnković,Croatia,0,1,0,1,1952
Ivica Horvat,Croatia,0,1,0,1,1952
Rajko Mitić,Serbia,0,1,0,1,1952
Tihomir Ognjanov,Serbia,0,1,0,1,1952
Branko Stanković,Serbia,0,1,0,1,1952
Bernard Vukas,Croatia,0,1,0,1,1952
Branko Zebec,Croatia,0,1,0,1,1952
Alfred Schwarzmann,Germany,0,1,0,1,1952
Masao Takemoto,Japan,0,1,0,1,1952
Jerzy Jokiel,Poland,0,1,0,1,1952
Ernst Fivian,Switzerland,0,1,0,1,1952
Ernst Gebendinger,Switzerland,0,1,0,1,1952
Hans Schwarzentruber,Switzerland,0,1,0,1,1952
Melchior Thalmann,Switzerland,0,1,0,1,1952
Jean Tschabold,Switzerland,0,1,0,1,1952
Claes Egnell,Sweden,0,1,0,1,1952
Thorsten Lindqvist,Sweden,0,1,0,1,1952
Merv Wood,Australia,0,1,0,1,1952
Bob Baetens,Belgium,0,1,0,1,1952
Michel Knuysen,Belgium,0,1,0,1,1952
Pierre Blondiaux,France,0,1,0,1,1952
Marc Bouissou,France,0,1,0,1,1952
Roger Gautier,France,0,1,0,1,1952
Jean-Jacques Guissart,France,0,1,0,1,1952
Helmut Heinhold,Germany,0,1,0,1,1952
Heinz Manchen,Germany,0,1,0,1,1952
Helmut Noll,Germany,0,1,0,1,1952
Rico Bianchi,Switzerland,0,1,0,1,1952
Émile Ess,Switzerland,0,1,0,1,1952
Walter Leiser,Switzerland,0,1,0,1,1952
Heini Scheller,Switzerland,0,1,0,1,1952
Karl Weidmann,Switzerland,0,1,0,1,1952
Slava Amiragov,Russian Federation,0,1,0,1,1952
Igor Borisov,Russian Federation,0,1,0,1,1952
Yevgeny Brago,Russian Federation,0,1,0,1,1952
Leonid Gissen,Russian Federation,0,1,0,1,1952
Igor Yemchuk,Soviet Union,0,1,0,1,1952
Aleksey Komarov,Russian Federation,0,1,0,1,1952
Vladimir Kryukov,Russian Federation,0,1,0,1,1952
Igor Polyakov,Russian Federation,0,1,0,1,1952
Vladimir Rodimushkin,Russian Federation,0,1,0,1,1952
Yevgeny Samsonov,Russian Federation,0,1,0,1,1952
Georgy Zhilin,Soviet Union,0,1,0,1,1952
Ángel León,Spain,0,1,0,1,1952
Vilho Ylönen,Finland,0,1,0,1,1952
Szilárd Kun,Hungary,0,1,0,1,1952
Robert Bürchler,Switzerland,0,1,0,1,1952
Knut Holmqvist,Sweden,0,1,0,1,1952
Olof Sköldberg,Sweden,0,1,0,1,1952
Mady Moreau,France,0,1,0,1,1952
Gilbert Bozon,France,0,1,0,1,1952
Toru Goto,Japan,0,1,0,1,1952
Yoshihiro Hamaguchi,Japan,0,1,0,1,1952
Shiro Hashizume,Japan,0,1,0,1,1952
Teijiro Tanikawa,Japan,0,1,0,1,1952
Joaquín Capilla,Mexico,0,1,0,1,1952
Irma Heijting-Schuhmacher,Netherlands,0,1,0,1,1952
Marie-Louise Linssen-Vaessen,Netherlands,0,1,0,1,1952
Koosje van Voorn,Netherlands,0,1,0,1,1952
Geertje Wielema,Netherlands,0,1,0,1,1952
Paula Jean Myers-Pope,United States,0,1,0,1,1952
Miller Anderson,United States,0,1,0,1,1952
Bo Stassforth,United States,0,1,0,1,1952
Veljko Bakašun,Croatia,0,1,0,1,1952
Marko Brajnović,Croatia,0,1,0,1,1952
Vladimir Ivković,Croatia,0,1,0,1,1952
Zdravko Ježić,Croatia,0,1,0,1,1952
Zdravko-Ćiro Kovačić,Croatia,0,1,0,1,1952
Ivo Kurtini,Croatia,0,1,0,1,1952
Lovro Radonić,Croatia,0,1,0,1,1952
Ivo Štakula,Croatia,0,1,0,1,1952
Boško Vuksanović,Montenegro,0,1,0,1,1952
Gerry Gratton,Canada,0,1,0,1,1952
Mahmoud Namdjou,Islamic Republic of Iran,0,1,0,1,1952
Yevgeny Lopatin,Russian Federation,0,1,0,1,1952
Grigory Novak,Russian Federation,0,1,0,1,1952
Nikolay Saksonov,Russian Federation,0,1,0,1,1952
Jim Bradford,United States,0,1,0,1,1952
Stan Stanczyk,United States,0,1,0,1,1952
Kalervo Rauhala,Finland,0,1,0,1,1952
Imre Polyák,Hungary,0,1,0,1,1952
Nasser Givehchi,Islamic Republic of Iran,0,1,0,1,1952
Gholam Reza Takhti,Islamic Republic of Iran,0,1,0,1,1952
Ignazio Fabra,Italy,0,1,0,1,1952
Yushu Kitano,Japan,0,1,0,1,1952
Zakaria Chihab,Lebanon,0,1,0,1,1952
Gösta Andersson,Sweden,0,1,0,1,1952
Bertil Antonsson,Sweden,0,1,0,1,1952
Per Berlin,Sweden,0,1,0,1,1952
Gustav Freij,Sweden,0,1,0,1,1952
Josef Růžička,Czech Republic,0,1,0,1,1952
Rəşid Məmmədbəyov,Azerbaijan,0,1,0,1,1952
Shalva Chikhladze,Georgia,0,1,0,1,1952
Tommy Evans,United States,0,1,0,1,1952
Henry Wittenberg,United States,0,1,0,1,1952
Vibeke Lunde,Norway,0,1,0,1,1952
Erland Almkvist,Sweden,0,1,0,1,1952
Tor Arneberg,Norway,0,1,0,1,1952
Sidney Boldt-Christmas,Sweden,0,1,0,1,1952
Charles Currey,Great Britain,0,1,0,1,1952
Børre Falkum-Hansen,Norway,0,1,0,1,1952
Finn Ferner,Norway,0,1,0,1,1952
Johan Martin Ferner,Norway,0,1,0,1,1952
Per Gedda,Sweden,0,1,0,1,1952
Erik Heiberg,Norway,0,1,0,1,1952
"Peder Lunde, Sr.",Norway,0,1,0,1,1952
Carl Mortensen,Norway,0,1,0,1,1952
John Price,United States,0,1,0,1,1952
John Reid,United States,0,1,0,1,1952
Reinaldo Gorno,Argentina,0,1,0,1,1952
Sheila Lerwill,Great Britain,0,1,0,1,1952
Helga Klein,Germany,0,1,0,1,1952
Ursula Knab,Germany,0,1,0,1,1952
Marga Petersen,Germany,0,1,0,1,1952
Marianne Werner,Germany,0,1,0,1,1952
Karl Storch,Germany,0,1,0,1,1952
Adolfo Consolini,Italy,0,1,0,1,1952
Puck Brouwer,Netherlands,0,1,0,1,1952
Daphne Robb-Hasenjäger,South Africa,0,1,0,1,1952
Fritz Schwab,Switzerland,0,1,0,1,1952
Josef Doležal,Czech Republic,0,1,0,1,1952
Yelizaveta Bagryantseva,Russian Federation,0,1,0,1,1952
Mariya Golubnichaya,Russian Federation,0,1,0,1,1952
Lev Kalyayev,Russian Federation,0,1,0,1,1952
Vladimir Kazantsev,Russian Federation,0,1,0,1,1952
Yury Lituyev,Russian Federation,0,1,0,1,1952
Levan Sanadze,Georgia,0,1,0,1,1952
Leonid Shcherbakov,Russian Federation,0,1,0,1,1952
Vladimir Sukharev,Russian Federation,0,1,0,1,1952
Boris Tokarev,Russian Federation,0,1,0,1,1952
Thane Baker,United States,0,1,0,1,1952
Milt Campbell,United States,0,1,0,1,1952
Gene Cole,United States,0,1,0,1,1952
Jack Davis,United States,0,1,0,1,1952
Meredith Gourdine,United States,0,1,0,1,1952
Darrow Hooper,United States,0,1,0,1,1952
Don Laz,United States,0,1,0,1,1952
Bob McMillen,United States,0,1,0,1,1952
Bill Miller,United States,0,1,0,1,1952
Ken Wiesner,United States,0,1,0,1,1952
Egon Drews,Germany,0,0,2,2,1952
Wilfried Soltau,Germany,0,0,2,2,1952
Fritz Thiedemann,Germany,0,0,2,2,1952
Oswald Zappelli,Switzerland,0,0,2,2,1952
Evelyn Kawamoto,United States,0,0,2,2,1952
Heinz Ulzheimer,Germany,0,0,2,2,1952
Boris Nikolov,Bulgaria,0,0,1,1,1952
Viktor Jørgensen,Denmark,0,0,1,1,1952
Ilkka Koski,Finland,0,0,1,1,1952
Erkki Mallenius,Finland,0,0,1,1,1952
Erkki Pakkanen,Finland,0,0,1,1,1952
Harry Siljander,Finland,0,0,1,1,1952
Joseph Ventaja,France,0,0,1,1,1952
Günther Heidemann,Germany,0,0,1,1,1952
Bruno Visintin,Italy,0,0,1,1,1952
Gang Jun-Ho,Republic of Korea,0,0,1,1,1952
Eladio Herrera,Argentina,0,0,1,1,1952
Martín Acosta y Lara,Uruguay,0,0,1,1,1952
Enrique Baliño,Uruguay,0,0,1,1,1952
Victorio Cieslinskas,Uruguay,0,0,1,1,1952
Héctor Costa,Uruguay,0,0,1,1,1952
Nelson Demarco,Uruguay,0,0,1,1,1952
Héctor García,Uruguay,0,0,1,1,1952
Tabaré Borges,Uruguay,0,0,1,1,1952
Adesio Lombardo,Uruguay,0,0,1,1,1952
Roberto Lovera,Uruguay,0,0,1,1,1952
Sergio Matto,Uruguay,0,0,1,1,1952
Wilfredo Peláez,Uruguay,0,0,1,1,1952
Carlos Roselló,Uruguay,0,0,1,1,1952
Gheorghe Fiat,Romania,0,0,1,1,1952
Len Leisching,South Africa,0,0,1,1,1952
Dries Nieman,South Africa,0,0,1,1,1952
Willie Toweel,South Africa,0,0,1,1,1952
Stig Sjölin,Sweden,0,0,1,1,1952
Anatoly Bulakov,Russian Federation,0,0,1,1,1952
Gennady Garbuzov,Russian Federation,0,0,1,1,1952
Anatoly Perov,Russian Federation,0,0,1,1,1952
Boris Tishin,Russian Federation,0,0,1,1,1952
Max Raub,Austria,0,0,1,1,1952
Herbert Wiedermann,Austria,0,0,1,1,1952
Olavi Ojanperä,Finland,0,0,1,1,1952
Louis Gantois,France,0,0,1,1,1952
Michel Scheuer,Germany,0,0,1,1,1952
József Gurovits,Hungary,0,0,1,1,1952
Ferenc Varga,Hungary,0,0,1,1,1952
Alfréd Jindra,Czech Republic,0,0,1,1,1952
Nina Savina,Russian Federation,0,0,1,1,1952
Ida von Nagel,Germany,0,0,1,1,1952
Champ Hough,United States,0,0,1,1,1952
André Jousseaumé,France,0,0,1,1,1952
Arthur McCashin,United States,0,0,1,1,1952
Heinz Pollay,Germany,0,0,1,1,1952
John Russell,United States,0,0,1,1,1952
Walter Staley,United States,0,0,1,1,1952
Bill Steinkraus,United States,0,0,1,1,1952
John E. B. Wofford,United States,0,0,1,1,1952
Jacques Anquetil,France,0,0,1,1,1952
Roland Bezamat,France,0,0,1,1,1952
Don Burgess,Great Britain,0,0,1,1,1952
Antonio Maspes,Italy,0,0,1,1,1952
George Newberry,Great Britain,0,0,1,1,1952
Alan Newton,Great Britain,0,0,1,1,1952
Cesare Pinarello,Italy,0,0,1,1,1952
Werner Potzernheim,Germany,0,0,1,1,1952
Claude Rouer,France,0,0,1,1,1952
Ron Stretton,Great Britain,0,0,1,1,1952
Alfred Tonello,France,0,0,1,1,1952
Edi Ziegler,Germany,0,0,1,1,1952
Denys Carnill,Great Britain,0,0,1,1,1952
John Cockett,Great Britain,0,0,1,1,1952
John Conroy,Great Britain,0,0,1,1,1952
Graham Dadds,Great Britain,0,0,1,1,1952
Derek Day,Great Britain,0,0,1,1,1952
Dennis Eagan,Great Britain,0,0,1,1,1952
Robin Fletcher,Great Britain,0,0,1,1,1952
Roger Midgley,Great Britain,0,0,1,1,1952
Richard Norris,Great Britain,0,0,1,1,1952
Neil Nugent,Great Britain,0,0,1,1,1952
Anthony Nunn,Great Britain,0,0,1,1,1952
Anthony Robinson,Great Britain,0,0,1,1,1952
John Taylor,Great Britain,0,0,1,1,1952
Karen Lachmann,Denmark,0,0,1,1,1952
Jean Laroyenne,France,0,0,1,1,1952
Jacques Lefèvre,France,0,0,1,1,1952
Jean Levavasseur,France,0,0,1,1,1952
Bernard Morel,France,0,0,1,1,1952
Maurice Piot,France,0,0,1,1,1952
Jean-François Tournon,France,0,0,1,1,1952
Lajos Maszlay,Hungary,0,0,1,1,1952
Endre Palócz,Hungary,0,0,1,1,1952
József Sákovics,Hungary,0,0,1,1,1952
Endre Tilli,Hungary,0,0,1,1,1952
Paul Barth,Switzerland,0,0,1,1,1952
Willy Fitting,Switzerland,0,0,1,1,1952
Paul Meister,Switzerland,0,0,1,1,1952
Otto Rüfenacht,Switzerland,0,0,1,1,1952
Mario Valota,Switzerland,0,0,1,1,1952
Sylve Bengtsson,Sweden,0,0,1,1,1952
Yngve Brodd,Sweden,0,0,1,1,1952
Bengt Gustavsson,Sweden,0,0,1,1,1952
Holger Hansson,Sweden,0,0,1,1,1952
Gösta Lindh,Sweden,0,0,1,1,1952
Gösta Löfgren,Sweden,0,0,1,1,1952
Erik Nilsson,Sweden,0,0,1,1,1952
Ingvar Rydell,Sweden,0,0,1,1,1952
Lennart Samuelsson,Sweden,0,0,1,1,1952
Gösta Sandberg,Sweden,0,0,1,1,1952
Karl Svensson,Sweden,0,0,1,1,1952
Olle Åhlund,Sweden,0,0,1,1,1952
Hana Bobková,Czech Republic,0,0,1,1,1952
Alena Chadimová,Czech Republic,0,0,1,1,1952
Jana Rabasová,Czech Republic,0,0,1,1,1952
Alena Reichová,Czech Republic,0,0,1,1,1952
Matylda Matoušková-Šínová,Czech Republic,0,0,1,1,1952
Božena Srncová,Czech Republic,0,0,1,1,1952
Věra Vančurová,Czech Republic,0,0,1,1,1952
Eva Bosáková-Věchtová,Czech Republic,0,0,1,1,1952
Onni Lappalainen,Finland,0,0,1,1,1952
Kaino Lempinen,Finland,0,0,1,1,1952
Berndt Lindfors,Finland,0,0,1,1,1952
Olavi Rove,Finland,0,0,1,1,1952
Heikki Savolainen,Finland,0,0,1,1,1952
Kalevi Viskari,Finland,0,0,1,1,1952
Paavo Aaltonen,Finland,0,0,1,1,1952
Takashi Ono,Japan,0,0,1,1,1952
Ole Mannonen,Finland,0,0,1,1,1952
Olavi Rokka,Finland,0,0,1,1,1952
Lauri Vilkko,Finland,0,0,1,1,1952
Dave Anderson,Australia,0,0,1,1,1952
Phil Cayzer,Australia,0,0,1,1,1952
Ernest Chapman,Australia,0,0,1,1,1952
Tom Chessell,Australia,0,0,1,1,1952
Merv Finlay,Australia,0,0,1,1,1952
Nim Greenwood,Australia,0,0,1,1,1952
Ted Pain,Australia,0,0,1,1,1952
Bob Tinning,Australia,0,0,1,1,1952
Geoff Williamson,Australia,0,0,1,1,1952
Jørgen Frantzen,Denmark,0,0,1,1,1952
Svend Pedersen,Denmark,0,0,1,1,1952
Poul Svendsen,Denmark,0,0,1,1,1952
Oiva Lommi,Finland,0,0,1,1,1952
Veikko Lommi,Finland,0,0,1,1,1952
Lauri Nevalainen,Finland,0,0,1,1,1952
Kauko Wahlsten,Finland,0,0,1,1,1952
Teodor Kocerka,Poland,0,0,1,1,1952
Hans Kalt,Switzerland,0,0,1,1,1952
Kurt Schmid,Switzerland,0,0,1,1,1952
Juan Rodríguez,Uruguay,0,0,1,1,1952
Miguel Seijas,Uruguay,0,0,1,1,1952
Matt Leanderson,United States,0,0,1,1,1952
Carl Lovsted,United States,0,0,1,1,1952
Al Rossi,United States,0,0,1,1,1952
Al Ulbrickson,United States,0,0,1,1,1952
Richard Wahlstrom,United States,0,0,1,1,1952
Tauno Mäki,Finland,0,0,1,1,1952
Ambrus Balogh,Hungary,0,0,1,1,1952
Gheorghe Lichiardopol,Romania,0,0,1,1,1952
Hans Liljedahl,Sweden,0,0,1,1,1952
Lev Vaynshteyn,Russian Federation,0,0,1,1,1952
Art Jackson,United States,0,0,1,1,1952
Tetsuo Okamoto,Brazil,0,0,1,1,1952
Jo Bernardo,France,0,0,1,1,1952
Aldo Eminente,France,0,0,1,1,1952
Alex Jany,France,0,0,1,1,1952
Elenor Gordon-McKay,Great Britain,0,0,1,1,1952
Günther Haase,Germany,0,0,1,1,1952
Herbert Klein,Germany,0,0,1,1,1952
Jean Stewart,New Zealand,0,0,1,1,1952
Göran Larsson,Sweden,0,0,1,1,1952
Per-Olof Östrand,Sweden,0,0,1,1,1952
Jody Alderson,United States,0,0,1,1,1952
Jackie LaVine,United States,0,0,1,1,1952
Zoe Ann Olsen-Jensen,United States,0,0,1,1,1952
Marilee Stepan,United States,0,0,1,1,1952
Juno Stover-Irwin,United States,0,0,1,1,1952
Bob Clotworthy,United States,0,0,1,1,1952
Jack Taylor,United States,0,0,1,1,1952
Gildo Arena,Italy,0,0,1,1,1952
Lucio Ceccarini,Italy,0,0,1,1,1952
Renato De Sanzuane,Italy,0,0,1,1,1952
Raffaello Gambino,Italy,0,0,1,1,1952
Salvatore Gionta,Italy,0,0,1,1,1952
Maurizio Mannelli,Italy,0,0,1,1,1952
Geminio Ognio,Italy,0,0,1,1,1952
Carlo Peretti,Italy,0,0,1,1,1952
Enzo Polito,Italy,0,0,1,1,1952
Cesare Rubini,Italy,0,0,1,1,1952
Renato Traiola,Italy,0,0,1,1,1952
Humberto Selvetti,Argentina,0,0,1,1,1952
Vern Barberis,Australia,0,0,1,1,1952
Ali Mirzai,Islamic Republic of Iran,0,0,1,1,1952
Kim Seong-Jip,Republic of Korea,0,0,1,1,1952
Lennox Kilgour,Trinidad and Tobago,0,0,1,1,1952
Rodney Wilkes,Trinidad and Tobago,0,0,1,1,1952
Arkady Vorobyov,Russian Federation,0,0,1,1,1952
Abdel Aal Rashid,Egypt,0,0,1,1,1952
Leo Honkala,Finland,0,0,1,1,1952
Tauno Kovanen,Finland,0,0,1,1,1952
Ken Richmond,Great Britain,0,0,1,1,1952
György Gurics,Hungary,0,0,1,1,1952
Khashaba Jadhav,India,0,0,1,1,1952
Abdollah Mojtabavi,Islamic Republic of Iran,0,0,1,1,1952
Mahmoud Mollaghasemi,Islamic Republic of Iran,0,0,1,1,1952
Tofigh Jahanbakht,Islamic Republic of Iran,0,0,1,1,1952
Khalil Taha,Lebanon,0,0,1,1,1952
Karl-Erik Nilsson,Sweden,0,0,1,1,1952
Mikuláš Athanasov,Czechoslovakia,0,0,1,1,1952
Adil Atan,Turkey,0,0,1,1,1952
Nikolay Belov,Russian Federation,0,0,1,1,1952
Artyom Teryan,Azerbaijan,0,0,1,1,1952
Joe Henson,United States,0,0,1,1,1952
Joaquim Fiúza,Portugal,0,0,1,1,1952
Ragnar Jansson,Finland,0,0,1,1,1952
Adolf Konto,Finland,0,0,1,1,1952
Erich Natusch,Germany,0,0,1,1,1952
Georg Nowka,Germany,0,0,1,1,1952
Carl-Erik Ohlson,Sweden,0,0,1,1,1952
Francisco de Andrade,Portugal,0,0,1,1,1952
Rickard Sarby,Sweden,0,0,1,1,1952
Paul Sjöberg,Finland,0,0,1,1,1952
Theodor Thomsen,Germany,0,0,1,1,1952
Rolf Turkka,Finland,0,0,1,1,1952
Folke Wassén,Sweden,0,0,1,1,1952
Magnus Wassén,Sweden,0,0,1,1,1952
Ernst Westerlund,Finland,0,0,1,1,1952
José da Conceição,Brazil,0,0,1,1,1952
Toivo Hyytiäinen,Finland,0,0,1,1,1952
Heather Armitage,Great Britain,0,0,1,1,1952
Shirley Cawley,Great Britain,0,0,1,1,1952
Sylvia Cheeseman,Great Britain,0,0,1,1,1952
Jean Desforges,Great Britain,0,0,1,1,1952
June Foulds-Paul,Great Britain,0,0,1,1,1952
McDonald Bailey,Great Britain,0,0,1,1,1952
John Disley,Great Britain,0,0,1,1,1952
Hans Geister,Germany,0,0,1,1,1952
Karl-Friedrich Haas,Germany,0,0,1,1,1952
Werner Lueg,Germany,0,0,1,1,1952
Herbert Schade,Germany,0,0,1,1,1952
Günther Steines,Germany,0,0,1,1,1952
György Csányi,Hungary,0,0,1,1,1952
Ödön Földessy,Hungary,0,0,1,1,1952
Béla Goldoványi,Hungary,0,0,1,1,1952
Imre Németh,Hungary,0,0,1,1,1952
Antal Róka,Hungary,0,0,1,1,1952
Géza Varasdi,Hungary,0,0,1,1,1952
László Zarándi,Hungary,0,0,1,1,1952
John Holland,New Zealand,0,0,1,1,1952
Gustaf Jansson,Sweden,0,0,1,1,1952
Ragnar Lundberg,Sweden,0,0,1,1,1952
Nino Dumbadze,Georgia,0,0,1,1,1952
Yelena Gorchakova,Russian Federation,0,0,1,1,1952
Nadezhda Khnik'ina-Dvalishvili,Georgia,0,0,1,1,1952
Klavdiya Tochonova,Russian Federation,0,0,1,1,1952
Aleksandr Anufriyev,Russian Federation,0,0,1,1,1952
Bruno Junk,Estonia,0,0,1,1,1952
Art Barnard,United States,0,0,1,1,1952
Jim Dillion,United States,0,0,1,1,1952
Jim Fuchs,United States,0,0,1,1,1952
Jimmy Gathers,United States,0,0,1,1,1952
Floyd Simmons,United States,0,0,1,1,1952
Asnoldo Devonish,Venezuela,0,0,1,1,1952
Kalevi Laitinen,Finland,0,0,1,1,1952
Ágnes Keleti,Hungary,4,2,0,6,1956
Larisa Latynina,Soviet Union,4,1,1,6,1956
Viktor Chukarin,Soviet Union,3,1,1,5,1956
Valentin Muratov,Russian Federation,3,1,0,4,1956
Murray Rose,Australia,3,0,0,3,1956
Betty Cuthbert,Australia,3,0,0,3,1956
Bobby Joe Morrow,United States,3,0,0,3,1956
Lorraine Crapp,Australia,2,1,0,3,1956
Dawn Fraser,Australia,2,1,0,3,1956
Edoardo Mangiarotti,Italy,2,0,1,3,1956
Leon Rotman,Romania,2,0,0,2,1956
Gert Fredriksson,Sweden,2,0,0,2,1956
Leandro Faggin,Italy,2,0,0,2,1956
Rudolf Kárpáti,Hungary,2,0,0,2,1956
Carlo Pavesi,Italy,2,0,0,2,1956
Albert Azaryan,Armenia,2,0,0,2,1956
Boris Shakhlin,Soviet Union,2,0,0,2,1956
Jon Henricks,Australia,2,0,0,2,1956
Pat McCormick,United States,2,0,0,2,1956
Shirley Strickland de la Hunty,Australia,2,0,0,2,1956
Vladimir Kuts,Soviet Union,2,0,0,2,1956
Tom Courtney,United States,2,0,0,2,1956
Charlie Jenkins,United States,2,0,0,2,1956
Takashi Ono,Japan,1,3,1,5,1956
Tamara Manina,Russian Federation,1,2,1,4,1956
Yury Titov,Russian Federation,1,1,2,4,1956
Olga Tass-Lemhényi,Hungary,1,1,1,3,1956
Thane Baker,United States,1,1,1,3,1956
Gratsian Botev,Russian Federation,1,1,0,2,1956
Pavel Kharin,Russian Federation,1,1,0,2,1956
Arnaud Geyre,France,1,1,0,2,1956
Michel Vermeulin,France,1,1,0,2,1956
Christian d'Oriola,France,1,1,0,2,1956
Giancarlo Bergamini,Italy,1,1,0,2,1956
Giuseppe Delfino,Italy,1,1,0,2,1956
Andrea Bodó-Molnár,Hungary,1,1,0,2,1956
Erzsébet Gulyás-Köteles,Hungary,1,1,0,2,1956
Aliz Kertész,Hungary,1,1,0,2,1956
Margit Korondi,Hungary,1,1,0,2,1956
Vasily Borisov,Russian Federation,1,1,0,2,1956
John Devitt,Australia,1,1,0,2,1956
Shelley Mann,United States,1,1,0,2,1956
Sofya Muratova,Russian Federation,1,0,3,4,1956
Michel Scheuer,Germany,1,0,1,2,1956
Antonio Spallino,Italy,1,0,1,2,1956
Polina Astakhova,Soviet Union,1,0,1,2,1956
Lyudmila Yegorova,Russian Federation,1,0,1,2,1956
Lidiya Kalinina-Ivanova,Russian Federation,1,0,1,2,1956
Faith Leech,Australia,1,0,1,2,1956
Joaquín Capilla,Mexico,1,0,1,2,1956
Dick McTaggart,Great Britain,1,0,0,1,1956
Terry Spinks,Great Britain,1,0,0,1,1956
Wolfgang Behrendt,East Germany,1,0,0,1,1956
László Papp,Hungary,1,0,0,1,1956
Dick Boushka,United States,1,0,0,1,1956
Carl Cain,United States,1,0,0,1,1956
Chuck Darling,United States,1,0,0,1,1956
Billy Evans,United States,1,0,0,1,1956
Gib Ford,United States,1,0,0,1,1956
Burdie Haldorson,United States,1,0,0,1,1956
Bill Hougland,United States,1,0,0,1,1956
Bob Jeangerard,United States,1,0,0,1,1956
K. C. Jones,United States,1,0,0,1,1956
Bill Russell,United States,1,0,0,1,1956
Ron Tomsic,United States,1,0,0,1,1956
Jim Walsh,United States,1,0,0,1,1956
Nicolae Linca,Romania,1,0,0,1,1956
Vladimir Engibaryan,Armenia,1,0,0,1,1956
Vladimir Safronov,Russian Federation,1,0,0,1,1956
Gennady Shatkov,Russian Federation,1,0,0,1,1956
Jim Boyd,United States,1,0,0,1,1956
Pete Rademacher,United States,1,0,0,1,1956
Meinrad Miltenberger,Germany,1,0,0,1,1956
László Fábián,Hungary,1,0,0,1,1956
János Urányi,Hungary,1,0,0,1,1956
Dumitru Alexe,Romania,1,0,0,1,1956
Simion Ismailciuc,Romania,1,0,0,1,1956
Yelizaveta Dementyeva,Russian Federation,1,0,0,1,1956
René Abadie,France,1,0,0,1,1956
Ercole Baldini,Italy,1,0,0,1,1956
Ian Browne,Australia,1,0,0,1,1956
Antonio Domenicali,Italy,1,0,0,1,1956
Franco Gandini,Italy,1,0,0,1,1956
Valentino Gasparella,Italy,1,0,0,1,1956
Tony Marchant,Australia,1,0,0,1,1956
Maurice Moucheraud,France,1,0,0,1,1956
Virginio Pizzali,Italy,1,0,0,1,1956
Michel Rousseau,France,1,0,0,1,1956
Leslie Claudius,India,1,0,0,1,1956
Ranganathan Francis,India,1,0,0,1,1956
Hari Pal Kaushik,India,1,0,0,1,1956
Amir Kumar,India,1,0,0,1,1956
Raghbir Lal,India,1,0,0,1,1956
Shankar Laxman,India,1,0,0,1,1956
Govind Perumal,India,1,0,0,1,1956
Bakshish Singh,India,1,0,0,1,1956
Amit Singh Bakshi,India,1,0,0,1,1956
Raghbir Singh Bhola,India,1,0,0,1,1956
"Balbir Singh, Sr.",India,1,0,0,1,1956
Hardayal Singh,India,1,0,0,1,1956
Randhir Singh Gentle,India,1,0,0,1,1956
Balkrishan Singh,India,1,0,0,1,1956
Gurdev Singh,India,1,0,0,1,1956
Udham Singh,India,1,0,0,1,1956
Charles Stephen,India,1,0,0,1,1956
Gillian Sheen,Great Britain,1,0,0,1,1956
Aladár Gerevich,Hungary,1,0,0,1,1956
Pál Kovács,Hungary,1,0,0,1,1956
Dániel Magay,Hungary,1,0,0,1,1956
Giorgio Anglesio,Italy,1,0,0,1,1956
Franco Bertinetti,Italy,1,0,0,1,1956
Luigi Carpaneda,Italy,1,0,0,1,1956
Manlio Di Rosa,Italy,1,0,0,1,1956
Vittorio Lucarelli,Italy,1,0,0,1,1956
Alberto Pellegrino,Italy,1,0,0,1,1956
Gene Hámori,Hungary,1,0,0,1,1956
Attila Keresztes,Hungary,1,0,0,1,1956
Anatoly Bashashkin,Russian Federation,1,0,0,1,1956
Yozhef Betsa,Soviet Union,1,0,0,1,1956
Anatoly Ilyin,Russian Federation,1,0,0,1,1956
Anatoly Isayev,Russian Federation,1,0,0,1,1956
Valentin Ivanov,Russian Federation,1,0,0,1,1956
Lev Yashin,Russian Federation,1,0,0,1,1956
Boris Kuznetsov,Russian Federation,1,0,0,1,1956
Anatoly Maslyonkin,Russian Federation,1,0,0,1,1956
Igor Netto,Russian Federation,1,0,0,1,1956
Mikhail Ogonkov,Russian Federation,1,0,0,1,1956
Aleksey Paramonov,Russian Federation,1,0,0,1,1956
Boris Razinsky,Russian Federation,1,0,0,1,1956
Vladimir Ryzhkin,Russian Federation,1,0,0,1,1956
Sergey Salnikov,Russian Federation,1,0,0,1,1956
Nikita Simonyan,Armenia,1,0,0,1,1956
Eduard Streltsov,Russian Federation,1,0,0,1,1956
Boris Tatushin,Russian Federation,1,0,0,1,1956
Nikolay Tishchenko,Russian Federation,1,0,0,1,1956
Helmut Bantz,Germany,1,0,0,1,1956
Pavel Stolbov,Russian Federation,1,0,0,1,1956
Lars Hall,Sweden,1,0,0,1,1956
Ivan Deryugin,Soviet Union,1,0,0,1,1956
Igor Novikov,Armenia,1,0,0,1,1956
Aleksandr Tarasov,Russian Federation,1,0,0,1,1956
Don Arnold,Canada,1,0,0,1,1956
Walter D'Hondt,Canada,1,0,0,1,1956
Lorne Loomer,Canada,1,0,0,1,1956
Archie MacKinnon,Canada,1,0,0,1,1956
Romano Sgheiz,Italy,1,0,0,1,1956
Ivo Stefanoni,Italy,1,0,0,1,1956
Franco Trincavelli,Italy,1,0,0,1,1956
Angelo Vanzin,Italy,1,0,0,1,1956
Alberto Winkler,Italy,1,0,0,1,1956
Aleksandr Berkutov,Russian Federation,1,0,0,1,1956
Vyacheslav Ivanov,Russian Federation,1,0,0,1,1956
Yury Tyukalov,Russian Federation,1,0,0,1,1956
Dan Ayrault,United States,1,0,0,1,1956
William Becklean,United States,1,0,0,1,1956
Don Beer,United States,1,0,0,1,1956
Tom Charlton,United States,1,0,0,1,1956
John Cooke,United States,1,0,0,1,1956
Caldwell Esselstyn,United States,1,0,0,1,1956
Jim Fifer,United States,1,0,0,1,1956
Conn Findlay,United States,1,0,0,1,1956
Charles Grimes,United States,1,0,0,1,1956
Duvall Hecht,United States,1,0,0,1,1956
Bob Morey,United States,1,0,0,1,1956
Kurt Seiffert,United States,1,0,0,1,1956
Rusty Wailes,United States,1,0,0,1,1956
Dave Wight,United States,1,0,0,1,1956
Gerry Ouellette,Canada,1,0,0,1,1956
Pentti Linnosvuo,Finland,1,0,0,1,1956
Galliano Rossini,Italy,1,0,0,1,1956
Ștefan Petrescu,Romania,1,0,0,1,1956
Anatoly Bogdanov,Russian Federation,1,0,0,1,1956
Vitaly Romanenko,Soviet Union,1,0,0,1,1956
Sandra Morgan,Australia,1,0,0,1,1956
Kevin O'Halloran,Australia,1,0,0,1,1956
David Theile,Australia,1,0,0,1,1956
Judith Grinham,Great Britain,1,0,0,1,1956
Ursula Happe,Germany,1,0,0,1,1956
Masaru Furukawa,Japan,1,0,0,1,1956
Bob Clotworthy,United States,1,0,0,1,1956
Bill Yorzyk,United States,1,0,0,1,1956
Antal Bolvári,Hungary,1,0,0,1,1956
Ottó Boros,Hungary,1,0,0,1,1956
Dezső Gyarmati,Hungary,1,0,0,1,1956
István Hevesi,Hungary,1,0,0,1,1956
László Jeney,Hungary,1,0,0,1,1956
Tivadar Kanizsa,Hungary,1,0,0,1,1956
György Kárpáti,Hungary,1,0,0,1,1956
Kálmán Markovits,Hungary,1,0,0,1,1956
Mihály Mayer,Hungary,1,0,0,1,1956
"István Szívós, Sr.",Hungary,1,0,0,1,1956
Ervin Zádor,Hungary,1,0,0,1,1956
Fyodor Bogdanovsky,Russian Federation,1,0,0,1,1956
Igor Rybak,Soviet Union,1,0,0,1,1956
Arkady Vorobyov,Russian Federation,1,0,0,1,1956
Paul Anderson,United States,1,0,0,1,1956
Ike Berger,United States,1,0,0,1,1956
Tommy Kono,United States,1,0,0,1,1956
Chuck Vinci,United States,1,0,0,1,1956
Nikola Stanchev,Bulgaria,1,0,0,1,1956
Kyösti Lehtonen,Finland,1,0,0,1,1956
Rauno Mäkinen,Finland,1,0,0,1,1956
Emam Ali Habibi,Islamic Republic of Iran,1,0,0,1,1956
Gholam Reza Takhti,Islamic Republic of Iran,1,0,0,1,1956
Mitsuo Ikeda,Japan,1,0,0,1,1956
Shozo Sasahara,Japan,1,0,0,1,1956
Mithat Bayrak,Turkey,1,0,0,1,1956
Mustafa Dağıstanlı,Turkey,1,0,0,1,1956
Hamit Kaplan,Turkey,1,0,0,1,1956
Givi K'art'ozia,Georgia,1,0,0,1,1956
Valentin Nikolayev,Russian Federation,1,0,0,1,1956
Anatoly Parfyonov,Russian Federation,1,0,0,1,1956
Nikolay Solovyov,Russian Federation,1,0,0,1,1956
Mirian Tsalkalamanidze,Georgia,1,0,0,1,1956
Konstantin Vyrupayev,Russian Federation,1,0,0,1,1956
Folke Bohlin,Sweden,1,0,0,1,1956
Jack Cropp,New Zealand,1,0,0,1,1956
Paul Elvstrøm,Denmark,1,0,0,1,1956
Hjalmar Karlsson,Sweden,1,0,0,1,1956
Larry Low,United States,1,0,0,1,1956
Peter Mander,New Zealand,1,0,0,1,1956
Bengt Palmquist,Sweden,1,0,0,1,1956
Sture Stork,Sweden,1,0,0,1,1956
Lars Thörn,Sweden,1,0,0,1,1956
Leif Wikström,Sweden,1,0,0,1,1956
Bert Williams,United States,1,0,0,1,1956
Norma Croker-Fleming,Australia,1,0,0,1,1956
Fleur Mellor,Australia,1,0,0,1,1956
Adhemar da Silva,Brazil,1,0,0,1,1956
Alain Mimoun,Algeria,1,0,0,1,1956
Chris Brasher,Great Britain,1,0,0,1,1956
Ronnie Delany,Ireland,1,0,0,1,1956
Egil Danielsen,Norway,1,0,0,1,1956
Norman Read,New Zealand,1,0,0,1,1956
Elżbieta Duńska-Krzesińska,Poland,1,0,0,1,1956
Inese Jaunzeme,Latvia,1,0,0,1,1956
Tamara Tyshkevich,Russian Federation,1,0,0,1,1956
Leonid Spirin,Russian Federation,1,0,0,1,1956
Olga Fikotová-Connolly,Czech Republic,1,0,0,1,1956
Millie McDaniel,United States,1,0,0,1,1956
Greg Bell,United States,1,0,0,1,1956
Lee Calhoun,United States,1,0,0,1,1956
Milt Campbell,United States,1,0,0,1,1956
Hal Connolly,United States,1,0,0,1,1956
Glenn Davis,United States,1,0,0,1,1956
Charlie Dumas,United States,1,0,0,1,1956
Lou Jones,United States,1,0,0,1,1956
Leamon King,United States,1,0,0,1,1956
J. W. Mashburn,United States,1,0,0,1,1956
Ira Murchison,United States,1,0,0,1,1956
Parry O'Brien,United States,1,0,0,1,1956
Al Oerter,United States,1,0,0,1,1956
Bob Richards,United States,1,0,0,1,1956
Masami Kubota,Japan,0,2,1,3,1956
Ladislav Fouček,Czech Republic,0,2,0,2,1956
Jerzy Pawłowski,Poland,0,2,0,2,1956
Nobuyuki Aihara,Japan,0,2,0,2,1956
Tsuyoshi Yamanaka,Japan,0,2,0,2,1956
Christa Stubnick,East Germany,0,2,0,2,1956
Masao Takemoto,Japan,0,1,3,4,1956
George Breen,United States,0,1,2,3,1956
Alan Jackson,Great Britain,0,1,1,2,1956
József Marosi,Hungary,0,1,1,2,1956
József Sákovics,Hungary,0,1,1,2,1956
Ann-Sofi Pettersson-Colling,Sweden,0,1,1,2,1956
Ole Mannonen,Finland,0,1,1,2,1956
Sylvia Ruuska,United States,0,1,1,2,1956
Derek Johnson,Great Britain,0,1,1,2,1956
Ramón Tapia,Chile,0,1,0,1,1956
Tommy Nicholls,Great Britain,0,1,0,1,1956
Harry Kurschat,Germany,0,1,0,1,1956
Fred Tiedt,Ireland,0,1,0,1,1956
Franco Nenci,Italy,0,1,0,1,1956
Song Sun-Cheon,Republic of Korea,0,1,0,1,1956
Arkady Bochkaryov,Russian Federation,0,1,0,1,1956
Jānis Krūmiņš,Latvia,0,1,0,1,1956
Algirdas Lauritėnas,Lithuania,0,1,0,1,1956
Valdis Muižnieks,Latvia,0,1,0,1,1956
Yury Ozerov,Russian Federation,0,1,0,1,1956
Kazys Petkevičius,Lithuania,0,1,0,1,1956
Mikhail Semyonov,Russian Federation,0,1,0,1,1956
Stasys Stonkus,Lithuania,0,1,0,1,1956
Mikhail Studenetsky,Russian Federation,0,1,0,1,1956
Vladimir Torban,Russian Federation,0,1,0,1,1956
Maigonis Valdmanis,Latvia,0,1,0,1,1956
Viktor Zubkov,Russian Federation,0,1,0,1,1956
Mircea Dobrescu,Romania,0,1,0,1,1956
Gheorghe Negrea,Romania,0,1,0,1,1956
Lev Mukhin,Russian Federation,0,1,0,1,1956
José Torres,United States,0,1,0,1,1956
Georges Dransart,France,0,1,0,1,1956
Marcel Renaud,France,0,1,0,1,1956
Therese Zenz,Germany,0,1,0,1,1956
Fritz Briel,Germany,0,1,0,1,1956
Theo Kleine,Germany,0,1,0,1,1956
Ferenc Hatlaczky,Hungary,0,1,0,1,1956
István Hernek,Hungary,0,1,0,1,1956
János Parti,Hungary,0,1,0,1,1956
Anatoly Demitkov,Russian Federation,0,1,0,1,1956
Mihhail Kaaleste,Russian Federation,0,1,0,1,1956
Igor Pisarev,Russian Federation,0,1,0,1,1956
René Bianchi,France,0,1,0,1,1956
Stan Brittain,Great Britain,0,1,0,1,1956
Jean Graczyk,France,0,1,0,1,1956
Bill Holmes,Great Britain,0,1,0,1,1956
Jean-Claude Lecante,France,0,1,0,1,1956
Václav Machek,Czech Republic,0,1,0,1,1956
Guglielmo Pesenti,Italy,0,1,0,1,1956
Harry Reynolds,Great Britain,0,1,0,1,1956
Abdul Hamid,Pakistan,0,1,0,1,1956
Akhtar Hussain,India,0,1,0,1,1956
Munir Ahmed Dar,Pakistan,0,1,0,1,1956
Ghulam Rasool,Pakistan,0,1,0,1,1956
Habibur Rehman,Pakistan,0,1,0,1,1956
Anwar Ahmed Khan,Pakistan,0,1,0,1,1956
Habib Ali Kiddie,Pakistan,0,1,0,1,1956
Latif-ur Rehman,India,0,1,0,1,1956
Manzoor Hussain Atif,Pakistan,0,1,0,1,1956
Qazi Massarrat Hussain,Pakistan,0,1,0,1,1956
Motiullah,Pakistan,0,1,0,1,1956
Ahmed Naseer Bunda,Pakistan,0,1,0,1,1956
Noor Alam,Pakistan,0,1,0,1,1956
Zakir Hussain,Pakistan,0,1,0,1,1956
Olga Orban-Szabo,Romania,0,1,0,1,1956
Bernard Baudoux,France,0,1,0,1,1956
Roger Closset,France,0,1,0,1,1956
René Coicaud,France,0,1,0,1,1956
Jacques Lataste,France,0,1,0,1,1956
Claude Netter,France,0,1,0,1,1956
Lajos Balthazár,Hungary,0,1,0,1,1956
Barnabás Berzsenyi,Hungary,0,1,0,1,1956
Ambrus Nagy,Hungary,0,1,0,1,1956
Béla Rerrich,Hungary,0,1,0,1,1956
Marek Kuszewski,Poland,0,1,0,1,1956
Zygmunt Pawlas,Poland,0,1,0,1,1956
Andrzej Piątkowski,Poland,0,1,0,1,1956
Wojciech Zabłocki,Poland,0,1,0,1,1956
Ryszard Zub,Poland,0,1,0,1,1956
Sava Antić,Serbia,0,1,0,1,1956
Ibrahim Biogradlić,Bosnia and Herzegovina,0,1,0,1,1956
Mladen Koščak,Croatia,0,1,0,1,1956
Dobrosav Krstić,Serbia,0,1,0,1,1956
Luka Lipošinović,Croatia,0,1,0,1,1956
Muhamed Mujić,Bosnia and Herzegovina,0,1,0,1,1956
Zlatko Papec,Croatia,0,1,0,1,1956
Petar Radenković,Serbia,0,1,0,1,1956
Nikola Radović,Montenegro,0,1,0,1,1956
Ivan Šantek,Croatia,0,1,0,1,1956
Dragoslav Šekularac,Serbia,0,1,0,1,1956
Ljubiša Spajić,Serbia,0,1,0,1,1956
Todor Veselinović,Colombia,0,1,0,1,1956
Blagoja Vidinić,North Macedonia,0,1,0,1,1956
Evy Berggren,Sweden,0,1,0,1,1956
Doris Hedberg,Sweden,0,1,0,1,1956
Maude Karlén,Sweden,0,1,0,1,1956
Karin Lindberg,Sweden,0,1,0,1,1956
Eva Rönström,Sweden,0,1,0,1,1956
Eva Bosáková-Věchtová,Czech Republic,0,1,0,1,1956
Akira Kono,Japan,0,1,0,1,1956
Shinsaku Tsukawaki,Japan,0,1,0,1,1956
William Thoresson,Sweden,0,1,0,1,1956
Bill Andre,United States,0,1,0,1,1956
Jack Daniels,United States,0,1,0,1,1956
George Lambert,United States,0,1,0,1,1956
Stuart MacKenzie,Australia,0,1,0,1,1956
David Helliwell,Canada,0,1,0,1,1956
Philip Kueber,Canada,0,1,0,1,1956
Dick McClure,Canada,0,1,0,1,1956
Douglas McDonald,Canada,0,1,0,1,1956
Bill McKerlich,Canada,0,1,0,1,1956
Carl Ogawa,Canada,0,1,0,1,1956
Waynne Pretty,Canada,0,1,0,1,1956
Laurie West,Canada,0,1,0,1,1956
Robert Wilson,Canada,0,1,0,1,1956
Horst Arndt,Germany,0,1,0,1,1956
Rainer Borkowsky,Germany,0,1,0,1,1956
Moritz von Groddeck,Germany,0,1,0,1,1956
Ivar Aronsson,Sweden,0,1,0,1,1956
Gösta Eriksson,Sweden,0,1,0,1,1956
Evert Gunnarsson,Sweden,0,1,0,1,1956
Bertil Göransson,Sweden,0,1,0,1,1956
Olle Larsson,Sweden,0,1,0,1,1956
Igor Buldakov,Russian Federation,0,1,0,1,1956
Viktor Ivanov,Russian Federation,0,1,0,1,1956
Pat Costello,United States,0,1,0,1,1956
Jim Gardiner,United States,0,1,0,1,1956
Jim McIntosh,United States,0,1,0,1,1956
Art McKinlay,United States,0,1,0,1,1956
John McKinlay,United States,0,1,0,1,1956
John Welchli,United States,0,1,0,1,1956
Adam Smelczyński,Poland,0,1,0,1,1956
Olof Sköldberg,Sweden,0,1,0,1,1956
Otakar Hořínek,Czech Republic,0,1,0,1,1956
Allan Erdman,Russian Federation,0,1,0,1,1956
Yevgeny Cherkasov,Russian Federation,0,1,0,1,1956
Makhmud Umarov,Russian Federation,0,1,0,1,1956
John Monckton,Australia,0,1,0,1,1956
Éva Székely,Hungary,0,1,0,1,1956
Takashi Ishimoto,Japan,0,1,0,1,1956
Masahiro Yoshimura,Japan,0,1,0,1,1956
Carin Cone,United States,0,1,0,1,1956
Nancy Ramey,United States,0,1,0,1,1956
Nancy Simons,United States,0,1,0,1,1956
Juno Stover-Irwin,United States,0,1,0,1,1956
Jeanne Stunyo,United States,0,1,0,1,1956
Dick Hanley,United States,0,1,0,1,1956
Don Harper,United States,0,1,0,1,1956
Ford Konno,United States,0,1,0,1,1956
Gary Tobian,United States,0,1,0,1,1956
Bill Woolsey,United States,0,1,0,1,1956
Ivo Cipci,Croatia,0,1,0,1,1956
Tomislav Franjković,Croatia,0,1,0,1,1956
Vladimir Ivković,Croatia,0,1,0,1,1956
Zdravko Ježić,Croatia,0,1,0,1,1956
Hrvoje Kačić,Croatia,0,1,0,1,1956
Zdravko-Ćiro Kovačić,Croatia,0,1,0,1,1956
Lovro Radonić,Croatia,0,1,0,1,1956
Marijan Žužej,Croatia,0,1,0,1,1956
Humberto Selvetti,Argentina,0,1,0,1,1956
Ravil Khabutdinov,Russian Federation,0,1,0,1,1956
Yevgeny Minayev,Russian Federation,0,1,0,1,1956
Vasīlijs Stepanovs,Latvia,0,1,0,1,1956
Vladimir Stogov,Russian Federation,0,1,0,1,1956
Pete George,United States,0,1,0,1,1956
Dave Sheppard,United States,0,1,0,1,1956
Jef Mewis,Belgium,0,1,0,1,1956
Dimitar Dobrev,Bulgaria,0,1,0,1,1956
Yusein Mekhmedov,Bulgaria,0,1,0,1,1956
Petko Sirakov,Bulgaria,0,1,0,1,1956
Wilfried Dietrich,Germany,0,1,0,1,1956
Imre Polyák,Hungary,0,1,0,1,1956
Mohamed Ali Khojastehpour,Islamic Republic of Iran,0,1,0,1,1956
Mohamed Mehdi Yaghoubi,Islamic Republic of Iran,0,1,0,1,1956
Ignazio Fabra,Italy,0,1,0,1,1956
Shigeru Kasahara,Japan,0,1,0,1,1956
Edvin Vesterby,Sweden,0,1,0,1,1956
Rıza Doğan,Turkey,0,1,0,1,1956
İbrahim Zengin,Turkey,0,1,0,1,1956
Boris Kulayev,Russian Federation,0,1,0,1,1956
Vladimir Maneyev,Russian Federation,0,1,0,1,1956
Dan Hodge,United States,0,1,0,1,1956
Cyril Andresen,Denmark,0,1,0,1,1956
Ole Berntsen,Denmark,0,1,0,1,1956
David Bowker,Great Britain,0,1,0,1,1956
John Dillon,Great Britain,0,1,0,1,1956
Neil Kennedy-Cochrane-Patrick,Great Britain,0,1,0,1,1956
André Nelis,Belgium,0,1,0,1,1956
Robert Perry,Great Britain,0,1,0,1,1956
Nico Rode,Italy,0,1,0,1,1956
John Scott,Australia,0,1,0,1,1956
Agostino Straulino,Italy,0,1,0,1,1956
Rolly Tasker,Australia,0,1,0,1,1956
Christian Robert von Bülow,Denmark,0,1,0,1,1956
Graham Gipson,Australia,0,1,0,1,1956
Kevan Gosper,Australia,0,1,0,1,1956
Leon Gregory,Australia,0,1,0,1,1956
David Lean,Australia,0,1,0,1,1956
Charles Porter,Australia,0,1,0,1,1956
Marlene Ahrens,Chile,0,1,0,1,1956
Heather Armitage,Great Britain,0,1,0,1,1956
June Foulds-Paul,Great Britain,0,1,0,1,1956
Thelma Hopkins,Great Britain,0,1,0,1,1956
Anne Pashley,Great Britain,0,1,0,1,1956
Jean Scrivens,Great Britain,0,1,0,1,1956
Gordon Pirie,Great Britain,0,1,0,1,1956
Gisela Köhler-Birkemeyer,East Germany,0,1,0,1,1956
Klaus Richtzenhain,East Germany,0,1,0,1,1956
Karl-Friedrich Haas,Germany,0,1,0,1,1956
József Kovács,Hungary,0,1,0,1,1956
Sándor Rozsnyói,Hungary,0,1,0,1,1956
Vilhjálmur Einarsson,Iceland,0,1,0,1,1956
Janusz Sidło,Poland,0,1,0,1,1956
Irina Beglyakova,Russian Federation,0,1,0,1,1956
Mariya Pisareva,Russian Federation,0,1,0,1,1956
Galina Zybina,Russian Federation,0,1,0,1,1956
Leonid Bartenev,Soviet Union,0,1,0,1,1956
Yury Konovalov,Azerbaijan,0,1,0,1,1956
Mikhail Krivonosov,Belarus,0,1,0,1,1956
Yevgeny Maskinskov,Russian Federation,0,1,0,1,1956
Antanas Mikėnas,Lithuania,0,1,0,1,1956
Vladimir Sukharev,Russian Federation,0,1,0,1,1956
Boris Tokarev,Russian Federation,0,1,0,1,1956
Willye White,United States,0,1,0,1,1956
John Bennett,United States,0,1,0,1,1956
Jack Davis,United States,0,1,0,1,1956
Fortune Gordien,United States,0,1,0,1,1956
Bob Gutowski,United States,0,1,0,1,1956
Rafer Johnson,United States,0,1,0,1,1956
Bill Nieder,United States,0,1,0,1,1956
Eddie Southern,United States,0,1,0,1,1956
Andy Stanfield,United States,0,1,0,1,1956
Franjo Mihalić,Croatia,0,1,0,1,1956
Joan Rosazza,United States,0,1,0,1,1956
Gennady Bukharin,Russian Federation,0,0,2,2,1956
Wäinö Korhonen,Finland,0,0,2,2,1956
Lev Kuznetsov,Russian Federation,0,0,2,2,1956
Elena Leuștean-Popescu,Romania,0,0,2,2,1956
Marlene Mathews-Willard,Australia,0,0,2,2,1956
Claudio Barrientos,Chile,0,0,1,1,1956
Carlos Lucas,Chile,0,0,1,1,1956
Pentti Hämäläinen,Finland,0,0,1,1,1956
Gilbert Chapron,France,0,0,1,1,1956
René Libeer,France,0,0,1,1,1956
Nicky Gargano,Great Britain,0,0,1,1,1956
John McCormack,Great Britain,0,0,1,1,1956
Tony Byrne,Ireland,0,0,1,1,1956
Johnny Caldwell,Ireland,0,0,1,1,1956
Freddie Gilroy,Ireland,0,0,1,1,1956
Mino Bozzano,Italy,0,0,1,1,1956
Víctor Zalazar,Argentina,0,0,1,1,1956
Kevin Hogarth,Australia,0,0,1,1,1956
Carlos Blixen,Uruguay,0,0,1,1,1956
Nelson Chelle,Uruguay,0,0,1,1,1956
Ramiro Cortés,Uruguay,0,0,1,1,1956
Héctor Costa,Uruguay,0,0,1,1,1956
Nelson Demarco,Uruguay,0,0,1,1,1956
Héctor García,Uruguay,0,0,1,1,1956
Carlos González,Uruguay,0,0,1,1,1956
Sergio Matto,Uruguay,0,0,1,1,1956
Raúl Mera,Uruguay,0,0,1,1,1956
Óscar Moglia,Uruguay,0,0,1,1,1956
Ariel Olascoaga,Uruguay,0,0,1,1,1956
Milton Scaron,Uruguay,0,0,1,1,1956
Henryk Niedźwiedzki,Poland,0,0,1,1,1956
Zbigniew Pietrzykowski,Poland,0,0,1,1,1956
Constantin Dumitrescu,Romania,0,0,1,1,1956
Daan Bekker,South Africa,0,0,1,1,1956
Henry Loubscher,South Africa,0,0,1,1,1956
Anatoly Lagetko,Russian Federation,0,0,1,1,1956
Romualdas Murauskas,Lithuania,0,0,1,1,1956
Walter Brown,Australia,0,0,1,1,1956
Dennis Green,Australia,0,0,1,1,1956
Max Raub,Austria,0,0,1,1,1956
Herbert Wiedermann,Austria,0,0,1,1,1956
Tove Søby,Denmark,0,0,1,1,1956
Imre Farkas,Hungary,0,0,1,1,1956
József Hunics,Hungary,0,0,1,1,1956
Lajos Kiss,Hungary,0,0,1,1,1956
Ferenc Mohácsi,Hungary,0,0,1,1,1956
Károly Wieland,Hungary,0,0,1,1,1956
Don Burgess,Great Britain,0,0,1,1,1956
Mike Gambrill,Great Britain,0,0,1,1,1956
John Geddes,Great Britain,0,0,1,1,1956
Erich Hagen,East Germany,0,0,1,1,1956
Giuseppe Ogna,Italy,0,0,1,1,1956
Cesare Pinarello,Italy,0,0,1,1,1956
Dick Ploog,Australia,0,0,1,1,1956
Reinhold Pommer,Germany,0,0,1,1,1956
Gustav-Adolf Schur,East Germany,0,0,1,1,1956
Tom Simpson,Great Britain,0,0,1,1,1956
Jimmy Swift,South Africa,0,0,1,1,1956
Horst Tüller,East Germany,0,0,1,1,1956
Günther Brennecke,Germany,0,0,1,1,1956
Hugo Budinger,Germany,0,0,1,1,1956
Werner Delmes,Germany,0,0,1,1,1956
Hugo Dollheiser,Germany,0,0,1,1,1956
Eberhard Ferstl,Germany,0,0,1,1,1956
Alfred Lücker,Germany,0,0,1,1,1956
Helmut Nonn,Germany,0,0,1,1,1956
Wolfgang Nonn,Germany,0,0,1,1,1956
Heinz Radzikowski,Germany,0,0,1,1,1956
Werner Rosenbaum,Germany,0,0,1,1,1956
Günther Ullerich,Germany,0,0,1,1,1956
Renée Garilhe,France,0,0,1,1,1956
Daniel Dagallier,France,0,0,1,1,1956
Yves Dreyfus,France,0,0,1,1,1956
Armand Mouyal,France,0,0,1,1,1956
Claude Nigon,France,0,0,1,1,1956
René Queyroux,France,0,0,1,1,1956
Mihály Fülöp,Hungary,0,0,1,1,1956
József Gyuricza,Hungary,0,0,1,1,1956
Lajos Somodi,Hungary,0,0,1,1,1956
Endre Tilli,Hungary,0,0,1,1,1956
Leonid Bogdanov,Russian Federation,0,0,1,1,1956
Yakov Rylsky,Russian Federation,0,0,1,1,1956
Yevgeny Cherepovsky,Soviet Union,0,0,1,1,1956
David Tyshler,Soviet Union,0,0,1,1,1956
Todor Diev,Bulgaria,0,0,1,1,1956
Krum Yanev,Bulgaria,0,0,1,1,1956
Yordan Yosifov,Bulgaria,0,0,1,1,1956
Ivan Kolev,Bulgaria,0,0,1,1,1956
Nikola Kovachev,Bulgaria,0,0,1,1,1956
Manol Manolov,Bulgaria,0,0,1,1,1956
Georgi Spirov Naydenov,Bulgaria,0,0,1,1,1956
Georgi Dimitrov,Bulgaria,0,0,1,1,1956
Milcho Goranov,Bulgaria,0,0,1,1,1956
Panayot Panayotov,Bulgaria,0,0,1,1,1956
Kiril Rakarov,Bulgaria,0,0,1,1,1956
Stefan Bozhkov,Bulgaria,0,0,1,1,1956
Dimitar Milanov,Bulgaria,0,0,1,1,1956
Gavril Stoyanov,Bulgaria,0,0,1,1,1956
Dorota Horzonek-Jokiel,Poland,0,0,1,1,1956
Natalia Kot,Poland,0,0,1,1,1956
Danuta Nowak-Stachow,Poland,0,0,1,1,1956
Helena Rakoczy,Poland,0,0,1,1,1956
Lidia Szczerbińska,Poland,0,0,1,1,1956
Barbara Wilk-Ślizowska,Poland,0,0,1,1,1956
Gheorgheta Hurmuzachi,Romania,0,0,1,1,1956
Sonia Iovan-Inovan,Romania,0,0,1,1,1956
Elena Mărgărit-Niculeșcu,Romania,0,0,1,1,1956
Elena Săcălici,Romania,0,0,1,1,1956
Emilia Vătășoiu-Liță,Romania,0,0,1,1,1956
Raimo Heinonen,Finland,0,0,1,1,1956
Onni Lappalainen,Finland,0,0,1,1,1956
Olavi Leimuvirta,Finland,0,0,1,1,1956
Berndt Lindfors,Finland,0,0,1,1,1956
Martti Mansikka,Finland,0,0,1,1,1956
Kalevi Suoniemi,Finland,0,0,1,1,1956
Berndt Katter,Finland,0,0,1,1,1956
Michael Aikman,Australia,0,0,1,1,1956
Fred Benfield,Australia,0,0,1,1,1956
David Boykett,Australia,0,0,1,1,1956
Brian Doyle,Australia,0,0,1,1,1956
Harold Hewitt,Australia,0,0,1,1,1956
Jim Howden,Australia,0,0,1,1,1956
Neville Howell,Australia,0,0,1,1,1956
Garth Manton,Australia,0,0,1,1,1956
Adrian Monger,Australia,0,0,1,1,1956
Murray Riley,Australia,0,0,1,1,1956
Merv Wood,Australia,0,0,1,1,1956
Josef Kloimstein,Austria,0,0,1,1,1956
Alfred Sageder,Austria,0,0,1,1,1956
Kauko Hänninen,Finland,0,0,1,1,1956
Veli Lehtelä,Finland,0,0,1,1,1956
Matti Niemi,Finland,0,0,1,1,1956
Toimi Pitkänen,Finland,0,0,1,1,1956
Reino Poutanen,Finland,0,0,1,1,1956
Yves Delacour,France,0,0,1,1,1956
Guy Guillabert,France,0,0,1,1,1956
René Guissart,France,0,0,1,1,1956
Gaston Mercier,France,0,0,1,1,1956
Igor Yemchuk,Soviet Union,0,0,1,1,1956
Vladimir Petrov,Russian Federation,0,0,1,1,1956
Georgy Zhilin,Soviet Union,0,0,1,1,1956
"Jack Kelly, Jr.",United States,0,0,1,1,1956
Gil Boa,Canada,0,0,1,1,1956
Vilho Ylönen,Finland,0,0,1,1,1956
Alessandro Ciceri,Italy,0,0,1,1,1956
Gheorghe Lichiardopol,Romania,0,0,1,1,1956
John Sundberg,Sweden,0,0,1,1,1956
Vladimir Sevryugin,Russian Federation,0,0,1,1,1956
Offutt Pinion,United States,0,0,1,1,1956
Gary Chapman,Australia,0,0,1,1,1956
Irene MacDonald,Canada,0,0,1,1,1956
Margaret Edwards,Great Britain,0,0,1,1,1956
Eva-Maria ten Elsen,East Germany,0,0,1,1,1956
György Tumpek,Hungary,0,0,1,1,1956
Moira Abernethy,South Africa,0,0,1,1,1956
Jeanette Myburgh,South Africa,0,0,1,1,1956
Natalie Myburgh,South Africa,0,0,1,1,1956
Susan Roberts,South Africa,0,0,1,1,1956
Kharis Yunichev,Russian Federation,0,0,1,1,1956
Boris Nik'it'ini,Georgia,0,0,1,1,1956
Gennady Nikolayev,Soviet Union,0,0,1,1,1956
Vitaly Sorokin,Russian Federation,0,0,1,1,1956
Vladimir Struzhanov,Russian Federation,0,0,1,1,1956
Paula Jean Myers-Pope,United States,0,0,1,1,1956
Mary Sears,United States,0,0,1,1,1956
Dick Conner,United States,0,0,1,1,1956
Frank McKinney,United States,0,0,1,1,1956
Viktor Ageyev,Russian Federation,0,0,1,1,1956
Pyotr Breus,Russian Federation,0,0,1,1,1956
Boris Goykhman,Russian Federation,0,0,1,1,1956
Nodar Gvakharia,Georgia,0,0,1,1,1956
Vyacheslav Kurennoy,Russian Federation,0,0,1,1,1956
Boris Markarov,Russian Federation,0,0,1,1,1956
P'et're Mshvenieradze,Georgia,0,0,1,1,1956
Valentin Prokopov,Russian Federation,0,0,1,1,1956
Mikhail Ryzhak,Russian Federation,0,0,1,1,1956
Yury Shlyapin,Russian Federation,0,0,1,1,1956
Jean Debuf,France,0,0,1,1,1956
Mahmoud Namdjou,Islamic Republic of Iran,0,0,1,1,1956
Alberto Pigaiani,Italy,0,0,1,1,1956
Ermanno Pignatti,Italy,0,0,1,1,1956
Kim Chang-Hui,Republic of Korea,0,0,1,1,1956
Marian Zieliński,Poland,0,0,1,1,1956
Jim George,United States,0,0,1,1,1956
Taisto Kangasniemi,Finland,0,0,1,1,1956
Erkki Penttilä,Finland,0,0,1,1,1956
Gyula Tóth,Hungary,0,0,1,1,1956
Adelmo Bulgarelli,Italy,0,0,1,1,1956
Francisc Horvath,Romania,0,0,1,1,1956
Per Berlin,Sweden,0,0,1,1,1956
Rune Jansson,Sweden,0,0,1,1,1956
Karl-Erik Nilsson,Sweden,0,0,1,1,1956
Hüseyin Akbaş,Turkey,0,0,1,1,1956
Dursun Ali Eğribaş,Turkey,0,0,1,1,1956
Vakht'ang Balavadze,Georgia,0,0,1,1,1956
Alimbeg Bestayev,Russian Federation,0,0,1,1,1956
Roman Dzeneladze,Georgia,0,0,1,1,1956
Mikhail Shakhov,Soviet Union,0,0,1,1,1956
Giorgi Skhirt'ladze,Georgia,0,0,1,1,1956
Pete Blair,United States,0,0,1,1,1956
Ron Backus,Great Britain,0,0,1,1,1956
Jasper Blackall,Great Britain,0,0,1,1,1956
Doug Buxton,Australia,0,0,1,1,1956
Sloane Farrington,Great Britain,0,0,1,1,1956
Jonathan Janson,Great Britain,0,0,1,1,1956
Durward Knowles,Great Britain,0,0,1,1,1956
Graham Mann,Great Britain,0,0,1,1,1956
John Marvin,United States,0,0,1,1,1956
Devereaux Mytton,Australia,0,0,1,1,1956
Terence Smith,Great Britain,0,0,1,1,1956
Jock Sturrock,Australia,0,0,1,1,1956
Norma Thrower,Australia,0,0,1,1,1956
Hec Hogan,Australia,0,0,1,1,1956
John Landy,Australia,0,0,1,1,1956
Al Lawrence,Australia,0,0,1,1,1956
Voitto Hellstén,Finland,0,0,1,1,1956
Veikko Karvonen,Finland,0,0,1,1,1956
Jorma Valkama,Finland,0,0,1,1,1956
Peter Higgins,Great Britain,0,0,1,1,1956
Derek Ibbotson,Great Britain,0,0,1,1,1956
John Salisbury,Great Britain,0,0,1,1,1956
Mike Wheeler,Great Britain,0,0,1,1,1956
Marianne Werner,Germany,0,0,1,1,1956
Heinz Fütterer,Germany,0,0,1,1,1956
Manfred Germar,Germany,0,0,1,1,1956
Lothar Knörzer,Germany,0,0,1,1,1956
Leo Pohl,Germany,0,0,1,1,1956
Georgios Roubanis,Greece,0,0,1,1,1956
Audun Boysen,Norway,0,0,1,1,1956
Ernst Larsen,Norway,0,0,1,1,1956
John Ljunggren,Sweden,0,0,1,1,1956
Jiří Skobla,Czech Republic,0,0,1,1,1956
Nadezhda Khnik'ina-Dvalishvili,Georgia,0,0,1,1,1956
Nadezhda Konyayeva,Russian Federation,0,0,1,1,1956
Nina Romashkova-Ponomaryova,Russian Federation,0,0,1,1,1956
Ardalion Ignatyev,Russian Federation,0,0,1,1,1956
Bruno Junk,Estonia,0,0,1,1,1956
Igor Kashkarov,Russian Federation,0,0,1,1,1956
Vitold Kreyer,Russian Federation,0,0,1,1,1956
Vasily Kuznetsov,Russian Federation,0,0,1,1,1956
Anatoly Samotsvetov,Russian Federation,0,0,1,1,1956
Viktor Tsybulenko,Soviet Union,0,0,1,1,1956
Isabelle Daniels,United States,0,0,1,1,1956
Mae Faggs,United States,0,0,1,1,1956
Margaret Matthews,United States,0,0,1,1,1956
Wilma Rudolph,United States,0,0,1,1,1956
Josh Culbreath,United States,0,0,1,1,1956
Des Koch,United States,0,0,1,1,1956
Joel Shankle,United States,0,0,1,1,1956
Boris Shakhlin,Soviet Union,4,2,1,7,1960
Larisa Latynina,Soviet Union,3,2,1,6,1960
Takashi Ono,Japan,3,1,2,6,1960
Chris von Saltza,United States,3,1,0,4,1960
Wilma Rudolph,United States,3,0,0,3,1960
Polina Astakhova,Soviet Union,2,1,1,4,1960
Antonina Seredina,Russian Federation,2,0,0,2,1960
Laurie Morgan,Australia,2,0,0,2,1960
Sante Gaiardoni,Italy,2,0,0,2,1960
Rudolf Kárpáti,Hungary,2,0,0,2,1960
Giuseppe Delfino,Italy,2,0,0,2,1960
Viktor Zhdanovich,Russian Federation,2,0,0,2,1960
Margarita Nikolayeva,Soviet Union,2,0,0,2,1960
Nobuyuki Aihara,Japan,2,0,0,2,1960
Ferenc Németh,Hungary,2,0,0,2,1960
Ingrid Gulbin-Engel-Krämer,East Germany,2,0,0,2,1960
Lynn Burke,United States,2,0,0,2,1960
Carolyn Schuler,United States,2,0,0,2,1960
Jeff Farrell,United States,2,0,0,2,1960
Mike Troy,United States,2,0,0,2,1960
Armin Hary,Germany,2,0,0,2,1960
Glenn Davis,United States,2,0,0,2,1960
Otis Davis,United States,2,0,0,2,1960
Sofya Muratova,Russian Federation,1,2,1,4,1960
Dawn Fraser,Australia,1,2,0,3,1960
Murray Rose,Australia,1,1,1,3,1960
Neale Lavis,Australia,1,1,0,2,1960
Livio Trapè,Italy,1,1,0,2,1960
Valentina Rastvorova,Soviet Union,1,1,0,2,1960
Zoltán Horváth,Hungary,1,1,0,2,1960
Edoardo Mangiarotti,Italy,1,1,0,2,1960
Alberto Pellegrino,Italy,1,1,0,2,1960
Yury Sisikin,Russian Federation,1,1,0,2,1960
Eva Bosáková-Věchtová,Czech Republic,1,1,0,2,1960
Masao Takemoto,Japan,1,1,0,2,1960
Albert Azaryan,Armenia,1,1,0,2,1960
Imre Nagy,Hungary,1,1,0,2,1960
David Theile,Australia,1,1,0,2,1960
Lance Larson,United States,1,1,0,2,1960
Frank McKinney,United States,1,1,0,2,1960
Gary Tobian,United States,1,1,0,2,1960
Wilfried Dietrich,Germany,1,1,0,2,1960
Tamara Press,Russian Federation,1,1,0,2,1960
Tamara Lyukhina-Zamotaylova,Russian Federation,1,0,2,3,1960
John Konrads,Australia,1,0,2,3,1960
Erik Hansen,Denmark,1,0,1,2,1960
Gert Fredriksson,Sweden,1,0,1,2,1960
Raimondo D'Inzeo,Italy,1,0,1,2,1960
Viktor Kapitonov,Russian Federation,1,0,1,2,1960
Shuji Tsurumi,Japan,1,0,1,2,1960
John Devitt,Australia,1,0,1,2,1960
Gyula Török,Hungary,1,0,0,1,1960
Nino Benvenuti,Italy,1,0,0,1,1960
Franco De Piccoli,Italy,1,0,0,1,1960
Francesco Musso,Italy,1,0,0,1,1960
Jay Arnette,United States,1,0,0,1,1960
Walt Bellamy,United States,1,0,0,1,1960
Bob Boozer,United States,1,0,0,1,1960
Terry Dischinger,United States,1,0,0,1,1960
Burdie Haldorson,United States,1,0,0,1,1960
Darrall Imhoff,United States,1,0,0,1,1960
Allen Kelley,United States,1,0,0,1,1960
Les Lane,Mexico,1,0,0,1,1960
Jerry Lucas,United States,1,0,0,1,1960
Oscar Robertson,United States,1,0,0,1,1960
Adrian Smith,United States,1,0,0,1,1960
Jerry West,United States,1,0,0,1,1960
Kazimierz Paździor,Poland,1,0,0,1,1960
Bohumil Němeček,Czech Republic,1,0,0,1,1960
Oleg Grigoryev,Russian Federation,1,0,0,1,1960
Cassius Clay,United States,1,0,0,1,1960
Eddie Crook,United States,1,0,0,1,1960
Wilbert McClure,United States,1,0,0,1,1960
Dieter Krause,East Germany,1,0,0,1,1960
Paul Lange,Germany,1,0,0,1,1960
Günter Perleberg,Germany,1,0,0,1,1960
Friedhelm Wentzke,Germany,1,0,0,1,1960
János Parti,Hungary,1,0,0,1,1960
Sven-Olov Sjödelius,Sweden,1,0,0,1,1960
Mariya Shubina,Russian Federation,1,0,0,1,1960
Leonid Geyshtor,Belarus,1,0,0,1,1960
Sergey Makarenko,Soviet Union,1,0,0,1,1960
Brian Crago,Australia,1,0,0,1,1960
Sergey Filatov,Russian Federation,1,0,0,1,1960
Bill Roycroft,Australia,1,0,0,1,1960
Alwin Schockemöhle,Germany,1,0,0,1,1960
Fritz Thiedemann,Germany,1,0,0,1,1960
Hans Günter Winkler,Germany,1,0,0,1,1960
Luigi Arienti,Italy,1,0,0,1,1960
Antonio Bailetti,Italy,1,0,0,1,1960
Giuseppe Beghetto,Italy,1,0,0,1,1960
Sergio Bianchetto,Italy,1,0,0,1,1960
Ottavio Cogliati,Italy,1,0,0,1,1960
Giacomo Fornoni,Italy,1,0,0,1,1960
Franco Testa,Italy,1,0,0,1,1960
Mario Vallotto,Italy,1,0,0,1,1960
Marino Vigna,Italy,1,0,0,1,1960
Abdul Hamid,Pakistan,1,0,0,1,1960
Abdul Rashid,Pakistan,1,0,0,1,1960
Abdul Waheed Khan,Pakistan,1,0,0,1,1960
Bashir Ahmed,Pakistan,1,0,0,1,1960
Ghulam Rasool,Pakistan,1,0,0,1,1960
Anwar Ahmed Khan,Pakistan,1,0,0,1,1960
Khurshid Aslam,Pakistan,1,0,0,1,1960
Habib Ali Kiddie,Pakistan,1,0,0,1,1960
Manzoor Hussain Atif,Pakistan,1,0,0,1,1960
Mushtaq Ahmed,Pakistan,1,0,0,1,1960
Motiullah,Pakistan,1,0,0,1,1960
Ahmed Naseer Bunda,Pakistan,1,0,0,1,1960
Noor Alam,Pakistan,1,0,0,1,1960
Heidi Schmid,Germany,1,0,0,1,1960
Galina Gorokhova,Russian Federation,1,0,0,1,1960
Tatyana Petrenko-Samusenko,Belarus,1,0,0,1,1960
Valentina Prudskova,Russian Federation,1,0,0,1,1960
Lyudmila Shishova,Russian Federation,1,0,0,1,1960
Aleksandra Zabelina,Russian Federation,1,0,0,1,1960
Gábor Delneky,Hungary,1,0,0,1,1960
Aladár Gerevich,Hungary,1,0,0,1,1960
Pál Kovács,Hungary,1,0,0,1,1960
Tamás Mendelényi,Hungary,1,0,0,1,1960
Fiorenzo Marini,Italy,1,0,0,1,1960
Carlo Pavesi,Italy,1,0,0,1,1960
Gianluigi Saccaro,Italy,1,0,0,1,1960
Mark Midler,Russian Federation,1,0,0,1,1960
Yury Rudov,Russian Federation,1,0,0,1,1960
German Sveshnikov,Russian Federation,1,0,0,1,1960
Andrija Anković,Croatia,1,0,0,1,1960
Vladimir Durković,Serbia,1,0,0,1,1960
Milan Galić,Yugoslavia,1,0,0,1,1960
Fahrudin Jusufi,Kosovo,1,0,0,1,1960
Tomislav Knez,Yugoslavia,1,0,0,1,1960
Bora Kostić,Serbia,1,0,0,1,1960
Aleksandar Kozlina,Yugoslavia,1,0,0,1,1960
Dušan Maravić,Serbia,1,0,0,1,1960
Željko Matuš,Croatia,1,0,0,1,1960
Željko Perušić,Croatia,1,0,0,1,1960
Novak Roganović,Serbia,1,0,0,1,1960
Velimir Sombolac,Yugoslavia,1,0,0,1,1960
Milutin Šoškić,Serbia,1,0,0,1,1960
Silvester Takač,Serbia,1,0,0,1,1960
Blagoja Vidinić,North Macedonia,1,0,0,1,1960
Ante Žanetić,Croatia,1,0,0,1,1960
Lidiya Kalinina-Ivanova,Russian Federation,1,0,0,1,1960
Eugen Ekman,Finland,1,0,0,1,1960
Yukio Endo,Japan,1,0,0,1,1960
Takashi Mitsukuri,Japan,1,0,0,1,1960
András Balczó,Hungary,1,0,0,1,1960
Klaus Bittner,Germany,1,0,0,1,1960
Gerd Cintl,Germany,1,0,0,1,1960
Horst Effertz,Germany,1,0,0,1,1960
Karl-Heinz Hopp,Germany,1,0,0,1,1960
Bernhard Knubel,Germany,1,0,0,1,1960
Hans Lenk,Germany,1,0,0,1,1960
Jürgen Litz,Germany,1,0,0,1,1960
Michael Obst,Germany,1,0,0,1,1960
Willi Padge,Germany,1,0,0,1,1960
Heinz Renneberg,Germany,1,0,0,1,1960
Klaus Riekemann,Germany,1,0,0,1,1960
Manfred Rulffs,Germany,1,0,0,1,1960
Frank Schepke,Germany,1,0,0,1,1960
Kraft Schepke,Germany,1,0,0,1,1960
Walter Schröder,Germany,1,0,0,1,1960
Moritz von Groddeck,Germany,1,0,0,1,1960
Klaus Zerta,Germany,1,0,0,1,1960
Václav Kozák,Czech Republic,1,0,0,1,1960
Pavel Schmidt,Czechoslovakia,1,0,0,1,1960
Valentin Boreyko,Russian Federation,1,0,0,1,1960
Oleg Golovanov,Russian Federation,1,0,0,1,1960
Vyacheslav Ivanov,Russian Federation,1,0,0,1,1960
Dan Ayrault,United States,1,0,0,1,1960
Ted Nash,United States,1,0,0,1,1960
John Sayre,United States,1,0,0,1,1960
Rusty Wailes,United States,1,0,0,1,1960
Hubert Hammerer,Austria,1,0,0,1,1960
Peter Kohnke,Germany,1,0,0,1,1960
Ion Dumitrescu,Romania,1,0,0,1,1960
Aleksey Gushchin,Russian Federation,1,0,0,1,1960
Viktor Shamburkin,Russian Federation,1,0,0,1,1960
Bill McMillan,United States,1,0,0,1,1960
Anita Lonsbrough,Great Britain,1,0,0,1,1960
Patty Kempner,United States,1,0,0,1,1960
Joan Spillane,United States,1,0,0,1,1960
Shirley Stobs,United States,1,0,0,1,1960
Carolyn Wood,United States,1,0,0,1,1960
Dick Blick,United States,1,0,0,1,1960
Paul Hait,United States,1,0,0,1,1960
George Harrison,United States,1,0,0,1,1960
Bill Mulliken,United States,1,0,0,1,1960
Bob Webster,United States,1,0,0,1,1960
Amedeo Ambron,Italy,1,0,0,1,1960
Danio Bardi,Italy,1,0,0,1,1960
Giuseppe D'Altrui,Italy,1,0,0,1,1960
Salvatore Gionta,Italy,1,0,0,1,1960
Giancarlo Guerrini,Italy,1,0,0,1,1960
Franco Lavoratori,Italy,1,0,0,1,1960
Gianni Lonzi,Italy,1,0,0,1,1960
Luigi Mannelli,Italy,1,0,0,1,1960
Rosario Parmegiani,Italy,1,0,0,1,1960
Eraldo Pizzo,Italy,1,0,0,1,1960
Dante Rossi,Italy,1,0,0,1,1960
Brunello Spinelli,Italy,1,0,0,1,1960
Ireneusz Paliński,Poland,1,0,0,1,1960
Viktor Bushuyev,Russian Federation,1,0,0,1,1960
Aleksandr Kurynov,Russian Federation,1,0,0,1,1960
Yevgeny Minayev,Russian Federation,1,0,0,1,1960
Yury Vlasov,Russian Federation,1,0,0,1,1960
Arkady Vorobyov,Russian Federation,1,0,0,1,1960
Chuck Vinci,United States,1,0,0,1,1960
Dimitar Dobrev,Bulgaria,1,0,0,1,1960
Dumitru Pîrvulescu,Romania,1,0,0,1,1960
İsmet Atlı,Turkey,1,0,0,1,1960
Mithat Bayrak,Turkey,1,0,0,1,1960
Ahmet Bilek,Turkey,1,0,0,1,1960
Mustafa Dağıstanlı,Turkey,1,0,0,1,1960
Hasan Güngör,Turkey,1,0,0,1,1960
Tevfik Kış,Turkey,1,0,0,1,1960
Müzahir Sille,Turkey,1,0,0,1,1960
Ivan Bogdan,Soviet Union,1,0,0,1,1960
Oleg Karavayev,Belarus,1,0,0,1,1960
Avtandil Koridze,Georgia,1,0,0,1,1960
Doug Blubaugh,United States,1,0,0,1,1960
Terry McCann,United States,1,0,0,1,1960
Shelby Wilson,United States,1,0,0,1,1960
Bjørn Bergvall,Norway,1,0,0,1,1960
Paul Elvstrøm,Denmark,1,0,0,1,1960
Odyssevs Eskitzoglou,Greece,1,0,0,1,1960
Jim Hunt,United States,1,0,0,1,1960
Crown Prince Konstantinos,Greece,1,0,0,1,1960
"Peder Lunde, Jr.",Norway,1,0,0,1,1960
George O'Day,United States,1,0,0,1,1960
Timir Pinegin,Russian Federation,1,0,0,1,1960
Fyodor Shutkov,Russian Federation,1,0,0,1,1960
Dave Smith,United States,1,0,0,1,1960
Georgios Zaimis,Greece,1,0,0,1,1960
Herb Elliott,Australia,1,0,0,1,1960
Abebe Bikila,Ethiopia,1,0,0,1,1960
Don Thompson,Great Britain,1,0,0,1,1960
Bernd Cullmann,Germany,1,0,0,1,1960
Martin Lauer,Germany,1,0,0,1,1960
Walter Mahlendorf,Germany,1,0,0,1,1960
Livio Berruti,Italy,1,0,0,1,1960
Murray Halberg,New Zealand,1,0,0,1,1960
Peter Snell,New Zealand,1,0,0,1,1960
Zdzisław Krzyszkowiak,Poland,1,0,0,1,1960
Józef Szmidt,Poland,1,0,0,1,1960
Iolanda Balaș,Romania,1,0,0,1,1960
Vera Kalashnikova-Krepkina,Soviet Union,1,0,0,1,1960
Lyudmila Lysenko,Soviet Union,1,0,0,1,1960
Elvīra Ozoliņa,Latvia,1,0,0,1,1960
Irina Press,Russian Federation,1,0,0,1,1960
Nina Romashkova-Ponomaryova,Russian Federation,1,0,0,1,1960
Pyotr Bolotnikov,Russian Federation,1,0,0,1,1960
Vladimir Golubnichy,Soviet Union,1,0,0,1,1960
Vasily Rudenkov,Belarus,1,0,0,1,1960
Robert' Shavlaq'adze,Georgia,1,0,0,1,1960
Viktor Tsybulenko,Soviet Union,1,0,0,1,1960
Martha Hudson,United States,1,0,0,1,1960
Barbara Jones,United States,1,0,0,1,1960
Lucinda Williams,United States,1,0,0,1,1960
Ralph Boston,United States,1,0,0,1,1960
Don Bragg,United States,1,0,0,1,1960
Lee Calhoun,United States,1,0,0,1,1960
Rafer Johnson,United States,1,0,0,1,1960
Bill Nieder,United States,1,0,0,1,1960
Al Oerter,United States,1,0,0,1,1960
Jack Yerman,United States,1,0,0,1,1960
Earl Young,United States,1,0,0,1,1960
Yury Titov,Russian Federation,0,2,1,3,1960
Therese Zenz,Germany,0,2,0,2,1960
György Mészáros,Hungary,0,2,0,2,1960
András Szente,Hungary,0,2,0,2,1960
Imre Szöllősi,Hungary,0,2,0,2,1960
Allan Jay,Great Britain,0,2,0,2,1960
Neville Hayes,Australia,0,2,0,2,1960
Tsuyoshi Yamanaka,Japan,0,2,0,2,1960
Paula Jean Myers-Pope,United States,0,2,0,2,1960
Hans Grodotzki,East Germany,0,2,0,2,1960
Jutta Heine,Germany,0,2,0,2,1960
Carl Kaufmann,Germany,0,2,0,2,1960
Toni Bühler,Switzerland,0,1,1,2,1960
Piero D'Inzeo,Italy,0,1,1,2,1960
Giovanni Carminucci,Italy,0,1,1,2,1960
Vladimir Portnoy,Russian Federation,0,1,1,2,1960
Jan Andrew,Australia,0,1,1,2,1960
Natalie Steward,Great Britain,0,1,1,2,1960
Yoshihiko Osaki,Japan,0,1,1,2,1960
Dorothy Hyman,Great Britain,0,1,1,2,1960
Ike Quartey,Ghana,0,1,0,1,1960
Carmelo Bossi,Italy,0,1,0,1,1960
Sandro Lopopolo,Italy,0,1,0,1,1960
Primo Zamparini,Italy,0,1,0,1,1960
Yury Korneyev,Russian Federation,0,1,0,1,1960
Jānis Krūmiņš,Latvia,0,1,0,1,1960
Guram Minashvili,Georgia,0,1,0,1,1960
Valdis Muižnieks,Latvia,0,1,0,1,1960
Cēzars Ozers,Latvia,0,1,0,1,1960
Aleksandr Petrov,Russian Federation,0,1,0,1,1960
Mikhail Semyonov,Russian Federation,0,1,0,1,1960
Vladimer Ugrekhelidze,Georgia,0,1,0,1,1960
Maigonis Valdmanis,Latvia,0,1,0,1,1960
Albert Valtin,Soviet Union,0,1,0,1,1960
Gennady Volnov,Russian Federation,0,1,0,1,1960
Viktor Zubkov,Russian Federation,0,1,0,1,1960
Jerzy Adamski,Poland,0,1,0,1,1960
Zbigniew Pietrzykowski,Poland,0,1,0,1,1960
Tadeusz Walasek,Poland,0,1,0,1,1960
Daan Bekker,South Africa,0,1,0,1,1960
Yury Radonyak,Russian Federation,0,1,0,1,1960
Sergey Sivko,Russian Federation,0,1,0,1,1960
Ingrid Hartmann,Germany,0,1,0,1,1960
Imre Kemecsey,Hungary,0,1,0,1,1960
Aldo Dezi,Italy,0,1,0,1,1960
Francesco La Macchia,Italy,0,1,0,1,1960
Aleksandr Silayev,Russian Federation,0,1,0,1,1960
Frank Chapot,United States,0,1,0,1,1960
Gustav Fischer,Switzerland,0,1,0,1,1960
Rudolf Günthardt,Switzerland,0,1,0,1,1960
George Morris,United States,0,1,0,1,1960
Rolf Ruff,Switzerland,0,1,0,1,1960
Hans Schwarzenbach,Switzerland,0,1,0,1,1960
Bill Steinkraus,United States,0,1,0,1,1960
Egon Adler,East Germany,0,1,0,1,1960
Bernd Barleben,East Germany,0,1,0,1,1960
Dieter Gieseler,Germany,0,1,0,1,1960
Peter Gröning,East Germany,0,1,0,1,1960
Erich Hagen,East Germany,0,1,0,1,1960
Manfred Klieme,East Germany,0,1,0,1,1960
Siegfried Köhler,East Germany,0,1,0,1,1960
Günter Lörke,East Germany,0,1,0,1,1960
Gustav-Adolf Schur,East Germany,0,1,0,1,1960
Jürgen Simon,East Germany,0,1,0,1,1960
Leo Sterckx,Belgium,0,1,0,1,1960
Lothar Stäber,East Germany,0,1,0,1,1960
Joe Antic,India,0,1,0,1,1960
Leslie Claudius,India,0,1,0,1,1960
Mohinder Lal,India,0,1,0,1,1960
Jaman Lal Sharma,India,0,1,0,1,1960
Shankar Laxman,India,0,1,0,1,1960
V. J. Peter,India,0,1,0,1,1960
Govind Sawant,India,0,1,0,1,1960
Charanjit Singh,India,0,1,0,1,1960
Jaswant Singh,India,0,1,0,1,1960
Gindi Singh,India,0,1,0,1,1960
Prithipal Singh,India,0,1,0,1,1960
Raghbir Singh Bhola,India,0,1,0,1,1960
Udham Singh,India,0,1,0,1,1960
Lídia Dömölky-Sákovics,Hungary,0,1,0,1,1960
Katalin Juhász-Nagy,Hungary,0,1,0,1,1960
Magda Nyári-Kovács,Hungary,0,1,0,1,1960
Ildikó Rejtő-Ujlaky-Sági,Hungary,0,1,0,1,1960
Györgyi Marvalics-Székely,Hungary,0,1,0,1,1960
Michael Alexander,Great Britain,0,1,0,1,1960
Ray Harrison,Great Britain,0,1,0,1,1960
Bill Hoskyns,Great Britain,0,1,0,1,1960
Michael Howard,Great Britain,0,1,0,1,1960
John Pelling,Great Britain,0,1,0,1,1960
Aldo Aureggi,Italy,0,1,0,1,1960
Luigi Carpaneda,Italy,0,1,0,1,1960
Mario Curletto,Italy,0,1,0,1,1960
Marek Kuszewski,Poland,0,1,0,1,1960
Emil Ochyra,Poland,0,1,0,1,1960
Jerzy Pawłowski,Poland,0,1,0,1,1960
Andrzej Piątkowski,Poland,0,1,0,1,1960
Wojciech Zabłocki,Poland,0,1,0,1,1960
Ryszard Zub,Poland,0,1,0,1,1960
Poul Andersen,Denmark,0,1,0,1,1960
John Danielsen,Denmark,0,1,0,1,1960
Henning Enoksen,Denmark,0,1,0,1,1960
Henry From,Denmark,0,1,0,1,1960
Bent Hansen,Denmark,0,1,0,1,1960
Poul Jensen,Denmark,0,1,0,1,1960
Flemming Nielsen,Denmark,0,1,0,1,1960
Hans Christian Nielsen,Denmark,0,1,0,1,1960
Harald Nielsen,Denmark,0,1,0,1,1960
Poul Pedersen,Denmark,0,1,0,1,1960
Jørn Sørensen,Denmark,0,1,0,1,1960
Tommy Troelsen,Denmark,0,1,0,1,1960
Hana Růžičková,Czech Republic,0,1,0,1,1960
Věra Čáslavská,Czech Republic,0,1,0,1,1960
Matylda Matoušková-Šínová,Czech Republic,0,1,0,1,1960
Ludmila Švédová,Czech Republic,0,1,0,1,1960
Adolfína Tkačíková-Tačová,Czech Republic,0,1,0,1,1960
Valery Kerdemelidi,Russian Federation,0,1,0,1,1960
Nikolay Miligulo,Belarus,0,1,0,1,1960
Igor Novikov,Armenia,0,1,0,1,1960
Hanno Selg,Estonia,0,1,0,1,1960
Nikolay Tatarinov,Russian Federation,0,1,0,1,1960
Josef Kloimstein,Austria,0,1,0,1,1960
Alfred Sageder,Austria,0,1,0,1,1960
David Anderson,Canada,0,1,0,1,1960
Don Arnold,Canada,0,1,0,1,1960
Sohen Biln,Canada,0,1,0,1,1960
Walter D'Hondt,Canada,0,1,0,1,1960
Nelson Kuhn,Canada,0,1,0,1,1960
John Lecky,Canada,0,1,0,1,1960
Archie MacKinnon,Canada,0,1,0,1,1960
Bill McKerlich,Canada,0,1,0,1,1960
Glen Mervyn,Canada,0,1,0,1,1960
Robert Dumontois,France,0,1,0,1,1960
Jean Klein,France,0,1,0,1,1960
Claude Martin,France,0,1,0,1,1960
Jacques Morel,France,0,1,0,1,1960
Guy Nosbaum,France,0,1,0,1,1960
Achim Hill,East Germany,0,1,0,1,1960
Tullio Baraglia,Italy,0,1,0,1,1960
Renato Bosatta,Italy,0,1,0,1,1960
Giancarlo Crosta,Italy,0,1,0,1,1960
Giuseppe Galante,Italy,0,1,0,1,1960
Aleksandr Berkutov,Russian Federation,0,1,0,1,1960
Antanas Bagdonavičius,Lithuania,0,1,0,1,1960
Zigmas Jukna,Lithuania,0,1,0,1,1960
Igor Rudakov,Russian Federation,0,1,0,1,1960
Yury Tyukalov,Russian Federation,0,1,0,1,1960
Pentti Linnosvuo,Finland,0,1,0,1,1960
Galliano Rossini,Italy,0,1,0,1,1960
Hansruedi Spillmann,Switzerland,0,1,0,1,1960
Marat Niyazov,Soviet Union,0,1,0,1,1960
Makhmud Umarov,Russian Federation,0,1,0,1,1960
Jim Hill,United States,0,1,0,1,1960
Alva Colquhoun,Australia,0,1,0,1,1960
Lorraine Crapp,Australia,0,1,0,1,1960
Ilsa Konrads,Australia,0,1,0,1,1960
Rosemary Lassig,Australia,0,1,0,1,1960
Marilyn Wilson,Australia,0,1,0,1,1960
Terry Gathercole,Australia,0,1,0,1,1960
Geoff Shipton,Australia,0,1,0,1,1960
Wiltrud Urselmann,Germany,0,1,0,1,1960
Tatsuo Fujimoto,Japan,0,1,0,1,1960
Makoto Fukui,Japan,0,1,0,1,1960
Hiroshi Ishii,Japan,0,1,0,1,1960
Marianne Heemskerk,Netherlands,0,1,0,1,1960
Jane Cederqvist,Sweden,0,1,0,1,1960
Sam Hall,United States,0,1,0,1,1960
Viktor Ageyev,Russian Federation,0,1,0,1,1960
Leri Gogoladze,Georgia,0,1,0,1,1960
Boris Goykhman,Russian Federation,0,1,0,1,1960
Yury Grigorovsky,Russian Federation,0,1,0,1,1960
Anatoly Kartashov,Russian Federation,0,1,0,1,1960
Vyacheslav Kurennoy,Russian Federation,0,1,0,1,1960
P'et're Mshvenieradze,Georgia,0,1,0,1,1960
Vladimir Novikov,Russian Federation,0,1,0,1,1960
Yevgeny Saltsyn,Azerbaijan,0,1,0,1,1960
Vladimir Semyonov,Russian Federation,0,1,0,1,1960
Givi Chikvanaia,Georgia,0,1,0,1,1960
Yoshinobu Miyake,Japan,0,1,0,1,1960
Tiger Tan,Malaysia,0,1,0,1,1960
Trofim Lomakin,Russian Federation,0,1,0,1,1960
Ike Berger,United States,0,1,0,1,1960
Jim Bradford,United States,0,1,0,1,1960
Jim George,United States,0,1,0,1,1960
Tommy Kono,United States,0,1,0,1,1960
Krali Bimbalov,Bulgaria,0,1,0,1,1960
Stancho Ivanov,Bulgaria,0,1,0,1,1960
Nezhdet Zalev,Bulgaria,0,1,0,1,1960
Osman El-Sayed,United Arab Republic,0,1,0,1,1960
Lothar Metz,East Germany,0,1,0,1,1960
Günter Maritschnigg,Germany,0,1,0,1,1960
Imre Polyák,Hungary,0,1,0,1,1960
Gholam Reza Takhti,Islamic Republic of Iran,0,1,0,1,1960
Masayuki Matsubara,Japan,0,1,0,1,1960
Ion Cernea,Romania,0,1,0,1,1960
Hamit Kaplan,Turkey,0,1,0,1,1960
İsmail Oğan,Turkey,0,1,0,1,1960
Vladimir Sinyavsky,Soviet Union,0,1,0,1,1960
Giorgi Skhirt'ladze,Georgia,0,1,0,1,1960
Branko Martinović,Serbia,0,1,0,1,1960
William Berntsen,Denmark,0,1,0,1,1960
Héctor Calegaris,Argentina,0,1,0,1,1960
Steen Christensen,Denmark,0,1,0,1,1960
Jorge Alberto del Río,Argentina,0,1,0,1,1960
Hans Fogh,Canada,0,1,0,1,1960
José Manuel Quina,Portugal,0,1,0,1,1960
Mário Quina,Portugal,0,1,0,1,1960
Søren Hancke,Denmark,0,1,0,1,1960
Ole Gunnar Petersen,Denmark,0,1,0,1,1960
Jorge Alberto Salas,Argentina,0,1,0,1,1960
Aleksander Tšutšelov,Estonia,0,1,0,1,1960
Brenda Jones,Australia,0,1,0,1,1960
Noel Freeman,Australia,0,1,0,1,1960
Roger Moens,Belgium,0,1,0,1,1960
Michel Jazy,France,0,1,0,1,1960
Carole Quinton,Great Britain,0,1,0,1,1960
Dorothy Shirley,Great Britain,0,1,0,1,1960
Johanna Hübner-Lüttge,East Germany,0,1,0,1,1960
Walter Krüger,East Germany,0,1,0,1,1960
Anni Biechl,Germany,0,1,0,1,1960
Brunhilde Hendrix,Germany,0,1,0,1,1960
Martha Langbein-Pensberger,Germany,0,1,0,1,1960
Jo Kaiser,Germany,0,1,0,1,1960
Manfred Kinder,Germany,0,1,0,1,1960
Jochen Reske,Germany,0,1,0,1,1960
Gyula Zsivótzky,Hungary,0,1,0,1,1960
Rhadi Ben Abdesselam,Morocco,0,1,0,1,1960
Elżbieta Duńska-Krzesińska,Poland,0,1,0,1,1960
Jarosława Jóźwiakowska-Bieda,Poland,0,1,0,1,1960
John Ljunggren,Sweden,0,1,0,1,1960
Dana Ingrová-Zátopková,Czech Republic,0,1,0,1,1960
Yang C. K.,Chinese Taipei,0,1,0,1,1960
Leonid Bartenev,Soviet Union,0,1,0,1,1960
Valery Brumel,Russian Federation,0,1,0,1,1960
Vladimir Goryayev,Belarus,0,1,0,1,1960
Yury Konovalov,Azerbaijan,0,1,0,1,1960
Gusman Kosanov,Kazakhstan,0,1,0,1,1960
Edvin Ozolin,Russian Federation,0,1,0,1,1960
Nikolay Sokolov,Russian Federation,0,1,0,1,1960
Rink Babka,United States,0,1,0,1,1960
Les Carney,United States,0,1,0,1,1960
Cliff Cushman,United States,0,1,0,1,1960
Willie May,United States,0,1,0,1,1960
Ron Morris,United States,0,1,0,1,1960
Parry O'Brien,United States,0,1,0,1,1960
Bo Roberson,United States,0,1,0,1,1960
Dave Sime,United States,0,1,0,1,1960
Wladimiro Calarese,Italy,0,0,2,2,1960
Bruno Habārovs,Latvia,0,0,2,2,1960
Franco Menichelli,Italy,0,0,2,2,1960
Bob Beck,United States,0,0,2,2,1960
Ursel Brunner,Germany,0,0,2,2,1960
Peter Radford,Great Britain,0,0,2,2,1960
George Kerr,Jamaica,0,0,2,2,1960
Abdel Moneim El-Gindy,United Arab Republic,0,0,1,1,1960
Jorma Limmonen,Finland,0,0,1,1,1960
Billy Fisher,Great Britain,0,0,1,1,1960
Jim Lloyd,Great Britain,0,0,1,1,1960
Dick McTaggart,Great Britain,0,0,1,1,1960
Günter Siegmund,East Germany,0,0,1,1,1960
Giulio Saraudi,Italy,0,0,1,1,1960
Kiyoshi Tanabe,Japan,0,0,1,1,1960
Abel Laudonio,Argentina,0,0,1,1,1960
Tony Madigan,Australia,0,0,1,1,1960
Wlamir Marques,Brazil,0,0,1,1,1960
Edson Bispo,Brazil,0,0,1,1,1960
Waldemar Blatskauskas,Brazil,0,0,1,1,1960
Moysés Blás,Brazil,0,0,1,1,1960
Algodão,Brazil,0,0,1,1,1960
Rosa Branca,Brazil,0,0,1,1,1960
Mosquito,Brazil,0,0,1,1,1960
Boccardo,Brazil,0,0,1,1,1960
Amaury,Brazil,0,0,1,1,1960
Fernando Brobró,Brazil,0,0,1,1,1960
Sucar,Brazil,0,0,1,1,1960
Jatyr,Brazil,0,0,1,1,1960
Ollie Taylor,Australia,0,0,1,1,1960
Brunon Bendig,Poland,0,0,1,1,1960
Lech Drogosz,Poland,0,0,1,1,1960
Marian Kasprzyk,Poland,0,0,1,1,1960
Ion Monea,Romania,0,0,1,1,1960
William Meyers,South Africa,0,0,1,1,1960
Josef Němec,Czech Republic,0,0,1,1,1960
Yevgeny Feofanov,Russian Federation,0,0,1,1,1960
Boris Lagutin,Russian Federation,0,0,1,1,1960
Quincey Daniels,United States,0,0,1,1,1960
Arne Høyer,Denmark,0,0,1,1,1960
Erling Jessen,Denmark,0,0,1,1,1960
Helmuth Nyborg Sørensen,Denmark,0,0,1,1,1960
Klára Bánfalvi-Fried,Hungary,0,0,1,1,1960
Vilma Egresi,Hungary,0,0,1,1,1960
Imre Farkas,Hungary,0,0,1,1,1960
Daniela Walkowiak-Pilecka,Poland,0,0,1,1,1960
Stefan Kapłaniak,Poland,0,0,1,1,1960
Władysław Zieliński,Poland,0,0,1,1,1960
Leon Rotman,Romania,0,0,1,1,1960
András Törő,Hungary,0,0,1,1,1960
David Broome,Great Britain,0,0,1,1,1960
"Pierre Durand, Sr.",France,0,0,1,1,1960
Jack Le Goff,France,0,0,1,1,1960
Jéhan Le Roy,France,0,0,1,1,1960
Guy Lefrant,France,0,0,1,1,1960
Josef Neckermann,Germany,0,0,1,1,1960
Antonio Oppes,Italy,0,0,1,1,1960
Arnold Belgardt,Russian Federation,0,0,1,1,1960
Valentino Gasparella,Italy,0,0,1,1,1960
Yevgeny Klevtsov,Russian Federation,0,0,1,1,1960
Leonid Kolumbet,Soviet Union,0,0,1,1,1960
Vladimir Leonov,Russian Federation,0,0,1,1,1960
Yury Melikhov,Russian Federation,0,0,1,1,1960
Stanislav Moskvin,Russian Federation,0,0,1,1,1960
Aleksey Petrov,Russian Federation,0,0,1,1,1960
Viktor Romanov,Russian Federation,0,0,1,1,1960
Willy Vanden Berghen,Belgium,0,0,1,1,1960
Rostislav Vargashkin,Russian Federation,0,0,1,1,1960
Boris Vasilyev,Russian Federation,0,0,1,1,1960
Pedro Amat,Spain,0,0,1,1,1960
Francisco Cavaller,Spain,0,0,1,1,1960
Juan Ángel Calzado,Spain,0,0,1,1,1960
José Colomer,Spain,0,0,1,1,1960
Carlos del Coso,Spain,0,0,1,1,1960
José Antonio Dinarés,Spain,0,0,1,1,1960
Eduardo Dualde,Spain,0,0,1,1,1960
Joaquín Dualde,Spain,0,0,1,1,1960
Rafael Egusquiza,Spain,0,0,1,1,1960
Ignacio Macaya,Spain,0,0,1,1,1960
Pedro Murua,Spain,0,0,1,1,1960
Pedro Roig,Spain,0,0,1,1,1960
Luis María Usoz,Spain,0,0,1,1,1960
Narciso Ventalló,Spain,0,0,1,1,1960
Irene Camber-Corno,Italy,0,0,1,1,1960
Velleda Cesari,Italy,0,0,1,1,1960
Bruna Colombetti-Peroncini,Italy,0,0,1,1,1960
Claudia Pasini,Italy,0,0,1,1,1960
Antonella Ragno-Lonzi,Italy,0,0,1,1,1960
Maria Vicol,Romania,0,0,1,1,1960
Jürgen Brecht,Germany,0,0,1,1,1960
Tim Gerresheim,Germany,0,0,1,1,1960
Eberhard Mehl,Germany,0,0,1,1,1960
Jürgen Theuerkauff,Germany,0,0,1,1,1960
Giampaolo Calanchini,Italy,0,0,1,1,1960
Pierluigi Chicca,Italy,0,0,1,1,1960
Roberto Ferrari,Italy,0,0,1,1,1960
Mario Ravagnan,Italy,0,0,1,1,1960
Guram Kostava,Georgia,0,0,1,1,1960
Aleksandr Pavlovsky,Belarus,0,0,1,1,1960
Valentin Chernikov,Armenia,0,0,1,1,1960
Arnold Chernushevich,Belarus,0,0,1,1,1960
Albie Axelrod,United States,0,0,1,1,1960
Flórián Albert,Hungary,0,0,1,1,1960
Jenő Dalnoki,Hungary,0,0,1,1,1960
Zoltán Dudás,Hungary,0,0,1,1,1960
János Dunai,Hungary,0,0,1,1,1960
Lajos Faragó,Hungary,0,0,1,1,1960
János Göröcs,Hungary,0,0,1,1,1960
Ferenc Kovács,Hungary,0,0,1,1,1960
Dezső Novák,Hungary,0,0,1,1,1960
Pál Orosz,Hungary,0,0,1,1,1960
Tibor Pál,Hungary,0,0,1,1,1960
Gyula Rákosi,Hungary,0,0,1,1,1960
Imre Sátori,Hungary,0,0,1,1,1960
Ernő Solymosi,Hungary,0,0,1,1,1960
Gábor Török,Hungary,0,0,1,1,1960
Pál Várhidi,Hungary,0,0,1,1,1960
Oszkár Vilezsál,Hungary,0,0,1,1,1960
Atanasia Ionescu,Romania,0,0,1,1,1960
Sonia Iovan-Inovan,Romania,0,0,1,1,1960
Elena Leuștean-Popescu,Romania,0,0,1,1,1960
Elena Mărgărit-Niculeșcu,Romania,0,0,1,1,1960
Uta Poreceanu,Romania,0,0,1,1,1960
Emilia Vătășoiu-Liță,Romania,0,0,1,1,1960
Velik Kapsazov,Bulgaria,0,0,1,1,1960
Pasquale Carminucci,Italy,0,0,1,1,1960
Gianfranco Marzolla,Italy,0,0,1,1,1960
Orlando Polmonari,Italy,0,0,1,1,1960
Angelo Vicardi,Italy,0,0,1,1,1960
Jack Daniels,United States,0,0,1,1,1960
George Lambert,United States,0,0,1,1,1960
Veli Lehtelä,Finland,0,0,1,1,1960
Toimi Pitkänen,Finland,0,0,1,1,1960
Fulvio Balatti,Italy,0,0,1,1,1960
Romano Sgheiz,Italy,0,0,1,1,1960
Ivo Stefanoni,Italy,0,0,1,1,1960
Franco Trincavelli,Italy,0,0,1,1,1960
Giovanni Zucchi,Italy,0,0,1,1,1960
Teodor Kocerka,Poland,0,0,1,1,1960
Ernst Hürlimann,Switzerland,0,0,1,1,1960
Rolf Larcher,Switzerland,0,0,1,1,1960
Bohumil Janoušek,Czech Republic,0,0,1,1,1960
Jan Jindra,Czech Republic,0,0,1,1,1960
Miroslav Koníček,Czech Republic,0,0,1,1,1960
Jiří Lundák,Czech Republic,0,0,1,1,1960
Stanislav Lusk,Czech Republic,0,0,1,1,1960
Václav Pafkovič,Czech Republic,0,0,1,1,1960
Luděk Pojezný,Czech Republic,0,0,1,1,1960
Jan Švéda,Czech Republic,0,0,1,1,1960
Josef Věntus,Czech Republic,0,0,1,1,1960
Igor Akhremchik,Russian Federation,0,0,1,1,1960
Yury Bachurov,Russian Federation,0,0,1,1,1960
Valentin Morkovkin,Russian Federation,0,0,1,1,1960
Anatoly Tarabrin,Russian Federation,0,0,1,1,1960
Dick Draeger,United States,0,0,1,1,1960
Conn Findlay,United States,0,0,1,1,1960
Kent Mitchell,United States,0,0,1,1,1960
Klaus Zähringer,Germany,0,0,1,1,1960
Yoshihisa Yoshikawa,Japan,0,0,1,1,1960
Vasily Borisov,Russian Federation,0,0,1,1,1960
Sergey Kalinin,Russian Federation,0,0,1,1,1960
Aleksandr Zabelin,Russian Federation,0,0,1,1,1960
Enrico Forcella,Venezuela,0,0,1,1,1960
David Dickson,Australia,0,0,1,1,1960
Manuel dos Santos,Brazil,0,0,1,1,1960
Liz Ferris,Great Britain,0,0,1,1,1960
Brian Phelps,Great Britain,0,0,1,1,1960
Bärbel Fuhrmann,East Germany,0,0,1,1,1960
Barbara Göbel,East Germany,0,0,1,1,1960
Ursula Küper,East Germany,0,0,1,1,1960
Heidi Pechstein,East Germany,0,0,1,1,1960
Ingrid Schmidt,East Germany,0,0,1,1,1960
Christel Steffin,East Germany,0,0,1,1,1960
Gisela Weiß,East Germany,0,0,1,1,1960
Satoko Tanaka,Japan,0,0,1,1,1960
Koichi Hirakida,Japan,0,0,1,1,1960
Keigo Shimizu,Japan,0,0,1,1,1960
Kazuo Tomita,Japan,0,0,1,1,1960
Juan Botella,Mexico,0,0,1,1,1960
Tineke Lagerberg,Netherlands,0,0,1,1,1960
Wieger Mensonides,Netherlands,0,0,1,1,1960
Ninel Krutova,Russian Federation,0,0,1,1,1960
Bob Bennett,United States,0,0,1,1,1960
George Breen,United States,0,0,1,1,1960
Dave Gillanders,United States,0,0,1,1,1960
András Bodnár,Hungary,0,0,1,1,1960
Ottó Boros,Hungary,0,0,1,1,1960
Zoltán Dömötör,Hungary,0,0,1,1,1960
László Felkai,Hungary,0,0,1,1,1960
Dezső Gyarmati,Hungary,0,0,1,1,1960
István Hevesi,Hungary,0,0,1,1,1960
László Jeney,Hungary,0,0,1,1,1960
Tivadar Kanizsa,Hungary,0,0,1,1,1960
György Kárpáti,Hungary,0,0,1,1,1960
András Katona,Hungary,0,0,1,1,1960
János Konrád,Hungary,0,0,1,1,1960
Kálmán Markovits,Hungary,0,0,1,1,1960
Mihály Mayer,Hungary,0,0,1,1,1960
Péter Rusorán,Hungary,0,0,1,1,1960
Louis Martin,Great Britain,0,0,1,1,1960
Győző Veres,Hungary,0,0,1,1,1960
Ismail Elm Khah,Islamic Republic of Iran,0,0,1,1,1960
Abdul Wahid Aziz,Iraq,0,0,1,1,1960
Sebastiano Mannironi,Italy,0,0,1,1,1960
Jan Bochenek,Poland,0,0,1,1,1960
Norb Schemansky,United States,0,0,1,1,1960
Dinko Petrov,Bulgaria,0,0,1,1,1960
Enyu Valchev,Bulgaria,0,0,1,1,1960
René Schiermeyer,France,0,0,1,1,1960
Mohamed Paziraie,Islamic Republic of Iran,0,0,1,1,1960
Ibrahim Seifpour,Islamic Republic of Iran,0,0,1,1,1960
Muhammad Bashir,Pakistan,0,0,1,1,1960
Tadeusz Trojanowski,Poland,0,0,1,1,1960
Ion Țăranu,Romania,0,0,1,1,1960
Hans Antonsson,Sweden,0,0,1,1,1960
Gustav Freij,Sweden,0,0,1,1,1960
Bohumil Kubát,Czech Republic,0,0,1,1,1960
Anatoly Albul,Russian Federation,0,0,1,1,1960
Savkuz Dzarasov,Russian Federation,0,0,1,1,1960
Givi K'art'ozia,Georgia,0,0,1,1,1960
Vladimer Rubashvili,Georgia,0,0,1,1,1960
Konstantin Vyrupayev,Russian Federation,0,0,1,1,1960
Antonio Ciciliano,Italy,0,0,1,1,1960
Henri Copponex,Switzerland,0,0,1,1,1960
Antonio Cosentino,Italy,0,0,1,1,1960
Giulio De Stefano,Italy,0,0,1,1,1960
Pierre Girard,Switzerland,0,0,1,1,1960
Bob Halperin,United States,0,0,1,1,1960
Manfred Metzger,Switzerland,0,0,1,1,1960
Rolf Mulka,Germany,0,0,1,1,1960
André Nelis,Belgium,0,0,1,1,1960
Bill Parks,United States,0,0,1,1,1960
Ingo von Bredow,Germany,0,0,1,1,1960
Dave Power,Australia,0,0,1,1,1960
Jim Wedderburn,Barbados,0,0,1,1,1960
Eeles Landström,Finland,0,0,1,1,1960
Abdou Sèye,France,0,0,1,1,1960
David Jones,Great Britain,0,0,1,1,1960
David Segal,Great Britain,0,0,1,1,1960
Stan Vickers,Great Britain,0,0,1,1,1960
Nick Whitehead,Great Britain,0,0,1,1,1960
Hildrun Laufer-Claus,East Germany,0,0,1,1,1960
Ulla Donath,East Germany,0,0,1,1,1960
Gisela Köhler-Birkemeyer,East Germany,0,0,1,1,1960
Halina Richter-Górecka-Herrmann,Poland,0,0,1,1,1960
Gergely Kulcsár,Hungary,0,0,1,1,1960
István Rózsavölgyi,Hungary,0,0,1,1,1960
Giuseppina Leone,Italy,0,0,1,1,1960
Abdon Pamich,Italy,0,0,1,1,1960
Keith Gardner,Jamaica,0,0,1,1,1960
Mal Spence,Jamaica,0,0,1,1,1960
Barry Magee,New Zealand,0,0,1,1,1960
Celina Jesionowska,Poland,0,0,1,1,1960
Barbara Lerczak-Janiszewska-Sobotta,Poland,0,0,1,1,1960
Teresa Ciepły-Wieczorek,Poland,0,0,1,1,1960
Tadeusz Rut,Poland,0,0,1,1,1960
Kazimierz Zimny,Poland,0,0,1,1,1960
Lia Manoliu,Romania,0,0,1,1,1960
Malcolm Spence,South Africa,0,0,1,1,1960
Birutė Kalėdienė,Lithuania,0,0,1,1,1960
Vitold Kreyer,Russian Federation,0,0,1,1,1960
Vasily Kuznetsov,Russian Federation,0,0,1,1,1960
Semyon Rzhishchin,Russian Federation,0,0,1,1,1960
Igor Ter-Ovanesyan,Russian Federation,0,0,1,1,1960
Earlene Brown,United States,0,0,1,1,1960
Dick Cochran,United States,0,0,1,1,1960
Dick Howard,United States,0,0,1,1,1960
Hayes Jones,United States,0,0,1,1,1960
Dallas Long,United States,0,0,1,1,1960
John Thomas,United States,0,0,1,1,1960
Achim Kadelbach,Germany,0,0,1,1,1960
Don Schollander,United States,4,0,0,4,1964
Věra Čáslavská,Czech Republic,3,1,0,4,1964
Yukio Endo,Japan,3,1,0,4,1964
Sharon Stouder,United States,3,1,0,4,1964
Steve Clark,United States,3,0,0,3,1964
Larisa Latynina,Soviet Union,2,2,2,6,1964
Polina Astakhova,Soviet Union,2,1,1,4,1964
Kathy Ellis,United States,2,0,2,4,1964
Mauro Checcoli,Italy,2,0,0,2,1964
Ildikó Rejtő-Ujlaky-Sági,Hungary,2,0,0,2,1964
Takuji Hayata,Japan,2,0,0,2,1964
Haruhiro Yamashita,Japan,2,0,0,2,1964
Donna de Varona,United States,2,0,0,2,1964
Cathy Ferguson,United States,2,0,0,2,1964
Gary Ilman,United States,2,0,0,2,1964
Peter Snell,New Zealand,2,0,0,2,1964
Tamara Press,Russian Federation,2,0,0,2,1964
Henry Carr,United States,2,0,0,2,1964
Bob Hayes,United States,2,0,0,2,1964
Mike Larrabee,United States,2,0,0,2,1964
Shuji Tsurumi,Japan,1,3,0,4,1964
Boris Shakhlin,Soviet Union,1,2,1,4,1964
Irena Kirszenstein-Szewińska,Poland,1,2,0,3,1964
Edith McGuire,United States,1,2,0,3,1964
Franco Menichelli,Italy,1,1,1,3,1964
Mary Bignal-Rand,Great Britain,1,1,1,3,1964
Harry Boldt,Germany,1,1,0,2,1964
Henri Chammartin,Switzerland,1,1,0,2,1964
Pierre Jonquères d'Oriola,France,1,1,0,2,1964
Hermann Schridde,Germany,1,1,0,2,1964
Sergio Bianchetto,Italy,1,1,0,2,1964
Giovanni Pettenella,Italy,1,1,0,2,1964
Egon Franke,Poland,1,1,0,2,1964
Tamara Manina,Russian Federation,1,1,0,2,1964
Igor Novikov,Armenia,1,1,0,2,1964
Lones Wigger,United States,1,1,0,2,1964
Dawn Fraser,Australia,1,1,0,2,1964
Ingrid Gulbin-Engel-Krämer,East Germany,1,1,0,2,1964
Roy Saari,United States,1,1,0,2,1964
Ann Packer,Great Britain,1,1,0,2,1964
Teresa Ciepły-Wieczorek,Poland,1,1,0,2,1964
Wyomia Tyus,United States,1,1,0,2,1964
Paul Drayton,United States,1,1,0,2,1964
Umyar Mavlikhanov,Russian Federation,1,0,1,2,1964
Miroslav Cerar,Slovenia,1,0,1,2,1964
Ferenc Török,Hungary,1,0,1,2,1964
Albert Mokeyev,Russian Federation,1,0,1,2,1964
László Hammerl,Hungary,1,0,1,2,1964
Kevin Berry,Australia,1,0,1,2,1964
Ian O'Brien,Australia,1,0,1,2,1964
Bob Windle,Australia,1,0,1,2,1964
Ginny Duenkel,United States,1,0,1,2,1964
Fred Schmidt,United States,1,0,1,2,1964
Ewa Kłobukowska,Poland,1,0,1,2,1964
Fernando Atzori,Italy,1,0,0,1,1964
Cosimo Pinto,Italy,1,0,0,1,1964
Takao Sakurai,Japan,1,0,0,1,1964
Jim Barnes,United States,1,0,0,1,1964
Bill Bradley,United States,1,0,0,1,1964
Larry Brown,United States,1,0,0,1,1964
Joe Caldwell,United States,1,0,0,1,1964
Mel Counts,United States,1,0,0,1,1964
Dick Davies,United States,1,0,0,1,1964
Walt Hazzard,United States,1,0,0,1,1964
Luke Jackson,United States,1,0,0,1,1964
Pete McCaffrey,United States,1,0,0,1,1964
Jeff Mullins,United States,1,0,0,1,1964
Jerry Shipp,United States,1,0,0,1,1964
Jiff Wilson,United States,1,0,0,1,1964
Józef Grudzień,Poland,1,0,0,1,1964
Marian Kasprzyk,Poland,1,0,0,1,1964
Jerzy Kulej,Poland,1,0,0,1,1964
Boris Lagutin,Russian Federation,1,0,0,1,1964
Valery Popenchenko,Russian Federation,1,0,0,1,1964
Stanislav Stepashkin,Russian Federation,1,0,0,1,1964
Joe Frazier,United States,1,0,0,1,1964
Jürgen Eschert,East Germany,1,0,0,1,1964
Roswitha Esser,Germany,1,0,0,1,1964
Annemarie Zimmermann,Germany,1,0,0,1,1964
Rolf Peterson,Sweden,1,0,0,1,1964
Sven-Olov Sjödelius,Sweden,1,0,0,1,1964
Gunnar Utterberg,Sweden,1,0,0,1,1964
Lyudmila Khvedosyuk-Pinayeva,Russian Federation,1,0,0,1,1964
Anatoly Grishin,Russian Federation,1,0,0,1,1964
Vyacheslav Ionov,Russian Federation,1,0,0,1,1964
Andrey Khimich,Soviet Union,1,0,0,1,1964
Vladimir Morozov,Soviet Union,1,0,0,1,1964
Stepan Oshchepkov,Russian Federation,1,0,0,1,1964
Nikolay Chuzhikov,Soviet Union,1,0,0,1,1964
Paolo Angioni,Italy,1,0,0,1,1964
Alessandro Argenton,Italy,1,0,0,1,1964
Kurt Jarasinski,Germany,1,0,0,1,1964
Reiner Klimke,Germany,1,0,0,1,1964
Josef Neckermann,Germany,1,0,0,1,1964
Giuseppe Ravano,Italy,1,0,0,1,1964
Hans Günter Winkler,Germany,1,0,0,1,1964
Lothar Claesges,Germany,1,0,0,1,1964
Jiří Daler,Czech Republic,1,0,0,1,1964
Angelo Damiano,Italy,1,0,0,1,1964
Eef Dolman,Netherlands,1,0,0,1,1964
Karl-Heinz Henrichs,Germany,1,0,0,1,1964
Gerben Karstens,Netherlands,1,0,0,1,1964
Karl Link,Germany,1,0,0,1,1964
Jan Pieterse,Netherlands,1,0,0,1,1964
Patrick Sercu,Belgium,1,0,0,1,1964
Ernst Streng,Germany,1,0,0,1,1964
Mario Zanin,Italy,1,0,0,1,1964
Bart Zoet,Netherlands,1,0,0,1,1964
Hari Pal Kaushik,India,1,0,0,1,1964
Mohinder Lal,India,1,0,0,1,1964
Shankar Laxman,India,1,0,0,1,1964
Bandu Patil,India,1,0,0,1,1964
V. J. Peter,India,1,0,0,1,1964
Syed Mushtaq Ali,India,1,0,0,1,1964
Charanjit Singh,India,1,0,0,1,1964
Darshan Singh,India,1,0,0,1,1964
Dharam Singh,India,1,0,0,1,1964
Gurbux Singh,India,1,0,0,1,1964
Harbinder Singh,India,1,0,0,1,1964
Jagjit Singh,India,1,0,0,1,1964
Gindi Singh,India,1,0,0,1,1964
Prithipal Singh,India,1,0,0,1,1964
Udham Singh,India,1,0,0,1,1964
Judit Ágoston-Mendelényi,Hungary,1,0,0,1,1964
Lídia Dömölky-Sákovics,Hungary,1,0,0,1,1964
Katalin Juhász-Nagy,Hungary,1,0,0,1,1964
Paula Marosi,Hungary,1,0,0,1,1964
Árpád Bárány,Hungary,1,0,0,1,1964
Tamás Gábor,Hungary,1,0,0,1,1964
István Kausz,Hungary,1,0,0,1,1964
Győző Kulcsár,Hungary,1,0,0,1,1964
Zoltán Nemere,Hungary,1,0,0,1,1964
Tibor Pézsa,Hungary,1,0,0,1,1964
Nugzar Asatiani,Georgia,1,0,0,1,1964
Grigory Kriss,Soviet Union,1,0,0,1,1964
Boris Melnikov,Russian Federation,1,0,0,1,1964
Mark Midler,Russian Federation,1,0,0,1,1964
Mark Rakita,Russian Federation,1,0,0,1,1964
Yakov Rylsky,Russian Federation,1,0,0,1,1964
Yury Sisikin,Russian Federation,1,0,0,1,1964
Yury Sharov,Russian Federation,1,0,0,1,1964
Viktor Zhdanovich,Russian Federation,1,0,0,1,1964
German Sveshnikov,Russian Federation,1,0,0,1,1964
Ferenc Bene,Hungary,1,0,0,1,1964
Tibor Csernai,Hungary,1,0,0,1,1964
János Farkas,Hungary,1,0,0,1,1964
József Gelei,Hungary,1,0,0,1,1964
Kálmán Ihász,Hungary,1,0,0,1,1964
Sándor Katona,Hungary,1,0,0,1,1964
Imre Komora,Hungary,1,0,0,1,1964
Ferenc Nógrádi,Hungary,1,0,0,1,1964
Dezső Novák,Hungary,1,0,0,1,1964
Árpád Orbán,Hungary,1,0,0,1,1964
Károly Palotai,Hungary,1,0,0,1,1964
Antal Szentmihályi,Hungary,1,0,0,1,1964
Gusztáv Szepesi,Hungary,1,0,0,1,1964
Zoltán Varga,Hungary,1,0,0,1,1964
Lyudmila Gromova,Russian Federation,1,0,0,1,1964
Tamara Lyukhina-Zamotaylova,Russian Federation,1,0,0,1,1964
Yelena Volchetskaya,Belarus,1,0,0,1,1964
Takashi Mitsukuri,Japan,1,0,0,1,1964
Takashi Ono,Japan,1,0,0,1,1964
Anton Geesink,Netherlands,1,0,0,1,1964
Isao Inokuma,Japan,1,0,0,1,1964
Takehide Nakatani,Japan,1,0,0,1,1964
Isao Okano,Japan,1,0,0,1,1964
Viktor Mineyev,Azerbaijan,1,0,0,1,1964
George Hungerford,Canada,1,0,0,1,1964
Roger Jackson,Canada,1,0,0,1,1964
John Ørsted Hansen,Denmark,1,0,0,1,1964
Bjørn Borgen Hasløv,Denmark,1,0,0,1,1964
Kurt Helmudt,Denmark,1,0,0,1,1964
Erik Petersen,Denmark,1,0,0,1,1964
Bernhard Britting,Germany,1,0,0,1,1964
Egbert Hirschfelder,Germany,1,0,0,1,1964
Peter Neusel,Germany,1,0,0,1,1964
Jürgen Oelke,Germany,1,0,0,1,1964
Joachim Werner,Germany,1,0,0,1,1964
Boris Dubrovsky,Russian Federation,1,0,0,1,1964
Vyacheslav Ivanov,Russian Federation,1,0,0,1,1964
Oleg Tyurin,Russian Federation,1,0,0,1,1964
Joe Amlong,United States,1,0,0,1,1964
Tom Amlong,United States,1,0,0,1,1964
Boyce Budd,United States,1,0,0,1,1964
Emory Clark,United States,1,0,0,1,1964
Stan Cwiklinski,United States,1,0,0,1,1964
Ed Ferry,United States,1,0,0,1,1964
Conn Findlay,United States,1,0,0,1,1964
Hugh Foley,United States,1,0,0,1,1964
Bill Knecht,United States,1,0,0,1,1964
Kent Mitchell,United States,1,0,0,1,1964
Róbert Zimonyi,Hungary,1,0,0,1,1964
Pentti Linnosvuo,Finland,1,0,0,1,1964
Väinö Markkanen,Finland,1,0,0,1,1964
Ennio Mattarelli,Italy,1,0,0,1,1964
Gary Anderson,United States,1,0,0,1,1964
Miklós Ambrus,Hungary,1,0,0,1,1964
Galina Prozumenshchikova-Stepanova,Soviet Union,1,0,0,1,1964
Lesley Bush,United States,1,0,0,1,1964
Cynthia Goyette,United States,1,0,0,1,1964
Pokey Watson,United States,1,0,0,1,1964
Mike Austin,United States,1,0,0,1,1964
Bill Craig,United States,1,0,0,1,1964
Jed Graef,United States,1,0,0,1,1964
Thompson Mann,United States,1,0,0,1,1964
Dick Roth,United States,1,0,0,1,1964
Ken Sitzberger,United States,1,0,0,1,1964
Bob Webster,United States,1,0,0,1,1964
Yuriko Handa,Japan,1,0,0,1,1964
Sata Isobe,Japan,1,0,0,1,1964
Masae Kasai,Japan,1,0,0,1,1964
Katsumi Matsumura,Japan,1,0,0,1,1964
Yoshiko Matsumura,Japan,1,0,0,1,1964
Emiko Miyamoto,Japan,1,0,0,1,1964
Setsuko Sasaki,Japan,1,0,0,1,1964
Ayano Shibuki,Japan,1,0,0,1,1964
Yoko Shinozaki,Japan,1,0,0,1,1964
Kinuko Tanida,Japan,1,0,0,1,1964
Ivans Bugajenkovs,Latvia,1,0,0,1,1964
Nikolay Burobin,Russian Federation,1,0,0,1,1964
Valery Kalachikhin,Russian Federation,1,0,0,1,1964
Vazha K'ach'arava,Georgia,1,0,0,1,1964
Vitaly Kovalenko,Russian Federation,1,0,0,1,1964
Georgy Mondzolevsky,Russian Federation,1,0,0,1,1964
Yury Poyarkov,Soviet Union,1,0,0,1,1964
Eduard Sibiryakov,Russian Federation,1,0,0,1,1964
Yury Chesnokov,Russian Federation,1,0,0,1,1964
Yury Vengerovsky,Soviet Union,1,0,0,1,1964
Dmitry Voskoboynikov,Russian Federation,1,0,0,1,1964
András Bodnár,Hungary,1,0,0,1,1964
Ottó Boros,Hungary,1,0,0,1,1964
Zoltán Dömötör,Hungary,1,0,0,1,1964
László Felkai,Hungary,1,0,0,1,1964
Dezső Gyarmati,Hungary,1,0,0,1,1964
Tivadar Kanizsa,Hungary,1,0,0,1,1964
György Kárpáti,Hungary,1,0,0,1,1964
János Konrád,Hungary,1,0,0,1,1964
Mihály Mayer,Hungary,1,0,0,1,1964
Dénes Pócsik,Hungary,1,0,0,1,1964
Péter Rusorán,Hungary,1,0,0,1,1964
Yoshinobu Miyake,Japan,1,0,0,1,1964
Waldemar Baszanowski,Poland,1,0,0,1,1964
Hans Zdražila,Czech Republic,1,0,0,1,1964
Vladimir Golovanov,Russian Federation,1,0,0,1,1964
Rudolf Plyukfelder,Russian Federation,1,0,0,1,1964
Leonid Zhabotinsky,Soviet Union,1,0,0,1,1964
Aleksey Vakhonin,Russian Federation,1,0,0,1,1964
Prodan Gardzhev,Bulgaria,1,0,0,1,1964
Boyan Radev,Bulgaria,1,0,0,1,1964
Enyu Valchev,Bulgaria,1,0,0,1,1964
István Kozma,Hungary,1,0,0,1,1964
Imre Polyák,Hungary,1,0,0,1,1964
Tsutomu Hanahara,Japan,1,0,0,1,1964
Masamitsu Ichiguchi,Japan,1,0,0,1,1964
Yojiro Uetake,Japan,1,0,0,1,1964
Osamu Watanabe,Japan,1,0,0,1,1964
Yoshikatsu Yoshida,Japan,1,0,0,1,1964
Kazım Ayvaz,Turkey,1,0,0,1,1964
İsmail Oğan,Turkey,1,0,0,1,1964
Aleksandr Ivanitsky,Russian Federation,1,0,0,1,1964
Anatoly Kolesov,Kazakhstan,1,0,0,1,1964
Aliaksandr Miadved,Belarus,1,0,0,1,1964
Branislav Simić,Serbia,1,0,0,1,1964
Ole Berntsen,Denmark,1,0,0,1,1964
Cecil Cooke,The Bahamas,1,0,0,1,1964
Durward Knowles,Great Britain,1,0,0,1,1964
Willi Kuhweide,Germany,1,0,0,1,1964
Bill Northam,Australia,1,0,0,1,1964
Peter O'Donnell,Australia,1,0,0,1,1964
Helmer Pedersen,New Zealand,1,0,0,1,1964
Ole Poulsen,Denmark,1,0,0,1,1964
Dick Sargeant,Australia,1,0,0,1,1964
Christian Robert von Bülow,Denmark,1,0,0,1,1964
Earle Wells,New Zealand,1,0,0,1,1964
Betty Cuthbert,Australia,1,0,0,1,1964
Gaston Roelants,Belgium,1,0,0,1,1964
Abebe Bikila,Ethiopia,1,0,0,1,1964
Pauli Nevala,Finland,1,0,0,1,1964
Lynn Davies,Great Britain,1,0,0,1,1964
Ken Matthews,Great Britain,1,0,0,1,1964
Karin Richert-Balzer,East Germany,1,0,0,1,1964
Halina Richter-Górecka-Herrmann,Poland,1,0,0,1,1964
Willi Holdorf,Germany,1,0,0,1,1964
Abdon Pamich,Italy,1,0,0,1,1964
Józef Szmidt,Poland,1,0,0,1,1964
Iolanda Balaș,Romania,1,0,0,1,1964
Mihaela Peneș,Romania,1,0,0,1,1964
Irina Press,Russian Federation,1,0,0,1,1964
Valery Brumel,Russian Federation,1,0,0,1,1964
Romuald Klim,Belarus,1,0,0,1,1964
Gerry Ashworth,United States,1,0,0,1,1964
Ollan Cassell,United States,1,0,0,1,1964
Rex Cawley,United States,1,0,0,1,1964
Fred Hansen,United States,1,0,0,1,1964
Hayes Jones,United States,1,0,0,1,1964
Dallas Long,United States,1,0,0,1,1964
Billy Mills,United States,1,0,0,1,1964
Al Oerter,United States,1,0,0,1,1964
Bob Schul,United States,1,0,0,1,1964
Dick Stebbins,United States,1,0,0,1,1964
Ulis Williams,United States,1,0,0,1,1964
Bill Stowe,United States,1,0,0,1,1964
Yoko Fujimoto,Japan,1,0,0,1,1964
Masako Kondo,Japan,1,0,0,1,1964
Viktor Lisitsky,Russian Federation,0,4,0,4,1964
Hans-Joachim Klein,Germany,0,3,1,4,1964
Frank Wiegand,East Germany,0,3,0,3,1964
Yury Titov,Russian Federation,0,2,0,2,1964
Horst-Günter Gregor,East Germany,0,2,0,2,1964
Ada Kok,Netherlands,0,2,0,2,1964
John Cooper,Great Britain,0,2,0,2,1964
Holger Zander,Germany,0,1,1,2,1964
Hilde Lauer,Romania,0,1,1,2,1964
Helga Volz-Mees,Germany,0,1,1,2,1964
Jean-Claude Magnan,France,0,1,1,2,1964
Yury Tsapenko,Russian Federation,0,1,1,2,1964
Gerhard Hetz,Germany,0,1,1,2,1964
Erica Terpstra,Netherlands,0,1,1,2,1964
Wendell Mottley,Trinidad and Tobago,0,1,1,2,1964
Joseph Gonzales,France,0,1,0,1,1964
Hans Huber,Germany,0,1,0,1,1964
Emil Schulz,Germany,0,1,0,1,1964
Jeong Sin-Jo,Republic of Korea,0,1,0,1,1964
Armenak Alachachyan,Armenia,0,1,0,1,1964
Nikolay Bagley,Soviet Union,0,1,0,1,1964
Juris Kalniņš,Latvia,0,1,0,1,1964
Yury Korneyev,Russian Federation,0,1,0,1,1964
Jānis Krūmiņš,Latvia,0,1,0,1,1964
Vyacheslav Khrynin,Russian Federation,0,1,0,1,1964
Jaak Lipso,Estonia,0,1,0,1,1964
Levan Moseshvili,Georgia,0,1,0,1,1964
Valdis Muižnieks,Latvia,0,1,0,1,1964
Aleksandr Petrov,Russian Federation,0,1,0,1,1964
Aleksandr Travin,Russian Federation,0,1,0,1,1964
Gennady Volnov,Russian Federation,0,1,0,1,1964
Anthony Villanueva,Philippines,0,1,0,1,1964
Artur Olech,Poland,0,1,0,1,1964
Vilikton Barannikov,Russian Federation,0,1,0,1,1964
Yevgeny Frolov,Russian Federation,0,1,0,1,1964
Aleksey Kiselyov,Russian Federation,0,1,0,1,1964
Ričardas Tamulis,Lithuania,0,1,0,1,1964
Paul Hoekstra,Belgium,0,1,0,1,1964
Jean Boudehen,France,0,1,0,1,1964
Michel Chapuis,France,0,1,0,1,1964
Günter Perleberg,Germany,0,1,0,1,1964
Berni Schulze,Germany,0,1,0,1,1964
Friedhelm Wentzke,Germany,0,1,0,1,1964
Mihály Hesz,Hungary,0,1,0,1,1964
Toon Geurts,Netherlands,0,1,0,1,1964
Andrei Igorov,Romania,0,1,0,1,1964
Francine Fox,United States,0,1,0,1,1964
Glo Perrier,United States,0,1,0,1,1964
Lana du Pont,United States,0,1,0,1,1964
Marianne Gossweiler,Switzerland,0,1,0,1,1964
Janou Lefèbvre,France,0,1,0,1,1964
Gustav Fischer,Switzerland,0,1,0,1,1964
Kevin Freeman,United States,0,1,0,1,1964
Guy Lefrant,France,0,1,0,1,1964
Carlos Moratorio,Argentina,0,1,0,1,1964
Michael Page,United States,0,1,0,1,1964
J. Michael Plumb,United States,0,1,0,1,1964
Severino Andreoli,Italy,0,1,0,1,1964
Imants Bodnieks,Latvia,0,1,0,1,1964
Luciano Dalla Bona,Italy,0,1,0,1,1964
Pietro Guerra,Italy,0,1,0,1,1964
Viktor Logunov,Russian Federation,0,1,0,1,1964
Cencio Mantovani,Italy,0,1,0,1,1964
Ferruccio Manza,Italy,0,1,0,1,1964
Carlo Rancati,Italy,0,1,0,1,1964
Kjell Rodian,Denmark,0,1,0,1,1964
Luigi Roncaglia,Italy,0,1,0,1,1964
Franco Testa,Italy,0,1,0,1,1964
Giorgio Ursi,Italy,0,1,0,1,1964
Abdul Hamid,Pakistan,0,1,0,1,1964
Munir Ahmed Dar,Pakistan,0,1,0,1,1964
Khalid Mahmood,Pakistan,0,1,0,1,1964
Anwar Ahmed Khan,Pakistan,0,1,0,1,1964
Nawaz Khizar Bajwa,Pakistan,0,1,0,1,1964
Khurshid Azam,Pakistan,0,1,0,1,1964
Muhammad Asad Malik,Pakistan,0,1,0,1,1964
Muhammad Afzal Manna,Pakistan,0,1,0,1,1964
Manzoor Hussain Atif,Pakistan,0,1,0,1,1964
Abdul Rashid,Pakistan,0,1,0,1,1964
Motiullah,Pakistan,0,1,0,1,1964
Tariq Niazi,Pakistan,0,1,0,1,1964
Saeed Anwar,Pakistan,0,1,0,1,1964
Tariq Aziz,Pakistan,0,1,0,1,1964
Zafar Hayat,Pakistan,0,1,0,1,1964
Khawaja Zaka-ud-Din,Pakistan,0,1,0,1,1964
Galina Gorokhova,Russian Federation,0,1,0,1,1964
Tatyana Petrenko-Samusenko,Belarus,0,1,0,1,1964
Valentina Prudskova,Russian Federation,0,1,0,1,1964
Valentina Rastvorova,Soviet Union,0,1,0,1,1964
Lyudmila Shishova,Russian Federation,0,1,0,1,1964
Claude Arabo,France,0,1,0,1,1964
Bill Hoskyns,Great Britain,0,1,0,1,1964
Giovanni Battista Breda,Italy,0,1,0,1,1964
Giampaolo Calanchini,Italy,0,1,0,1,1964
Wladimiro Calarese,Italy,0,1,0,1,1964
Pierluigi Chicca,Italy,0,1,0,1,1964
Giuseppe Delfino,Italy,0,1,0,1,1964
Gianfranco Paolucci,Italy,0,1,0,1,1964
Alberto Pellegrino,Italy,0,1,0,1,1964
Mario Ravagnan,Italy,0,1,0,1,1964
Gianluigi Saccaro,Italy,0,1,0,1,1964
Cesare Salvadori,Italy,0,1,0,1,1964
Ryszard Parulski,Poland,0,1,0,1,1964
Jan Różycki,Poland,0,1,0,1,1964
Zbigniew Skrudlik,Poland,0,1,0,1,1964
Witold Woyda,Poland,0,1,0,1,1964
Paul Pesthy,United States,0,1,0,1,1964
Jan Brumovský,Czechoslovakia,0,1,0,1,1964
Ľudovít Cvetler,Czechoslovakia,0,1,0,1,1964
Ján Geleta,Czechoslovakia,0,1,0,1,1964
František Knebort,Czech Republic,0,1,0,1,1964
Karel Knesl,Czech Republic,0,1,0,1,1964
Karel Lichtnégl,Czech Republic,0,1,0,1,1964
Vojtech Masný,Czechoslovakia,0,1,0,1,1964
Štefan Matlák,Czechoslovakia,0,1,0,1,1964
Ivan Mráz,Czechoslovakia,0,1,0,1,1964
Karel Nepomucký,Czech Republic,0,1,0,1,1964
Zdeněk Pičman,Czech Republic,0,1,0,1,1964
František Schmucker,Czechoslovakia,0,1,0,1,1964
Anton Švajlen,Czechoslovakia,0,1,0,1,1964
Anton Urban,Czechoslovakia,0,1,0,1,1964
František Valošek,Czech Republic,0,1,0,1,1964
Josef Vojta,Czech Republic,0,1,0,1,1964
Vladimír Weiss,Czechoslovakia,0,1,0,1,1964
Birgit Radochla,East Germany,0,1,0,1,1964
Katalin Makray-Schmitt,Hungary,0,1,0,1,1964
Hana Růžičková,Czech Republic,0,1,0,1,1964
Marianna Némethová-Krajčírová,Czechoslovakia,0,1,0,1,1964
Jána Kubičková-Posnerová,Czechoslovakia,0,1,0,1,1964
Jaroslava Sedláčková,Czech Republic,0,1,0,1,1964
Adolfína Tkačíková-Tačová,Czech Republic,0,1,0,1,1964
Sergey Diomidov,Soviet Union,0,1,0,1,1964
Viktor Leontyev,Russian Federation,0,1,0,1,1964
Wolfgang Hofmann,Germany,0,1,0,1,1964
Eric Hänni,Switzerland,0,1,0,1,1964
Akio Kaminaga,Japan,0,1,0,1,1964
Doug Rogers,Canada,0,1,0,1,1964
Dave Kirkwood,United States,0,1,0,1,1964
James Moore,United States,0,1,0,1,1964
Jean-Claude Darouy,France,0,1,0,1,1964
Georges Morel,France,0,1,0,1,1964
Jacques Morel,France,0,1,0,1,1964
William Barry,Great Britain,0,1,0,1,1964
John James,Great Britain,0,1,0,1,1964
John M. Russell,Great Britain,0,1,0,1,1964
Hugh Wardell-Yerburgh,Great Britain,0,1,0,1,1964
Achim Hill,East Germany,0,1,0,1,1964
Klaus Aeffke,Germany,0,1,0,1,1964
Thomas Ahrens,Germany,0,1,0,1,1964
Klaus Behrens,Germany,0,1,0,1,1964
Klaus Bittner,Germany,0,1,0,1,1964
Horst Meyer,Germany,0,1,0,1,1964
Jürgen Plagemann,Germany,0,1,0,1,1964
Jürgen Schröder,Germany,0,1,0,1,1964
Moritz von Groddeck,Germany,0,1,0,1,1964
Hans-Jürgen Wallbrecht,Germany,0,1,0,1,1964
Renato Bosatta,Italy,0,1,0,1,1964
Franco De Pedrina,Italy,0,1,0,1,1964
Giuseppe Galante,Italy,0,1,0,1,1964
Giovanni Spinola,Italy,0,1,0,1,1964
Emilio Trivini,Italy,0,1,0,1,1964
Steven Blaisse,Netherlands,0,1,0,1,1964
Ernst Veenemans,Netherlands,0,1,0,1,1964
Sy Cromwell,United States,0,1,0,1,1964
Jim Storm,United States,0,1,0,1,1964
Velichko Velichkov,Bulgaria,0,1,0,1,1964
Ion Tripșa,Romania,0,1,0,1,1964
Shota Kveliashvili,Georgia,0,1,0,1,1964
Pāvels Seničevs,Latvia,0,1,0,1,1964
Frank Green,United States,0,1,0,1,1964
Lyn Bell,Australia,0,1,0,1,1964
Jan Murphy,Australia,0,1,0,1,1964
Robyn Thorn,Australia,0,1,0,1,1964
Kiki Caron,France,0,1,0,1,1964
Bobby McGregor,Great Britain,0,1,0,1,1964
Egon Henninger,East Germany,0,1,0,1,1964
Uwe Jacobsen,Germany,0,1,0,1,1964
Ernst-Joachim Küppers,Germany,0,1,0,1,1964
Horst Löffler,Germany,0,1,0,1,1964
Klaus Dibiasi,Italy,0,1,0,1,1964
Klenie Bimolt,Netherlands,0,1,0,1,1964
Corrie Winkel,Netherlands,0,1,0,1,1964
Georgy Prokopenko,Soviet Union,0,1,0,1,1964
Jeanne Collier,United States,0,1,0,1,1964
Sharon Finneran,United States,0,1,0,1,1964
Claudia Kolb,United States,0,1,0,1,1964
Marilyn Ramenofsky,United States,0,1,0,1,1964
Gary Dilley,United States,0,1,0,1,1964
Frank Gorman,United States,0,1,0,1,1964
John Nelson,United States,0,1,0,1,1964
Carl Robie,United States,0,1,0,1,1964
Milan Čuda,Czech Republic,0,1,0,1,1964
Bohumil Golián,Czechoslovakia,0,1,0,1,1964
Zdeněk Humhal,Czech Republic,0,1,0,1,1964
Petr Kop,Czech Republic,0,1,0,1,1964
Josef Musil,Czech Republic,0,1,0,1,1964
Karel Paulus,Czech Republic,0,1,0,1,1964
Boris Perušič,Czech Republic,0,1,0,1,1964
Pavel Schenk,Czech Republic,0,1,0,1,1964
Václav Šmídl,Czech Republic,0,1,0,1,1964
Josef Šorm,Czech Republic,0,1,0,1,1964
Ladislav Toman,Czech Republic,0,1,0,1,1964
Nelli Abramova,Russian Federation,0,1,0,1,1964
Astra Biltauere,Latvia,0,1,0,1,1964
Lyudmila Buldakova,Russian Federation,0,1,0,1,1964
Lyudmila Gureyeva,Soviet Union,0,1,0,1,1964
Valentina Kamenyok-Vinogradova,Russian Federation,0,1,0,1,1964
Marita Katusheva,Russian Federation,0,1,0,1,1964
Ninel Lukanina,Russian Federation,0,1,0,1,1964
Valentina Mishak,Soviet Union,0,1,0,1,1964
Tatyana Roshchina,Russian Federation,0,1,0,1,1964
Antonina Ryzhova,Russian Federation,0,1,0,1,1964
Inna Ryskal,Azerbaijan,0,1,0,1,1964
Tamara Tikhonina,Russian Federation,0,1,0,1,1964
Ozren Bonačić,Croatia,0,1,0,1,1964
Zoran Janković,Serbia,0,1,0,1,1964
Milan Muškatirović,Serbia,0,1,0,1,1964
Ante Nardeli,Croatia,0,1,0,1,1964
Frane Nonković,Croatia,0,1,0,1,1964
Vinko Rosić,Croatia,0,1,0,1,1964
Mirko Sandić,Serbia,0,1,0,1,1964
Zlatko Šimenc,Croatia,0,1,0,1,1964
Božidar Stanišić,Montenegro,0,1,0,1,1964
Karlo Stipanić,Croatia,0,1,0,1,1964
Ivo Trumbić,Croatia,0,1,0,1,1964
Louis Martin,Great Britain,0,1,0,1,1964
Imre Földi,Hungary,0,1,0,1,1964
Géza Tóth,Hungary,0,1,0,1,1964
Vladimir Kaplunov,Russian Federation,0,1,0,1,1964
Viktor Kurentsov,Russian Federation,0,1,0,1,1964
Yury Vlasov,Russian Federation,0,1,0,1,1964
Ike Berger,United States,0,1,0,1,1964
Lyutvi Akhmedov,Bulgaria,0,1,0,1,1964
Angel Kerezov,Bulgaria,0,1,0,1,1964
Stancho Ivanov,Bulgaria,0,1,0,1,1964
Kiril Petkov,Bulgaria,0,1,0,1,1964
Klaus Rost,Germany,0,1,0,1,1964
Jang Chang-Seon,Republic of Korea,0,1,0,1,1964
Valeriu Bularcă,Romania,0,1,0,1,1964
Per Svensson,Sweden,0,1,0,1,1964
Jiří Kormaník,Czech Republic,0,1,0,1,1964
Hüseyin Akbaş,Turkey,0,1,0,1,1964
Ahmet Ayık,Turkey,0,1,0,1,1964
Hasan Güngör,Turkey,0,1,0,1,1964
Anatoly Roshchin,Russian Federation,0,1,0,1,1964
Roman Rurua,Georgia,0,1,0,1,1964
Guram Sagharadze,Georgia,0,1,0,1,1964
Vladlen Trostyansky,Soviet Union,0,1,0,1,1964
Peter Ahrendt,East Germany,0,1,0,1,1964
Peter Barrett,United States,0,1,0,1,1964
Arne Karlsson,Sweden,0,1,0,1,1964
Wilfried Lorenz,Germany,0,1,0,1,1964
Ulrich Mense,East Germany,0,1,0,1,1964
Tony Morgan,Great Britain,0,1,0,1,1964
Keith Musto,Great Britain,0,1,0,1,1964
Dick Stearns,United States,0,1,0,1,1964
Sture Stork,Sweden,0,1,0,1,1964
Lars Thörn,Sweden,0,1,0,1,1964
Lindsay Williams,United States,0,1,0,1,1964
Michele Mason-Brown,Australia,0,1,0,1,1964
Bill Crothers,Canada,0,1,0,1,1964
Enrique Figuerola,Cuba,0,1,0,1,1964
Maryvonne Dupureur,France,0,1,0,1,1964
Robbie Brightwell,Great Britain,0,1,0,1,1964
Tim Graham,Great Britain,0,1,0,1,1964
Basil Heatley,Great Britain,0,1,0,1,1964
Maurice Herriott,Great Britain,0,1,0,1,1964
Adrian Metcalfe,Great Britain,0,1,0,1,1964
Paul Nihill,Great Britain,0,1,0,1,1964
Renate Boy-Garisch-Culmberger,East Germany,0,1,0,1,1964
Ingrid Lotz,East Germany,0,1,0,1,1964
Dieter Lindner,East Germany,0,1,0,1,1964
Harald Norpoth,Germany,0,1,0,1,1964
Wolfgang Reinhardt,Germany,0,1,0,1,1964
Márta Antal-Rudas,Hungary,0,1,0,1,1964
Gergely Kulcsár,Hungary,0,1,0,1,1964
Gyula Zsivótzky,Hungary,0,1,0,1,1964
Marian Dudziak,Poland,0,1,0,1,1964
Marian Foik,Poland,0,1,0,1,1964
Wiesław Maniak,Poland,0,1,0,1,1964
Andrzej Zieliński,Poland,0,1,0,1,1964
Ludvík Daněk,Czech Republic,0,1,0,1,1964
Josef Odložil,Czech Republic,0,1,0,1,1964
Mohamad Gammoudi,Tunisia,0,1,0,1,1964
Rein Aun,Estonia,0,1,0,1,1964
Oleg Fedoseyev,Russian Federation,0,1,0,1,1964
Marilyn White,United States,0,1,0,1,1964
Willye White,United States,0,1,0,1,1964
Ralph Boston,United States,0,1,0,1,1964
Blaine Lindgren,United States,0,1,0,1,1964
Randy Matson,United States,0,1,0,1,1964
John Thomas,United States,0,1,0,1,1964
Aurel Vernescu,Romania,0,0,2,2,1964
Sergey Filatov,Russian Federation,0,0,2,2,1964
Fritz Ligges,Germany,0,0,2,2,1964
Daniel Revenu,France,0,0,2,2,1964
David Dickson,Australia,0,0,2,2,1964
Allan Wood,Australia,0,0,2,2,1964
Svetlana Babanina,Soviet Union,0,0,2,2,1964
Edwin Roberts,Trinidad and Tobago,0,0,2,2,1964
Aleksandar Nikolov,Bulgaria,0,0,1,1,1964
Pertti Purhonen,Finland,0,0,1,1,1964
Heinz Schulz,East Germany,0,0,1,1,1964
Eddie Blay,Ghana,0,0,1,1,1964
Jim McCourt,Ireland,0,0,1,1,1964
Silvano Bertini,Italy,0,0,1,1,1964
Giuseppe Ros,Italy,0,0,1,1,1964
Franco Valle,Italy,0,0,1,1,1964
Juan Fabila,Mexico,0,0,1,1,1964
Nojim Maiyegun,Nigeria,0,0,1,1,1964
Wlamir Marques,Brazil,0,0,1,1,1964
Edson Bispo,Brazil,0,0,1,1,1964
Fritz,Brazil,0,0,1,1,1964
Rosa Branca,Brazil,0,0,1,1,1964
Macarrão,Brazil,0,0,1,1,1964
Mosquito,Brazil,0,0,1,1,1964
Edvar Simões,Brazil,0,0,1,1,1964
Victor Mirshauswka,Brazil,0,0,1,1,1964
Amaury,Brazil,0,0,1,1,1964
Bira,Brazil,0,0,1,1,1964
Sucar,Brazil,0,0,1,1,1964
Jatyr,Brazil,0,0,1,1,1964
Józef Grzesiak,Poland,0,0,1,1,1964
Zbigniew Pietrzykowski,Poland,0,0,1,1,1964
Tadeusz Walasek,Poland,0,0,1,1,1964
Habib Galhia,Tunisia,0,0,1,1,1964
Vadim Yemelyanov,Russian Federation,0,0,1,1,1964
Stanislav Sorokin,Russian Federation,0,0,1,1,1964
Washington Rodríguez,Uruguay,0,0,1,1,1964
Charlie Brown,United States,0,0,1,1,1964
Bob Carmody,United States,0,0,1,1,1964
Ronnie Harris,United States,0,0,1,1,1964
Peer Norrbohm,Denmark,0,0,1,1,1964
John Rungsted Sørensen,Denmark,0,0,1,1,1964
Heinz Büker,Germany,0,0,1,1,1964
Cornelia Sideri,Romania,0,0,1,1,1964
Simion Cuciuc,Romania,0,0,1,1,1964
Atanasie Sciotnic,Romania,0,0,1,1,1964
Mihai Țurcaș,Romania,0,0,1,1,1964
Yevgeny Penyayev,Russian Federation,0,0,1,1,1964
Marcia Jones Smoke,United States,0,0,1,1,1964
Piero D'Inzeo,Italy,0,0,1,1,1964
Raimondo D'Inzeo,Italy,0,0,1,1,1964
Karl-Heinz Fuhrmann,East Germany,0,0,1,1,1964
Ivan Kalita,Russian Federation,0,0,1,1,1964
Horst Karsten,Germany,0,0,1,1,1964
Ivan Kizimov,Russian Federation,0,0,1,1,1964
Graziano Mancinelli,Italy,0,0,1,1,1964
Peter Robeson,Great Britain,0,0,1,1,1964
Gerhard Schulz,East Germany,0,0,1,1,1964
Henk Cornelisse,Netherlands,0,0,1,1,1964
Erik Pettersson,Sweden,0,0,1,1,1964
Gösta Pettersson,Sweden,0,0,1,1,1964
Sture Pettersson,Sweden,0,0,1,1,1964
Willi Fuggerer,Germany,0,0,1,1,1964
Walter Godefroot,Belgium,0,0,1,1,1964
Sven Hamrin,Sweden,0,0,1,1,1964
Preben Isaksson,Denmark,0,0,1,1,1964
Klaus Kobusch,Germany,0,0,1,1,1964
Gerard Koel,Netherlands,0,0,1,1,1964
Daniel Morelon,France,0,0,1,1,1964
Jaap Oudkerk,Netherlands,0,0,1,1,1964
Cor Schuuring,Netherlands,0,0,1,1,1964
Pierre Trentin,France,0,0,1,1,1964
Mervyn Crossman,Australia,0,0,1,1,1964
Paul Dearing,Australia,0,0,1,1,1964
Ray Evans,Australia,0,0,1,1,1964
Brian Glencross,Australia,0,0,1,1,1964
Robin Hodder,Australia,0,0,1,1,1964
John McBryde,Australia,0,0,1,1,1964
Don McWatters,Australia,0,0,1,1,1964
Patrick Nilan,Australia,0,0,1,1,1964
Eric Pearce,Australia,0,0,1,1,1964
Julian Pearce,Australia,0,0,1,1,1964
Desmond Piper,Australia,0,0,1,1,1964
Don Smart,Australia,0,0,1,1,1964
Tony Waters,Australia,0,0,1,1,1964
Graham Wood,Australia,0,0,1,1,1964
Heidi Schmid,Germany,0,0,1,1,1964
Gundi Theuerkauff,Germany,0,0,1,1,1964
Romi Weiß-Scherberger,Germany,0,0,1,1,1964
Antonella Ragno-Lonzi,Italy,0,0,1,1,1964
Claude Bourquard,France,0,0,1,1,1964
Claude Brodin,France,0,0,1,1,1964
Jacques Brodin,France,0,0,1,1,1964
Jacky Courtillat,France,0,0,1,1,1964
Yves Dreyfus,France,0,0,1,1,1964
Jack Guittet,France,0,0,1,1,1964
Christian Noël,France,0,0,1,1,1964
Pierre Rodocanachi,France,0,0,1,1,1964
Emil Ochyra,Poland,0,0,1,1,1964
Jerzy Pawłowski,Poland,0,0,1,1,1964
Andrzej Piątkowski,Poland,0,0,1,1,1964
Wojciech Zabłocki,Poland,0,0,1,1,1964
Ryszard Zub,Poland,0,0,1,1,1964
Guram Kostava,Georgia,0,0,1,1,1964
Wolfgang Barthels,East Germany,0,0,1,1,1964
Bernd Bauchspieß,East Germany,0,0,1,1,1964
Dieter Engelhardt,East Germany,0,0,1,1,1964
Henning Frenzel,East Germany,0,0,1,1,1964
Otto Fräßdorf,East Germany,0,0,1,1,1964
Manfred Geisler,East Germany,0,0,1,1,1964
Jürgen Heinsch,East Germany,0,0,1,1,1964
Gerhard Körner,East Germany,0,0,1,1,1964
Klaus Lisiewicz,East Germany,0,0,1,1,1964
Jürgen Nöldner,East Germany,0,0,1,1,1964
Herbert Pankau,East Germany,0,0,1,1,1964
Peter Rock,East Germany,0,0,1,1,1964
Klaus-Dieter Seehaus,East Germany,0,0,1,1,1964
Hermann Stöcker,East Germany,0,0,1,1,1964
Werner Unger,East Germany,0,0,1,1,1964
Klaus Urbanczyk,East Germany,0,0,1,1,1964
Eberhard Vogel,East Germany,0,0,1,1,1964
Manfred Walter,East Germany,0,0,1,1,1964
Horst Weigang,East Germany,0,0,1,1,1964
Anikó Ducza-Jánosi,Hungary,0,0,1,1,1964
Ginko Abukawa-Chiba,Japan,0,0,1,1,1964
Taniko Nakamura-Mitsukuri,Japan,0,0,1,1,1964
Kiyoko Ono,Japan,0,0,1,1,1964
Toshiko Shirasu-Aihara,Japan,0,0,1,1,1964
Keiko Tanaka-Ikeda,Japan,0,0,1,1,1964
Hiroko Tsuji,Japan,0,0,1,1,1964
Hannu Rantakari,Finland,0,0,1,1,1964
Siegfried Fülle,East Germany,0,0,1,1,1964
Erwin Koppe,East Germany,0,0,1,1,1964
Klaus Köste,East Germany,0,0,1,1,1964
Peter Weber,East Germany,0,0,1,1,1964
Philipp Fürst,Germany,0,0,1,1,1964
Günter Lyhs,Germany,0,0,1,1,1964
Ārons Boguļubovs,Latvia,0,0,1,1,1964
Ted Boronovskis,Australia,0,0,1,1,1964
Jim Bregman,United States,0,0,1,1,1964
Klaus Glahn,Germany,0,0,1,1,1964
Anzor K'ik'nadze,Georgia,0,0,1,1,1964
Kim Ui-Tae,Republic of Korea,0,0,1,1,1964
Oleg Stepanov,Russian Federation,0,0,1,1,1964
Parnaoz Chik'viladze,Georgia,0,0,1,1,1964
Imre Nagy,Hungary,0,0,1,1,1964
Ottó Török,Hungary,0,0,1,1,1964
Wolfgang Hottenrott,Germany,0,0,1,1,1964
Michael Schwan,Germany,0,0,1,1,1964
Jan-Just Bos,Netherlands,0,0,1,1,1964
Erik Hartsuiker,Netherlands,0,0,1,1,1964
Marius Klumperbeek,Netherlands,0,0,1,1,1964
Lex Mullink,Netherlands,0,0,1,1,1964
Herman Rouwé,Netherlands,0,0,1,1,1964
Bobbie van der Graaf,Netherlands,0,0,1,1,1964
Freek van de Graaff,Netherlands,0,0,1,1,1964
Jan van de Graaff,Netherlands,0,0,1,1,1964
Göpf Kottmann,Switzerland,0,0,1,1,1964
Vladimír Andrs,Czech Republic,0,0,1,1,1964
Petr Čermák,Czech Republic,0,0,1,1,1964
Pavel Hofmann,Czech Republic,0,0,1,1,1964
Bohumil Janoušek,Czech Republic,0,0,1,1,1964
Miroslav Koníček,Czech Republic,0,0,1,1,1964
Jiří Lundák,Czech Republic,0,0,1,1,1964
Jan Mrvík,Czech Republic,0,0,1,1,1964
Richard Nový,Czech Republic,0,0,1,1,1964
Luděk Pojezný,Czech Republic,0,0,1,1,1964
Július Toček,Czechoslovakia,0,0,1,1,1964
Josef Věntus,Czech Republic,0,0,1,1,1964
Phil Durbrow,United States,0,0,1,1,1964
Dick Lyon,United States,0,0,1,1,1964
Ted Mittet,United States,0,0,1,1,1964
Ted Nash,United States,0,0,1,1,1964
Geoffrey Picard,United States,0,0,1,1,1964
Yoshihisa Yoshikawa,Japan,0,0,1,1,1964
Lubomír Nácovský,Czech Republic,0,0,1,1,1964
Martin Gunnarsson,United States,0,0,1,1,1964
Bill Morris,United States,0,0,1,1,1964
Tommy Pool,United States,0,0,1,1,1964
Peter Doak,Australia,0,0,1,1,1964
Peter Reynolds,Australia,0,0,1,1,1964
John Ryan,Australia,0,0,1,1,1964
Makoto Fukui,Japan,0,0,1,1,1964
Kunihiro Iwasaki,Japan,0,0,1,1,1964
Yukiaki Okabe,Japan,0,0,1,1,1964
Toshio Shoji,Japan,0,0,1,1,1964
Toos Beumer,Netherlands,0,0,1,1,1964
Pauline van der Wildt,Netherlands,0,0,1,1,1964
Winnie van Weerdenburg,Netherlands,0,0,1,1,1964
Galina Alekseyeva,Russian Federation,0,0,1,1,1964
Tatyana Devyatova,Soviet Union,0,0,1,1,1964
Tatyana Savelyeva,Russian Federation,0,0,1,1,1964
Nataliya Ustinova,Soviet Union,0,0,1,1,1964
Martha Randall,United States,0,0,1,1,1964
Terri Lee Stickles,United States,0,0,1,1,1964
Patsy Willard,United States,0,0,1,1,1964
Larry Andreasen,United States,0,0,1,1,1964
Bob Bennett,United States,0,0,1,1,1964
Tom Gompf,United States,0,0,1,1,1964
Chet Jastremski,United States,0,0,1,1,1964
Yutaka Demachi,Japan,0,0,1,1,1964
Naohiro Ikeda,Japan,0,0,1,1,1964
Toshiaki Kosedo,Japan,0,0,1,1,1964
Tsutomu Koyama,Japan,0,0,1,1,1964
Masayuki Minami,Japan,0,0,1,1,1964
Teruhisa Moriyama,Japan,0,0,1,1,1964
Katsutoshi Nekoda,Japan,0,0,1,1,1964
Yasutaka Sato,Japan,0,0,1,1,1964
Sadatoshi Sugawara,Japan,0,0,1,1,1964
Krystyna Czajkowska-Rawska,Poland,0,0,1,1,1964
Maria Golimowska,Poland,0,0,1,1,1964
Krystyna Jakubowska,Poland,0,0,1,1,1964
Danuta Kordaczuk,Poland,0,0,1,1,1964
Krystyna Krupa,Poland,0,0,1,1,1964
Józefa Ledwig,Poland,0,0,1,1,1964
Jadwiga Marko-Książek,Poland,0,0,1,1,1964
Jadwiga Rutkowska,Poland,0,0,1,1,1964
Maria Śliwka,Poland,0,0,1,1,1964
Zofia Szcześniewska,Poland,0,0,1,1,1964
Viktor Ageyev,Russian Federation,0,0,1,1,1964
Zenon Bortkevich,Azerbaijan,0,0,1,1,1964
Igor Grabovsky,Russian Federation,0,0,1,1,1964
Boris Grishin,Russian Federation,0,0,1,1,1964
Eduard Yegorov,Russian Federation,0,0,1,1,1964
Nikolay Kalashnikov,Russian Federation,0,0,1,1,1964
Nikolay Kuznetsov,Azerbaijan,0,0,1,1,1964
Vladimir Kuznetsov,Russian Federation,0,0,1,1,1964
Leonid Osipov,Russian Federation,0,0,1,1,1964
Boris Popov,Russian Federation,0,0,1,1,1964
Vladimir Semyonov,Russian Federation,0,0,1,1,1964
Győző Veres,Hungary,0,0,1,1,1964
Shiro Ichinoseki,Japan,0,0,1,1,1964
Masashi Ohuchi,Japan,0,0,1,1,1964
Mieczysław Nowak,Poland,0,0,1,1,1964
Ireneusz Paliński,Poland,0,0,1,1,1964
Marian Zieliński,Poland,0,0,1,1,1964
Norb Schemansky,United States,0,0,1,1,1964
Said Mustafov,Bulgaria,0,0,1,1,1964
Lothar Metz,East Germany,0,0,1,1,1964
Wilfried Dietrich,Germany,0,0,1,1,1964
Heinz Kiehl,Germany,0,0,1,1,1964
Sayed Ali Akbar Haydari,Islamic Republic of Iran,0,0,1,1,1964
Mohammad Ali Sanatkaran,Islamic Republic of Iran,0,0,1,1,1964
Iwao Horiuchi,Japan,0,0,1,1,1964
Ion Cernea,Romania,0,0,1,1,1964
Dumitru Pîrvulescu,Romania,0,0,1,1,1964
Bertil Nyström,Sweden,0,0,1,1,1964
Hamit Kaplan,Turkey,0,0,1,1,1964
Davit Gvantseladze,Georgia,0,0,1,1,1964
Aydın İbrahimov,Azerbaijan,0,0,1,1,1964
Nodar Khokhashvili,Georgia,0,0,1,1,1964
Dan Brand,United States,0,0,1,1,1964
Branko Martinović,Serbia,0,0,1,1,1964
Joe Batchelder,United States,0,0,1,1,1964
Bill Bentsen,United States,0,0,1,1,1964
Dick Deaver,United States,0,0,1,1,1964
Don McNamara,United States,0,0,1,1,1964
"Buddy Melges, Jr.",United States,0,0,1,1,1964
Lowell North,United States,0,0,1,1,1964
Pelle Petterson,Sweden,0,0,1,1,1964
Charlie Rogers,United States,0,0,1,1,1964
Frank Scully,United States,0,0,1,1,1964
Holger Sundström,Sweden,0,0,1,1,1964
Henning Wind,Denmark,0,0,1,1,1964
Judy Amoore-Pollock,Australia,0,0,1,1,1964
Marilyn Black,Australia,0,0,1,1,1964
Pam Kilborn-Ryan,Australia,0,0,1,1,1964
Ron Clarke,Australia,0,0,1,1,1964
Harry Jerome,Canada,0,0,1,1,1964
Jocelyn Delecour,France,0,0,1,1,1964
Paul Genevay,France,0,0,1,1,1964
Bernard Laidebeur,France,0,0,1,1,1964
Claude Piquemal,France,0,0,1,1,1964
Daphne Arden,Great Britain,0,0,1,1,1964
Dorothy Hyman,Great Britain,0,0,1,1,1964
Janet Simpson,Great Britain,0,0,1,1,1964
Uwe Beyer,Germany,0,0,1,1,1964
Klaus Lehnertz,Germany,0,0,1,1,1964
Hans-Joachim Walde,Germany,0,0,1,1,1964
Vilmos Varjú,Hungary,0,0,1,1,1964
Salvatore Morale,Italy,0,0,1,1,1964
Kokichi Tsuburaya,Japan,0,0,1,1,1964
Wilson Kiprugut,Kenya,0,0,1,1,1964
Marise Chamberlain,New Zealand,0,0,1,1,1964
John Davies,New Zealand,0,0,1,1,1964
Andrzej Badeński,Poland,0,0,1,1,1964
Lia Manoliu,Romania,0,0,1,1,1964
Ingvar Pettersson,Sweden,0,0,1,1,1964
Kent Bernard,Trinidad and Tobago,0,0,1,1,1964
Edwin Skinner,Trinidad and Tobago,0,0,1,1,1964
Galina Bystrova,Azerbaijan,0,0,1,1,1964
Taisiya Chenchik,Russian Federation,0,0,1,1,1964
Yelena Gorchakova,Russian Federation,0,0,1,1,1964
Tatyana Shchelkanova,Russian Federation,0,0,1,1,1964
Galina Zybina,Russian Federation,0,0,1,1,1964
Ivan Belyayev,Soviet Union,0,0,1,1,1964
Vladimir Golubnichy,Soviet Union,0,0,1,1,1964
Viktor Kravchenko,Russian Federation,0,0,1,1,1964
Jānis Lūsis,Latvia,0,0,1,1,1964
Anatoly Mikhaylov,Russian Federation,0,0,1,1,1964
Igor Ter-Ovanesyan,Russian Federation,0,0,1,1,1964
Bill Dellinger,United States,0,0,1,1,1964
John Rambo,United States,0,0,1,1,1964
Dave Weill,United States,0,0,1,1,1964
Věra Čáslavská,Czech Republic,4,2,0,6,1968
Akinori Nakayama,Japan,4,1,1,6,1968
Charlie Hickcox,United States,3,1,0,4,1968
Sawao Kato,Japan,3,0,1,4,1968
Debbie Meyer,United States,3,0,0,3,1968
Mikhail Voronin,Russian Federation,2,4,1,7,1968
Sue Pedersen,United States,2,2,0,4,1968
Mike Wenden,Australia,2,1,1,4,1968
Jan Henne,United States,2,1,1,4,1968
Mark Spitz,United States,2,1,1,4,1968
Roland Matthes,East Germany,2,1,0,3,1968
Ken Walsh,United States,2,1,0,3,1968
Nataliya Kuchinskaya,Russian Federation,2,0,2,4,1968
Pierre Trentin,France,2,0,1,3,1968
Larisa Petrik,Belarus,2,0,1,3,1968
Kaye Hall,United States,2,0,1,3,1968
Daniel Morelon,France,2,0,0,2,1968
Yelena Novikova-Belova,Belarus,2,0,0,2,1968
Győző Kulcsár,Hungary,2,0,0,2,1968
Claudia Kolb,United States,2,0,0,2,1968
Mike Burton,United States,2,0,0,2,1968
Don McKenzie,United States,2,0,0,2,1968
Steve Rerych,United States,2,0,0,2,1968
Doug Russell,United States,2,0,0,2,1968
Wyomia Tyus,United States,2,0,0,2,1968
Lee Evans,United States,2,0,0,2,1968
Jim Hines,United States,2,0,0,2,1968
Zinaida Voronina,Russian Federation,1,1,2,4,1968
Ellie Daniel,United States,1,1,1,3,1968
Linda Gustavson,United States,1,1,1,3,1968
Aleksandr Shaparenko,Soviet Union,1,1,0,2,1968
Derek Allhusen,Great Britain,1,1,0,2,1968
Ivan Kizimov,Russian Federation,1,1,0,2,1968
Josef Neckermann,Germany,1,1,0,2,1968
Mogens Frey Jensen,Denmark,1,1,0,2,1968
Mark Rakita,Russian Federation,1,1,0,2,1968
Yukio Endo,Japan,1,1,0,2,1968
András Balczó,Hungary,1,1,0,2,1968
Lyn McClements,Australia,1,1,0,2,1968
Klaus Dibiasi,Italy,1,1,0,2,1968
Don Schollander,United States,1,1,0,2,1968
Đurđica Bjedov,Croatia,1,1,0,2,1968
Mamo Wolde,Ethiopia,1,1,0,2,1968
Kip Keino,Kenya,1,1,0,2,1968
Barbara Ferrell,United States,1,1,0,2,1968
Larry James,United States,1,1,0,2,1968
Lyudmila Khvedosyuk-Pinayeva,Russian Federation,1,0,1,2,1968
Reiner Klimke,Germany,1,0,1,2,1968
Pierfranco Vianelli,Italy,1,0,1,2,1968
Daniel Revenu,France,1,0,1,2,1968
Takeshi Kato,Japan,1,0,1,2,1968
Eizo Kenmotsu,Japan,1,0,1,2,1968
Jane Barkman,United States,1,0,1,2,1968
Sharon Wichman,United States,1,0,1,2,1968
John Nelson,United States,1,0,1,2,1968
Naftali Temu,Kenya,1,0,1,2,1968
Irena Kirszenstein-Szewińska,Poland,1,0,1,2,1968
Mohamad Gammoudi,Tunisia,1,0,1,2,1968
Ron Freeman,United States,1,0,1,2,1968
Charlie Greene,United States,1,0,1,2,1968
Chris Finnegan,Great Britain,1,0,0,1,1968
Manfred Wolke,East Germany,1,0,0,1,1968
Ricardo Delgado,Mexico,1,0,0,1,1968
Antonio Roldán,Mexico,1,0,0,1,1968
Mike Barrett,United States,1,0,0,1,1968
John Clawson,United States,1,0,0,1,1968
Don Dee,United States,1,0,0,1,1968
Cal Fowler,United States,1,0,0,1,1968
Spencer Haywood,United States,1,0,0,1,1968
Bill Hosket,United States,1,0,0,1,1968
Jim King,United States,1,0,0,1,1968
Glynn Saulters,United States,1,0,0,1,1968
Charlie Scott,United States,1,0,0,1,1968
Mike Silliman,United States,1,0,0,1,1968
Ken Spain,United States,1,0,0,1,1968
Jo-Jo White,United States,1,0,0,1,1968
Jerzy Kulej,Poland,1,0,0,1,1968
Boris Lagutin,Russian Federation,1,0,0,1,1968
Danas Pozniakas,Lithuania,1,0,0,1,1968
Valerian Sokolov,Russian Federation,1,0,0,1,1968
George Foreman,United States,1,0,0,1,1968
Ronnie Harris,United States,1,0,0,1,1968
Francisco Rodríguez,Venezuela,1,0,0,1,1968
Roswitha Esser,Germany,1,0,0,1,1968
Annemarie Zimmermann,Germany,1,0,0,1,1968
Mihály Hesz,Hungary,1,0,0,1,1968
Tibor Tatai,Hungary,1,0,0,1,1968
Steinar Amundsen,Norway,1,0,0,1,1968
Tore Berger,Norway,1,0,0,1,1968
Jan Johansen,Norway,1,0,0,1,1968
Egil Søby,Norway,1,0,0,1,1968
Serghei Covaliov,Romania,1,0,0,1,1968
Ivan Patzaichin,Romania,1,0,0,1,1968
Vladimir Morozov,Soviet Union,1,0,0,1,1968
Jane Bullen,Great Britain,1,0,0,1,1968
Liselott Linsenhoff,Germany,1,0,0,1,1968
Jim Day,Canada,1,0,0,1,1968
Jim Elder,Canada,1,0,0,1,1968
Tom Gayford,Canada,1,0,0,1,1968
Jean-Jacques Guyon,France,1,0,0,1,1968
Ben Jones,Great Britain,1,0,0,1,1968
Richard Meade,Great Britain,1,0,0,1,1968
Bill Steinkraus,United States,1,0,0,1,1968
Gunnar Asmussen,Denmark,1,0,0,1,1968
Fedor den Hertog,Netherlands,1,0,0,1,1968
Per Lyngemark,Denmark,1,0,0,1,1968
Jan Krekels,Netherlands,1,0,0,1,1968
Reno Olsen,Denmark,1,0,0,1,1968
Peder Pedersen,Denmark,1,0,0,1,1968
René Pijnen,Netherlands,1,0,0,1,1968
Daniel Rébillard,France,1,0,0,1,1968
Joop Zoetemelk,Netherlands,1,0,0,1,1968
Abdul Rashid,Pakistan,1,0,0,1,1968
Jahangir Butt,Pakistan,1,0,0,1,1968
Tanvir Dar,Pakistan,1,0,0,1,1968
Gulraiz Akhtar,Pakistan,1,0,0,1,1968
Khalid Mahmood,Pakistan,1,0,0,1,1968
Muhammad Asad Malik,Pakistan,1,0,0,1,1968
Ashfaq Ahmed,Pakistan,1,0,0,1,1968
Tariq Niazi,Pakistan,1,0,0,1,1968
Riaz Ahmed,Pakistan,1,0,0,1,1968
Riaz ud-Din,Pakistan,1,0,0,1,1968
Saeed Anwar,Pakistan,1,0,0,1,1968
Tariq Aziz,Pakistan,1,0,0,1,1968
Zakir Hussain,Pakistan,1,0,0,1,1968
Galina Gorokhova,Russian Federation,1,0,0,1,1968
Tatyana Petrenko-Samusenko,Belarus,1,0,0,1,1968
Svetlana Tširkova,Estonia,1,0,0,1,1968
Aleksandra Zabelina,Russian Federation,1,0,0,1,1968
Gilles Berolatti,France,1,0,0,1,1968
Jacques Dimont,France,1,0,0,1,1968
Jean-Claude Magnan,France,1,0,0,1,1968
Christian Noël,France,1,0,0,1,1968
Csaba Fenyvesi,Hungary,1,0,0,1,1968
Pál B. Nagy,Hungary,1,0,0,1,1968
Zoltán Nemere,Hungary,1,0,0,1,1968
Pál Schmitt,Hungary,1,0,0,1,1968
Jerzy Pawłowski,Poland,1,0,0,1,1968
Ion Drîmbă,Romania,1,0,0,1,1968
Umyar Mavlikhanov,Russian Federation,1,0,0,1,1968
Vladimir Nazlymov,Russian Federation,1,0,0,1,1968
Viktor Sidyak,Belarus,1,0,0,1,1968
Eduard Vinokurov,Russian Federation,1,0,0,1,1968
István Básti,Hungary,1,0,0,1,1968
Lajos Dunai,Hungary,1,0,0,1,1968
Antal Dunai,Hungary,1,0,0,1,1968
Károly Fatér,Hungary,1,0,0,1,1968
László Fazekas,Hungary,1,0,0,1,1968
István Juhász,Hungary,1,0,0,1,1968
László Keglovich,Hungary,1,0,0,1,1968
Lajos Kocsis,Hungary,1,0,0,1,1968
Iván Menczel,Hungary,1,0,0,1,1968
László Nagy,Hungary,1,0,0,1,1968
Ernő Noskó,Hungary,1,0,0,1,1968
Dezső Novák,Hungary,1,0,0,1,1968
Miklós Páncsics,Hungary,1,0,0,1,1968
István Sárközi,Hungary,1,0,0,1,1968
Miklós Szalay,Hungary,1,0,0,1,1968
Zoltán Szarka,Hungary,1,0,0,1,1968
Lajos Szűcs,Hungary,1,0,0,1,1968
Lyubov Burda,Russian Federation,1,0,0,1,1968
Olga Karasyova,Russian Federation,1,0,0,1,1968
Lyudmila Turishcheva,Russian Federation,1,0,0,1,1968
Mitsuo Tsukahara,Japan,1,0,0,1,1968
Miroslav Cerar,Slovenia,1,0,0,1,1968
István Móna,Hungary,1,0,0,1,1968
Ferenc Török,Hungary,1,0,0,1,1968
Björn Ferm,Sweden,1,0,0,1,1968
Heinz-Jürgen Bothe,East Germany,1,0,0,1,1968
Frank Forberger,East Germany,1,0,0,1,1968
Dieter Grahn,East Germany,1,0,0,1,1968
Jörg Lucke,East Germany,1,0,0,1,1968
Frank Rühle,East Germany,1,0,0,1,1968
Dieter Schubert,East Germany,1,0,0,1,1968
Roland Böse,West Germany,1,0,0,1,1968
Rüdiger Henning,West Germany,1,0,0,1,1968
Egbert Hirschfelder,Germany,1,0,0,1,1968
Wolfgang Hottenrott,Germany,1,0,0,1,1968
Horst Meyer,Germany,1,0,0,1,1968
Niko Ott,West Germany,1,0,0,1,1968
Dirk Schreyer,West Germany,1,0,0,1,1968
Jörg Siebert,West Germany,1,0,0,1,1968
Gunther Tiersch,West Germany,1,0,0,1,1968
Lutz Ulbricht,West Germany,1,0,0,1,1968
Primo Baran,Italy,1,0,0,1,1968
Bruno Cipolla,Italy,1,0,0,1,1968
Renzo Sambo,Italy,1,0,0,1,1968
Jan Wienese,Netherlands,1,0,0,1,1968
Warren Cole,New Zealand,1,0,0,1,1968
Ross Collinge,New Zealand,1,0,0,1,1968
Simon Dickie,New Zealand,1,0,0,1,1968
Dick Joyce,New Zealand,1,0,0,1,1968
Dudley Storey,New Zealand,1,0,0,1,1968
Anatoly Sass,Russian Federation,1,0,0,1,1968
Aleksandr Timoshinin,Russian Federation,1,0,0,1,1968
Bob Braithwaite,Great Britain,1,0,0,1,1968
Bernd Klingner,Germany,1,0,0,1,1968
Józef Zapędzki,Poland,1,0,0,1,1968
Jan Kůrka,Czech Republic,1,0,0,1,1968
Grigory Kosykh,Russian Federation,1,0,0,1,1968
Yevgeny Petrov,Russian Federation,1,0,0,1,1968
Gary Anderson,United States,1,0,0,1,1968
Felipe Muñoz,Mexico,1,0,0,1,1968
Ada Kok,Netherlands,1,0,0,1,1968
Milena Duchková,Czech Republic,1,0,0,1,1968
Catie Ball,United States,1,0,0,1,1968
Sue Gossick,United States,1,0,0,1,1968
Pokey Watson,United States,1,0,0,1,1968
Carl Robie,United States,1,0,0,1,1968
Bernie Wrightson,United States,1,0,0,1,1968
Zac Zorn,United States,1,0,0,1,1968
Lyudmila Buldakova,Russian Federation,1,0,0,1,1968
Vera Galushka-Duyunova,Soviet Union,1,0,0,1,1968
Valentina Kamenyok-Vinogradova,Russian Federation,1,0,0,1,1968
Vera Lantratova,Azerbaijan,1,0,0,1,1968
Galina Leontyeva,Russian Federation,1,0,0,1,1968
Lyudmila Mikhaylovskaya,Russian Federation,1,0,0,1,1968
Tatyana Ponyayeva-Tretyakova,Russian Federation,1,0,0,1,1968
Inna Ryskal,Azerbaijan,1,0,0,1,1968
Roza Salikhova,Russian Federation,1,0,0,1,1968
Tatyana Sarycheva,Russian Federation,1,0,0,1,1968
Nina Smoleyeva,Kazakhstan,1,0,0,1,1968
Oļegs Antropovs,Latvia,1,0,0,1,1968
Vladimir Belyayev,Soviet Union,1,0,0,1,1968
Ivans Bugajenkovs,Latvia,1,0,0,1,1968
Vladimir Ivanov,Soviet Union,1,0,0,1,1968
Valery Kravchenko,Kazakhstan,1,0,0,1,1968
Yevgeny Lapinsky,Soviet Union,1,0,0,1,1968
Vasilijus Matuševas,Lithuania,1,0,0,1,1968
Viktor Mikhalchuk,Soviet Union,1,0,0,1,1968
Georgy Mondzolevsky,Russian Federation,1,0,0,1,1968
Yury Poyarkov,Soviet Union,1,0,0,1,1968
Eduard Sibiryakov,Russian Federation,1,0,0,1,1968
Boris Tereshchuk,Soviet Union,1,0,0,1,1968
Ozren Bonačić,Croatia,1,0,0,1,1968
Dejan Dabović,Montenegro,1,0,0,1,1968
Zdravko Hebel,Croatia,1,0,0,1,1968
Zoran Janković,Serbia,1,0,0,1,1968
Ronald Lopatny,Croatia,1,0,0,1,1968
Uroš Marović,Serbia,1,0,0,1,1968
Đorđe Perišić,Montenegro,1,0,0,1,1968
Miroslav Poljak,Croatia,1,0,0,1,1968
Mirko Sandić,Serbia,1,0,0,1,1968
Karlo Stipanić,Croatia,1,0,0,1,1968
Ivo Trumbić,Croatia,1,0,0,1,1968
Kaarlo Kangasniemi,Finland,1,0,0,1,1968
Mohammad Nassiri,Islamic Republic of Iran,1,0,0,1,1968
Yoshinobu Miyake,Japan,1,0,0,1,1968
Waldemar Baszanowski,Poland,1,0,0,1,1968
Viktor Kurentsov,Russian Federation,1,0,0,1,1968
Boris Selitsky,Russian Federation,1,0,0,1,1968
Leonid Zhabotinsky,Soviet Union,1,0,0,1,1968
Petar Kirov,Bulgaria,1,0,0,1,1968
Boyan Radev,Bulgaria,1,0,0,1,1968
Lothar Metz,East Germany,1,0,0,1,1968
Rudolf Vesper,East Germany,1,0,0,1,1968
István Kozma,Hungary,1,0,0,1,1968
János Varga,Hungary,1,0,0,1,1968
Abdullah Movahed,Islamic Republic of Iran,1,0,0,1,1968
Masaaki Kaneko,Japan,1,0,0,1,1968
Shigeo Nakata,Japan,1,0,0,1,1968
Munji Munemura,Japan,1,0,0,1,1968
Yojiro Uetake,Japan,1,0,0,1,1968
Mahmut Atalay,Turkey,1,0,0,1,1968
Ahmet Ayık,Turkey,1,0,0,1,1968
Boris Gurevich,Soviet Union,1,0,0,1,1968
Aliaksandr Miadved,Belarus,1,0,0,1,1968
Roman Rurua,Georgia,1,0,0,1,1968
Peter Barrett,United States,1,0,0,1,1968
Buddy Friedrichs,United States,1,0,0,1,1968
Barton Jahncke,United States,1,0,0,1,1968
Iain MacDonald-Smith,Great Britain,1,0,0,1,1968
Valentin Mankin,Soviet Union,1,0,0,1,1968
Lowell North,United States,1,0,0,1,1968
Rodney Pattisson,Great Britain,1,0,0,1,1968
Gerry Schreck,United States,1,0,0,1,1968
Jörgen Sundelin,Sweden,1,0,0,1,1968
Peter Sundelin,Sweden,1,0,0,1,1968
Ulf Sundelin,Sweden,1,0,0,1,1968
Maureen Caird,Australia,1,0,0,1,1968
Ralph Doubell,Australia,1,0,0,1,1968
Colette Besson,France,1,0,0,1,1968
Dave Hemery,Great Britain,1,0,0,1,1968
Margitta Helmbold-Gummel,East Germany,1,0,0,1,1968
Christoph Höhne,East Germany,1,0,0,1,1968
Ingrid Mickler-Becker,Germany,1,0,0,1,1968
Angéla Németh-Ránky,Hungary,1,0,0,1,1968
Gyula Zsivótzky,Hungary,1,0,0,1,1968
Amos Biwott,Kenya,1,0,0,1,1968
Lia Manoliu,Romania,1,0,0,1,1968
Viorica Viscopoleanu,Romania,1,0,0,1,1968
Miloslava Hübnerová-Rezková,Czech Republic,1,0,0,1,1968
Vladimir Golubnichy,Soviet Union,1,0,0,1,1968
Jānis Lūsis,Latvia,1,0,0,1,1968
Viktor Saneyev,Georgia,1,0,0,1,1968
Margaret Bailes,United States,1,0,0,1,1968
Madeline Manning-Jackson,United States,1,0,0,1,1968
Mildrette Netter,United States,1,0,0,1,1968
Bob Beamon,United States,1,0,0,1,1968
Willie Davenport,United States,1,0,0,1,1968
Dick Fosbury,United States,1,0,0,1,1968
Randy Matson,United States,1,0,0,1,1968
Vince Matthews,United States,1,0,0,1,1968
Al Oerter,United States,1,0,0,1,1968
Mel Pender,United States,1,0,0,1,1968
Bob Seagren,United States,1,0,0,1,1968
Ronnie Ray Smith,United States,1,0,0,1,1968
Tommie Smith,United States,1,0,0,1,1968
Bill Toomey,United States,1,0,0,1,1968
Elaine Tanner,Canada,0,2,1,3,1968
Vladimir Kosinsky,Russian Federation,0,2,1,3,1968
Grigory Kriss,Soviet Union,0,2,0,2,1968
Daniel Robin,France,0,2,0,2,1968
Leonid Ilyichov,Russian Federation,0,1,2,3,1968
Csaba Giczy,Hungary,0,1,1,2,1968
István Tímár,Hungary,0,1,1,2,1968
Michael Page,United States,0,1,1,2,1968
Gösta Pettersson,Sweden,0,1,1,2,1968
Ildikó Rejtő-Ujlaky-Sági,Hungary,0,1,1,2,1968
Karin Janz,East Germany,0,1,1,2,1968
Erika Zuchold,East Germany,0,1,1,2,1968
Sergey Diomidov,Soviet Union,0,1,1,2,1968
Viktor Klimenko,Russian Federation,0,1,1,2,1968
Pavel Lednyov,Russian Federation,0,1,1,2,1968
Greg Rogers,Australia,0,1,1,2,1968
Bob Windle,Australia,0,1,1,2,1968
Galina Prozumenshchikova-Stepanova,Soviet Union,0,1,1,2,1968
Semyon Belits-Geyman,Russian Federation,0,1,1,2,1968
Georgijs Kuļikovs,Latvia,0,1,1,2,1968
Gerhard Hennige,West Germany,0,1,1,2,1968
Joseph Bessala,Cameroon,0,1,0,1,1968
Rolando Garbey,Cuba,0,1,0,1,1968
Enrique Regüeiferos,Cuba,0,1,0,1,1968
Dragutin Čermak,Serbia,0,1,0,1,1968
Ji Yong-Ju,Republic of Korea,0,1,0,1,1968
Zoran Maroević,Yugoslavia,0,1,0,1,1968
Nikola Plećaš,Croatia,0,1,0,1,1968
Krešimir Ćosić,Croatia,0,1,0,1,1968
Vladimir Cvetković,Serbia,0,1,0,1,1968
Ivo Daneu,Slovenia,0,1,0,1,1968
Radivoj Korać,Serbia,0,1,0,1,1968
Trajko Rajković,Serbia,0,1,0,1,1968
Dragoslav Ražnatović,Serbia,0,1,0,1,1968
Petar Skansi,Croatia,0,1,0,1,1968
Damir Šolman,Croatia,0,1,0,1,1968
Aljoša Žorga,Slovenia,0,1,0,1,1968
Józef Grudzień,Poland,0,1,0,1,1968
Artur Olech,Poland,0,1,0,1,1968
Ion Monea,Romania,0,1,0,1,1968
Eridadi Mukwanga,Uganda,0,1,0,1,1968
Aleksey Kiselyov,Russian Federation,0,1,0,1,1968
Jonas Čepulis,Lithuania,0,1,0,1,1968
Al Robinson,United States,0,1,0,1,1968
Renate Breuer,West Germany,0,1,0,1,1968
Detlef Lewe,Germany,0,1,0,1,1968
Anna Pfeffer,Hungary,0,1,0,1,1968
Katalin Sági-Rozsnyói,Hungary,0,1,0,1,1968
Gyula Petrikovics,Hungary,0,1,0,1,1968
Tamás Wichmann,Hungary,0,1,0,1,1968
Anton Calenic,Romania,0,1,0,1,1968
Dimitrie Ivanov,Romania,0,1,0,1,1968
Haralambie Ivanov,Romania,0,1,0,1,1968
Mihai Țurcaș,Romania,0,1,0,1,1968
Marion Coakes,Great Britain,0,1,0,1,1968
Janou Lefèbvre,France,0,1,0,1,1968
Yelena Petushkova,Russian Federation,0,1,0,1,1968
Kevin Freeman,United States,0,1,0,1,1968
Pierre Jonquères d'Oriola,France,0,1,0,1,1968
Ivan Kalita,Russian Federation,0,1,0,1,1968
J. Michael Plumb,United States,0,1,0,1,1968
Marcel Rozier,France,0,1,0,1,1968
Jimmy Wofford,United States,0,1,0,1,1968
Erik Pettersson,Sweden,0,1,0,1,1968
Sture Pettersson,Sweden,0,1,0,1,1968
Tomas Pettersson,Sweden,0,1,0,1,1968
Niels Fredborg,Denmark,0,1,0,1,1968
Udo Hempel,West Germany,0,1,0,1,1968
Karl-Heinz Henrichs,Germany,0,1,0,1,1968
Jan Jansen,Netherlands,0,1,0,1,1968
Jürgen Kissner,West Germany,0,1,0,1,1968
Karl Link,Germany,0,1,0,1,1968
Leijn Loevesijn,Netherlands,0,1,0,1,1968
Leif Mortensen,Denmark,0,1,0,1,1968
Rainer Podlesch,West Germany,0,1,0,1,1968
Giordano Turrini,Italy,0,1,0,1,1968
Paul Dearing,Australia,0,1,0,1,1968
Ray Evans,Australia,0,1,0,1,1968
Brian Glencross,Australia,0,1,0,1,1968
Robert Haigh,Australia,0,1,0,1,1968
Don Martin,Australia,0,1,0,1,1968
James Mason,Australia,0,1,0,1,1968
Patrick Nilan,Australia,0,1,0,1,1968
Eric Pearce,Australia,0,1,0,1,1968
Gordon Pearce,Australia,0,1,0,1,1968
Julian Pearce,Australia,0,1,0,1,1968
Desmond Piper,Australia,0,1,0,1,1968
Fred Quine,Australia,0,1,0,1,1968
Ron Riley,Australia,0,1,0,1,1968
Don Smart,Australia,0,1,0,1,1968
Ildikó Farkasinszky-Bóbis,Hungary,0,1,0,1,1968
Lídia Dömölky-Sákovics,Hungary,0,1,0,1,1968
Mária Gulácsy,Hungary,0,1,0,1,1968
Paula Marosi,Hungary,0,1,0,1,1968
Pilar Roldán,Mexico,0,1,0,1,1968
Jenő Kamuti,Hungary,0,1,0,1,1968
Wladimiro Calarese,Italy,0,1,0,1,1968
Pierluigi Chicca,Italy,0,1,0,1,1968
Michele Maffei,Italy,0,1,0,1,1968
Rolando Rigoli,Italy,0,1,0,1,1968
Cesare Salvadori,Italy,0,1,0,1,1968
Viktor Modzalevsky,Russian Federation,0,1,0,1,1968
Aleksey Nikanchikov,Belarus,0,1,0,1,1968
Viktor Putyatin,Soviet Union,0,1,0,1,1968
Yury Sisikin,Russian Federation,0,1,0,1,1968
Yury Sharov,Russian Federation,0,1,0,1,1968
Yury Smolyakov,Belarus,0,1,0,1,1968
Vasily Stankovich,Soviet Union,0,1,0,1,1968
German Sveshnikov,Russian Federation,0,1,0,1,1968
Iosif Vitebsky,Soviet Union,0,1,0,1,1968
Georgi Khristakiev,Bulgaria,0,1,0,1,1968
Atanas Mikhaylov,Bulgaria,0,1,0,1,1968
Kiril Khristov,Bulgaria,0,1,0,1,1968
Yancho Dimitrov,Bulgaria,0,1,0,1,1968
Tsvetan Veselinov,Bulgaria,0,1,0,1,1968
Asparukh Donev,Bulgaria,0,1,0,1,1968
Milko Gaydarski,Bulgaria,0,1,0,1,1968
Ivaylo Georgiev,Bulgaria,0,1,0,1,1968
Atanas Gerov,Bulgaria,0,1,0,1,1968
Mikhail Gyonin,Bulgaria,0,1,0,1,1968
Georgi Ivanov,Bulgaria,0,1,0,1,1968
Kiril Ivkov,Bulgaria,0,1,0,1,1968
Evgeni Yanchovski,Bulgaria,0,1,0,1,1968
Petar Zhekov,Bulgaria,0,1,0,1,1968
Stoyan Yordanov,Bulgaria,0,1,0,1,1968
Todor Nikolov,Bulgaria,0,1,0,1,1968
Georgi Vasilev,Bulgaria,0,1,0,1,1968
Ivan Zafirov,Bulgaria,0,1,0,1,1968
Marianna Némethová-Krajčírová,Czechoslovakia,0,1,0,1,1968
Hana Lišková,Czech Republic,0,1,0,1,1968
Jána Kubičková-Posnerová,Czechoslovakia,0,1,0,1,1968
Bohumila Řimnáčová,Czech Republic,0,1,0,1,1968
Miroslava Skleničková,Czech Republic,0,1,0,1,1968
Olli Laiho,Finland,0,1,0,1,1968
Valery Ilyinykh,Russian Federation,0,1,0,1,1968
Valery Karasyov,Russian Federation,0,1,0,1,1968
Viktor Lisitsky,Russian Federation,0,1,0,1,1968
Boris Onishchenko,Soviet Union,0,1,0,1,1968
Stasys Šaparnis,Lithuania,0,1,0,1,1968
Peter Dickson,Australia,0,1,0,1,1968
David Douglas,Australia,0,1,0,1,1968
Alf Duval,Australia,0,1,0,1,1968
Joe Fazio,Australia,0,1,0,1,1968
Alan Grover,Australia,0,1,0,1,1968
Michael Morgan,Australia,0,1,0,1,1968
Gary Pearce,Australia,0,1,0,1,1968
JR Ranch,Australia,0,1,0,1,1968
Bob Shirlaw,Australia,0,1,0,1,1968
Manfred Gelpke,East Germany,0,1,0,1,1968
Roland Göhler,East Germany,0,1,0,1,1968
Klaus Jacob,East Germany,0,1,0,1,1968
Peter Kremtz,East Germany,0,1,0,1,1968
Dieter Semetzky,East Germany,0,1,0,1,1968
Jochen Meißner,West Germany,0,1,0,1,1968
József Csermely,Hungary,0,1,0,1,1968
Antal Melis,Hungary,0,1,0,1,1968
Zoltán Melis,Hungary,0,1,0,1,1968
György Sarlós,Hungary,0,1,0,1,1968
Harry Droog,Netherlands,0,1,0,1,1968
Rody Rijnders,Netherlands,0,1,0,1,1968
Herman Suselbeek,Netherlands,0,1,0,1,1968
Leendert van Dis,Netherlands,0,1,0,1,1968
Hadriaan van Nes,Netherlands,0,1,0,1,1968
Larry Hough,United States,0,1,0,1,1968
Tony Johnson,United States,0,1,0,1,1968
Heinz Mertel,West Germany,0,1,0,1,1968
László Hammerl,Hungary,0,1,0,1,1968
Romano Garagnani,Italy,0,1,0,1,1968
Marcel Roșca,Romania,0,1,0,1,1968
Valentin Kornev,Russian Federation,0,1,0,1,1968
Tom Garrigus,United States,0,1,0,1,1968
John Writer,United States,0,1,0,1,1968
Judy Playfair,Australia,0,1,0,1,1968
Jenny Steinbeck,Australia,0,1,0,1,1968
Lynne Watson,Australia,0,1,0,1,1968
Graham White,Australia,0,1,0,1,1968
Ralph Hutton,Canada,0,1,0,1,1968
Martyn Woodroffe,Great Britain,0,1,0,1,1968
Martina Grunert,East Germany,0,1,0,1,1968
Roswitha Krause,East Germany,0,1,0,1,1968
Helga Lindner,East Germany,0,1,0,1,1968
Uta Schmuck,East Germany,0,1,0,1,1968
Gabriele Wetzko,East Germany,0,1,0,1,1968
Horst-Günter Gregor,East Germany,0,1,0,1,1968
Egon Henninger,East Germany,0,1,0,1,1968
Frank Wiegand,East Germany,0,1,0,1,1968
Álvaro Gaxiola,Mexico,0,1,0,1,1968
Tamara Fedosova-Pogozheva-Safonova,Russian Federation,0,1,0,1,1968
Nataliya Kuznetsova-Lobanova,Russian Federation,0,1,0,1,1968
Viktor Mazanov,Russian Federation,0,1,0,1,1968
Pam Kruse,United States,0,1,0,1,1968
Lynn Vidali,United States,0,1,0,1,1968
Greg Buckingham,United States,0,1,0,1,1968
Gary Hall,United States,0,1,0,1,1968
Mitch Ivey,United States,0,1,0,1,1968
John Kinsella,United States,0,1,0,1,1968
Sachiko Fukunaka,Japan,0,1,0,1,1968
Keiko Hama,Japan,0,1,0,1,1968
Setsuko Inoue,Japan,0,1,0,1,1968
Toyoko Iwahara,Japan,0,1,0,1,1968
Yukiyo Kojima,Japan,0,1,0,1,1968
Sumie Oinuma,Japan,0,1,0,1,1968
Kunie Shishikura,Japan,0,1,0,1,1968
Suzue Takayama,Japan,0,1,0,1,1968
Setsuko Yoshida,Japan,0,1,0,1,1968
Kenji Kimura,Japan,0,1,0,1,1968
Isao Koizumi,Japan,0,1,0,1,1968
Masayuki Minami,Japan,0,1,0,1,1968
Yasuaki Mitsumori,Japan,0,1,0,1,1968
Jungo Morita,Japan,0,1,0,1,1968
Katsutoshi Nekoda,Japan,0,1,0,1,1968
Seiji Oko,Japan,0,1,0,1,1968
Tetsuo Sato,Japan,0,1,0,1,1968
Kenji Shimaoka,Japan,0,1,0,1,1968
Mamoru Shiragami,Japan,0,1,0,1,1968
Tadayoshi Yokota,Japan,0,1,0,1,1968
Aleksey Barkalov,Soviet Union,0,1,0,1,1968
Oleg Bovin,Russian Federation,0,1,0,1,1968
Aleksandr Dolgushin,Russian Federation,0,1,0,1,1968
Yury Grigorovsky,Russian Federation,0,1,0,1,1968
Boris Grishin,Russian Federation,0,1,0,1,1968
Vadim Gulyayev,Russian Federation,0,1,0,1,1968
Leonid Osipov,Russian Federation,0,1,0,1,1968
Vladimir Semyonov,Russian Federation,0,1,0,1,1968
Aleksandr Shidlovsky,Russian Federation,0,1,0,1,1968
Vyacheslav Skok,Russian Federation,0,1,0,1,1968
Givi Chikvanaia,Georgia,0,1,0,1,1968
Serge Reding,Belgium,0,1,0,1,1968
Imre Földi,Hungary,0,1,0,1,1968
Parviz Jalayer,Islamic Republic of Iran,0,1,0,1,1968
Masashi Ohuchi,Japan,0,1,0,1,1968
Vladimir Belyayev,Soviet Union,0,1,0,1,1968
Dito Shanidze,Georgia,0,1,0,1,1968
Jaan Talts,Estonia,0,1,0,1,1968
Osman Duraliev,Bulgaria,0,1,0,1,1968
Enyu Todorov,Bulgaria,0,1,0,1,1968
Enyu Valchev,Bulgaria,0,1,0,1,1968
Hideo Fujimoto,Japan,0,1,0,1,1968
Jigjidiin Mönkhbat,Mongolia,0,1,0,1,1968
Ion Baciu,Romania,0,1,0,1,1968
Vladimir Bakulin,Kazakhstan,0,1,0,1,1968
Nikolay Yakovenko,Russian Federation,0,1,0,1,1968
Shota Lomidze,Georgia,0,1,0,1,1968
Valentin Olenik,Russian Federation,0,1,0,1,1968
Anatoly Roshchin,Russian Federation,0,1,0,1,1968
Don Behm,United States,0,1,0,1,1968
Rich Sanders,United States,0,1,0,1,1968
Stevan Horvat,Serbia,0,1,0,1,1968
Aage Birch,Denmark,0,1,0,1,1968
Bernard Dunand,Switzerland,0,1,0,1,1968
Paul Lindemark Jørgensen,Denmark,0,1,0,1,1968
Ulli Libor,West Germany,0,1,0,1,1968
"Peder Lunde, Jr.",Norway,0,1,0,1,1968
Niels Markussen,Denmark,0,1,0,1,1968
Peter Naumann,West Germany,0,1,0,1,1968
Louis Noverraz,Switzerland,0,1,0,1,1968
Hubert Raudaschl,Austria,0,1,0,1,1968
Marcel Stern,Switzerland,0,1,0,1,1968
Per Olav Wiken,Norway,0,1,0,1,1968
Raelene Boyle,Australia,0,1,0,1,1968
Pam Kilborn-Ryan,Australia,0,1,0,1,1968
Peter Norman,Australia,0,1,0,1,1968
Liese Sykora-Prokop,Austria,0,1,0,1,1968
Nélson Prudêncio,Brazil,0,1,0,1,1968
Miguelina Cobián,Cuba,0,1,0,1,1968
Marlene Elejalde,Cuba,0,1,0,1,1968
Violeta Quesada,Cuba,0,1,0,1,1968
Fulgencia Romay,Cuba,0,1,0,1,1968
Enrique Figuerola,Cuba,0,1,0,1,1968
Pablo Montes,Cuba,0,1,0,1,1968
Juan Morales,Cuba,0,1,0,1,1968
Hermes Ramírez,Cuba,0,1,0,1,1968
Jorma Kinnunen,Finland,0,1,0,1,1968
Lillian Board,Great Britain,0,1,0,1,1968
Sheila Parkin-Sherwood,Great Britain,0,1,0,1,1968
Marita Lange,East Germany,0,1,0,1,1968
Klaus Beer,East Germany,0,1,0,1,1968
Lothar Milde,East Germany,0,1,0,1,1968
Liesel Westermann,West Germany,0,1,0,1,1968
Claus Schiprowski,West Germany,0,1,0,1,1968
Hans-Joachim Walde,Germany,0,1,0,1,1968
Antal Kiss,Hungary,0,1,0,1,1968
Lennox Miller,Jamaica,0,1,0,1,1968
Kenji Kimihara,Japan,0,1,0,1,1968
Charles Asati,Kenya,0,1,0,1,1968
Naftali Bon,Kenya,0,1,0,1,1968
Wilson Kiprugut,Kenya,0,1,0,1,1968
Benjamin Kogo,Kenya,0,1,0,1,1968
Munyoro Nyamau,Kenya,0,1,0,1,1968
Daniel Rudisha,Kenya,0,1,0,1,1968
José Pedraza,Mexico,0,1,0,1,1968
Mihaela Peneș,Romania,0,1,0,1,1968
Ileana Silai,Romania,0,1,0,1,1968
Antonina Okorokova-Lazareva,Russian Federation,0,1,0,1,1968
Romuald Klim,Belarus,0,1,0,1,1968
Ed Caruthers,United States,0,1,0,1,1968
Erv Hall,United States,0,1,0,1,1968
Jim Ryun,United States,0,1,0,1,1968
George Woods,United States,0,1,0,1,1968
Tibor Pézsa,Hungary,0,0,2,2,1968
John Ferris,United States,0,0,2,2,1968
Ivan Mikhaylov,Bulgaria,0,0,1,1,1968
Georgi Stankov,Bulgaria,0,0,1,1,1968
Arto Nilsson,Finland,0,0,1,1,1968
Günther Meier,West Germany,0,0,1,1,1968
Giorgio Bambini,Italy,0,0,1,1,1968
Eiji Morioka,Japan,0,0,1,1,1968
Philip Waruinge,Kenya,0,0,1,1,1968
Jang Sun-Gil,Republic of Korea,0,0,1,1,1968
Joaquín Rocha,Mexico,0,0,1,1,1968
Agustín Zaragoza,Mexico,0,0,1,1,1968
Mario Guilloti,Argentina,0,0,1,1,1968
Vladimir Andreyev,Russian Federation,0,0,1,1,1968
Sergey Belov,Russian Federation,0,0,1,1,1968
Vadim Kapranov,Russian Federation,0,0,1,1,1968
Sergey Kovalenko,Soviet Union,0,0,1,1,1968
Anatoli Krikun,Estonia,0,0,1,1,1968
Jaak Lipso,Estonia,0,0,1,1,1968
Modestas Paulauskas,Lithuania,0,0,1,1,1968
Anatoly Polivoda,Soviet Union,0,0,1,1,1968
Zurab Sak'andelidze,Georgia,0,0,1,1,1968
Yury Selikhov,Russian Federation,0,0,1,1,1968
Priit Tomson,Estonia,0,0,1,1,1968
Gennady Volnov,Russian Federation,0,0,1,1,1968
Servilio de Oliveira,Brazil,0,0,1,1,1968
Stanisław Dragan,Poland,0,0,1,1,1968
Hubert Skrzypczak,Poland,0,0,1,1,1968
Calistrat Cuțov,Romania,0,0,1,1,1968
Leo Rwabwogo,Uganda,0,0,1,1,1968
Vladimir Musalimov,Soviet Union,0,0,1,1,1968
Johnny Baldwin,United States,0,0,1,1,1968
Al Jones,United States,0,0,1,1,1968
Harlan Marbley,United States,0,0,1,1,1968
Jim Wallington,United States,0,0,1,1,1968
Zvonko Vujin,Serbia,0,0,1,1,1968
Günther Pfaff,Austria,0,0,1,1,1968
Gerhard Seibold,Austria,0,0,1,1,1968
Erik Hansen,Denmark,0,0,1,1,1968
István Csizmadia,Hungary,0,0,1,1,1968
Imre Szöllősi,Hungary,0,0,1,1,1968
Viorica Dumitru,Romania,0,0,1,1,1968
Antonina Seredina,Russian Federation,0,0,1,1,1968
Vitaly Galkov,Russian Federation,0,0,1,1,1968
Naum Prokupets,Republic of Moldova,0,0,1,1,1968
Mikhail Zamotin,Russian Federation,0,0,1,1,1968
Marianne Gossweiler,Switzerland,0,0,1,1,1968
David Broome,Great Britain,0,0,1,1,1968
Henri Chammartin,Switzerland,0,0,1,1,1968
Brien Cobcroft,Australia,0,0,1,1,1968
Gustav Fischer,Switzerland,0,0,1,1,1968
Bill Roycroft,Australia,0,0,1,1,1968
Wayne Roycroft,Australia,0,0,1,1,1968
James Scanlon,Australia,0,0,1,1,1968
Alwin Schockemöhle,Germany,0,0,1,1,1968
Hermann Schridde,Germany,0,0,1,1,1968
Hans Günter Winkler,Germany,0,0,1,1,1968
Lorenzo Bosisio,Italy,0,0,1,1,1968
Giovanni Bramucci,Italy,0,0,1,1,1968
Cipriano Chemello,Italy,0,0,1,1,1968
Daniel Goens,Belgium,0,0,1,1,1968
Janusz Kierzkowski,Poland,0,0,1,1,1968
Xaver Kurmann,Switzerland,0,0,1,1,1968
Vittorio Marcelli,Italy,0,0,1,1,1968
Giorgio Morbiato,Italy,0,0,1,1,1968
Luigi Roncaglia,Italy,0,0,1,1,1968
Mauro Simonetti,Italy,0,0,1,1,1968
Robert Van Lancker,Belgium,0,0,1,1,1968
Rajendra Christy,India,0,0,1,1,1968
Krishnamurty Perumal,India,0,0,1,1,1968
V. J. Peter,India,0,0,1,1,1968
Inam-ur Rahman,India,0,0,1,1,1968
Munir Sait,India,0,0,1,1,1968
Ajitpal Singh,India,0,0,1,1,1968
Balbir Singh,India,0,0,1,1,1968
Balbir Singh,India,0,0,1,1,1968
Balbir Singh,India,0,0,1,1,1968
Gurbux Singh,India,0,0,1,1,1968
Harbinder Singh,India,0,0,1,1,1968
Harmik Singh,India,0,0,1,1,1968
Gogi Singh,India,0,0,1,1,1968
Jagjit Singh,India,0,0,1,1,1968
Prithipal Singh,India,0,0,1,1,1968
Tarsem Singh,India,0,0,1,1,1968
Ana Derșidan-Ene-Pascu,Romania,0,0,1,1,1968
Ileana Gyulai-Drîmbă-Jenei,Romania,0,0,1,1,1968
Ecaterina Stahl-Iencic,Romania,0,0,1,1,1968
Olga Orban-Szabo,Romania,0,0,1,1,1968
Maria Vicol,Romania,0,0,1,1,1968
Péter Bakonyi,Hungary,0,0,1,1,1968
János Kalmár,Hungary,0,0,1,1,1968
Tamás Kovács,Hungary,0,0,1,1,1968
Miklós Meszéna,Hungary,0,0,1,1,1968
Gianluigi Saccaro,Italy,0,0,1,1,1968
Bohdan Andrzejewski,Poland,0,0,1,1,1968
Kazimierz Barburski,Poland,0,0,1,1,1968
Michał Butkiewicz,Poland,0,0,1,1,1968
Egon Franke,Poland,0,0,1,1,1968
Bogdan Gonsior,Poland,0,0,1,1,1968
Adam Lisewski,Poland,0,0,1,1,1968
Henryk Nielaba,Poland,0,0,1,1,1968
Ryszard Parulski,Poland,0,0,1,1,1968
Zbigniew Skrudlik,Poland,0,0,1,1,1968
Witold Woyda,Poland,0,0,1,1,1968
Kunishige Kamamoto,Japan,0,0,1,1,1968
Mitsuo Kamata,Japan,0,0,1,1,1968
Hiroshi Katayama,Japan,0,0,1,1,1968
Yasuyuki Kuwahara,Japan,0,0,1,1,1968
Ikuo Matsumoto,Japan,0,0,1,1,1968
Masakatsu Miyamoto,Japan,0,0,1,1,1968
Teruki Miyamoto,Japan,0,0,1,1,1968
Takaji Mori,Japan,0,0,1,1,1968
Aritatsu Ogi,Japan,0,0,1,1,1968
Ryuichi Sugiyama,Japan,0,0,1,1,1968
Kiyoshi Tomizawa,Japan,0,0,1,1,1968
Masashi Watanabe,Japan,0,0,1,1,1968
Shigeo Yaegashi,Japan,0,0,1,1,1968
Yoshitada Yamaguchi,Japan,0,0,1,1,1968
Kenzo Yokoyama,Japan,0,0,1,1,1968
Eizo Yuguchi,Japan,0,0,1,1,1968
Maritta Bauerschmidt,East Germany,0,0,1,1,1968
Marianne Noack,East Germany,0,0,1,1,1968
Magdalena Schmidt,East Germany,0,0,1,1,1968
Ute Starke,East Germany,0,0,1,1,1968
Günter Beier,East Germany,0,0,1,1,1968
Matthias Brehme,East Germany,0,0,1,1,1968
Gerhard Dietrich,East Germany,0,0,1,1,1968
Siegfried Fülle,East Germany,0,0,1,1,1968
Klaus Köste,East Germany,0,0,1,1,1968
Peter Weber,East Germany,0,0,1,1,1968
Jean-Pierre Giudicelli,France,0,0,1,1,1968
Raoul Gueguen,France,0,0,1,1,1968
Lucien Guiguet,France,0,0,1,1,1968
Alberto Demiddi,Argentina,0,0,1,1,1968
Peter Fich Christiansen,Denmark,0,0,1,1,1968
Harry Jørgensen,Denmark,0,0,1,1,1968
Jørn Krab,Denmark,0,0,1,1,1968
Preben Krab,Denmark,0,0,1,1,1968
Ib Larsen,Denmark,0,0,1,1,1968
Abramo Albini,Italy,0,0,1,1,1968
Tullio Baraglia,Italy,0,0,1,1,1968
Renato Bosatta,Italy,0,0,1,1,1968
Pier Angelo Conti-Manzini,Italy,0,0,1,1,1968
Peter Bolliger,Switzerland,0,0,1,1,1968
Gottlieb Fröhlich,Switzerland,0,0,1,1,1968
Jakob Grob,Switzerland,0,0,1,1,1968
Denis Oswald,Switzerland,0,0,1,1,1968
Hugo Waser,Switzerland,0,0,1,1,1968
Antanas Bagdonavičius,Lithuania,0,0,1,1,1968
Vytautas Briedis,Lithuania,0,0,1,1,1968
Juozas Jagelavičius,Lithuania,0,0,1,1,1968
Zigmas Jukna,Lithuania,0,0,1,1,1968
Valentin Kravchuk,Soviet Union,0,0,1,1,1968
Yury Lorentsson,Russian Federation,0,0,1,1,1968
Aleksandr Martyshkin,Russian Federation,0,0,1,1,1968
Vladimir Sterlik,Soviet Union,0,0,1,1,1968
Viktor Suslin,Russian Federation,0,0,1,1,1968
Bill Maher,United States,0,0,1,1,1968
John Nunn,United States,0,0,1,1,1968
Kurt Czekalla,East Germany,0,0,1,1,1968
Harald Vollmar,East Germany,0,0,1,1,1968
Konrad Wirnhier,West Germany,0,0,1,1,1968
Ian Ballinger,New Zealand,0,0,1,1,1968
Kurt Müller,Switzerland,0,0,1,1,1968
Vitaly Parkhimovich,Belarus,0,0,1,1,1968
Renart Suleymanov,Russian Federation,0,0,1,1,1968
Karen Moras,Australia,0,0,1,1,1968
Greg Brough,Australia,0,0,1,1,1968
Robert Cusack,Australia,0,0,1,1,1968
Marilyn Corson,Canada,0,0,1,1,1968
Angela Coughlan,Canada,0,0,1,1,1968
Marion Lay,Canada,0,0,1,1,1968
Alain Mosconi,France,0,0,1,1,1968
Sabine Steinbach,East Germany,0,0,1,1,1968
Uta Frommater,West Germany,0,0,1,1,1968
Heike Hustede-Nagel,Germany,0,0,1,1,1968
Angelika Kraus,West Germany,0,0,1,1,1968
Heidi Reineck,West Germany,0,0,1,1,1968
Mike Holthaus,West Germany,0,0,1,1,1968
María Teresa Ramírez,Mexico,0,0,1,1,1968
Vladimir Bure,Russian Federation,0,0,1,1,1968
Yury Gromak,Soviet Union,0,0,1,1,1968
Vladimir Nemshilov,Russian Federation,0,0,1,1,1968
Nikolay Pankin,Russian Federation,0,0,1,1,1968
Keala O'Sullivan,United States,0,0,1,1,1968
Ann Peterson,United States,0,0,1,1,1968
Susan Shields,United States,0,0,1,1,1968
Jane Swagerty,United States,0,0,1,1,1968
Jim Henry,United States,0,0,1,1,1968
Jack Horsley,United States,0,0,1,1,1968
Brian Job,United States,0,0,1,1,1968
Ronnie Mills,United States,0,0,1,1,1968
Ross Wales,United States,0,0,1,1,1968
Win Young,United States,0,0,1,1,1968
Halina Aszkiełowicz,Poland,0,0,1,1,1968
Lidia Chmielnicka,Poland,0,0,1,1,1968
Krystyna Czajkowska-Rawska,Poland,0,0,1,1,1968
Barbara Hermel-Niemczyk,Poland,0,0,1,1,1968
Krystyna Jakubowska,Poland,0,0,1,1,1968
Krystyna Krupa,Poland,0,0,1,1,1968
Józefa Ledwig,Poland,0,0,1,1,1968
Jadwiga Marko-Książek,Poland,0,0,1,1,1968
Krystyna Ostromęcka-Guryn,Poland,0,0,1,1,1968
Elżbieta Porzec-Nowak,Poland,0,0,1,1,1968
Zofia Szcześniewska,Poland,0,0,1,1,1968
Wanda Wiecha-Wanot,Poland,0,0,1,1,1968
Bohumil Golián,Czechoslovakia,0,0,1,1,1968
Zdeněk Groessl,Czech Republic,0,0,1,1,1968
Petr Kop,Czech Republic,0,0,1,1,1968
Drahomír Koudelka,Czech Republic,0,0,1,1,1968
Josef Musil,Czech Republic,0,0,1,1,1968
Vladimír Petlák,Czech Republic,0,0,1,1,1968
Antonín Procházka,Czech Republic,0,0,1,1,1968
Pavel Schenk,Czech Republic,0,0,1,1,1968
Josef Smolka,Czech Republic,0,0,1,1,1968
František Sokol,Czech Republic,0,0,1,1,1968
Jiří Svoboda,Czech Republic,0,0,1,1,1968
Lubomír Zajíček,Czech Republic,0,0,1,1,1968
András Bodnár,Hungary,0,0,1,1,1968
Zoltán Dömötör,Hungary,0,0,1,1,1968
László Felkai,Hungary,0,0,1,1,1968
Ferenc Konrád,Hungary,0,0,1,1,1968
János Konrád,Hungary,0,0,1,1,1968
Mihály Mayer,Hungary,0,0,1,1,1968
Endre Molnár,Hungary,0,0,1,1,1968
Dénes Pócsik,Hungary,0,0,1,1,1968
László Sárosi,Hungary,0,0,1,1,1968
János Steinmetz,Hungary,0,0,1,1,1968
"István Szívós, Jr.",Hungary,0,0,1,1,1968
Károly Bakos,Hungary,0,0,1,1,1968
Yoshiyuki Miyake,Japan,0,0,1,1,1968
Marek Gołąb,Poland,0,0,1,1,1968
Norbert Ozimek,Poland,0,0,1,1,1968
Henryk Trębicki,Poland,0,0,1,1,1968
Marian Zieliński,Poland,0,0,1,1,1968
Joe Dube,United States,0,0,1,1,1968
Prodan Gardzhev,Bulgaria,0,0,1,1,1968
Wilfried Dietrich,Germany,0,0,1,1,1968
Petros Galaktopoulos,Greece,0,0,1,1,1968
Károly Bajkó,Hungary,0,0,1,1,1968
József Csatári,Hungary,0,0,1,1,1968
Abutaleb Talebi,Islamic Republic of Iran,0,0,1,1,1968
Shamseddin Seyyed Abbasi,Islamic Republic of Iran,0,0,1,1,1968
Danzandarjaagiin Sereeter,Mongolia,0,0,1,1,1968
Chimedbazaryn Damdinsharav,Mongolia,0,0,1,1,1968
Tömöriin Artag,Mongolia,0,0,1,1,1968
Nicolae Martinescu,Romania,0,0,1,1,1968
Simion Popescu,Romania,0,0,1,1,1968
Petr Kment,Czech Republic,0,0,1,1,1968
Miroslav Zeman,Czech Republic,0,0,1,1,1968
Ivan Kochergin,Russian Federation,0,0,1,1,1968
Branislav Simić,Serbia,0,0,1,1,1968
Robin Aisher,Great Britain,0,0,1,1,1968
Fabio Albarelli,Italy,0,0,1,1,1968
Paul Anderson,Great Britain,0,0,1,1,1968
Paul Borowski,East Germany,0,0,1,1,1968
Franco Cavallo,Italy,0,0,1,1,1968
Reinaldo Conrad,Brazil,0,0,1,1,1968
Burkhard Cordes,Brazil,0,0,1,1,1968
Camillo Gargano,Italy,0,0,1,1,1968
Adrian Jardine,Great Britain,0,0,1,1,1968
Karl-Heinz Thun,East Germany,0,0,1,1,1968
Konrad Weichert,East Germany,0,0,1,1,1968
Jennifer Lamy,Australia,0,0,1,1,1968
Eva Janko,Austria,0,0,1,1,1968
Roger Bambuck,France,0,0,1,1,1968
Jocelyn Delecour,France,0,0,1,1,1968
Gérard Fenouil,France,0,0,1,1,1968
Claude Piquemal,France,0,0,1,1,1968
John Sherwood,Great Britain,0,0,1,1,1968
Wolfgang Nordwig,East Germany,0,0,1,1,1968
Kurt Bendlin,West Germany,0,0,1,1,1968
Martin Jellinghaus,West Germany,0,0,1,1,1968
Manfred Kinder,Germany,0,0,1,1,1968
Helmar Müller,West Germany,0,0,1,1,1968
Bodo Tümmler,West Germany,0,0,1,1,1968
Jolán Kleiber-Kontsek,Hungary,0,0,1,1,1968
Annamária Kovács-Tóth,Hungary,0,0,1,1,1968
Gergely Kulcsár,Hungary,0,0,1,1,1968
Lázár Lovász,Hungary,0,0,1,1,1968
Giuseppe Gentile,Italy,0,0,1,1,1968
Eddy Ottoz,Italy,0,0,1,1,1968
Mia Gommers,Netherlands,0,0,1,1,1968
Mike Ryan,New Zealand,0,0,1,1,1968
Ludvík Daněk,Czech Republic,0,0,1,1,1968
Chi Cheng,Chinese Taipei,0,0,1,1,1968
Galina Bukharina,Russian Federation,0,0,1,1,1968
Nataliya Pechonkina-Chistyakova,Russian Federation,0,0,1,1,1968
Nadezhda Chizhova,Russian Federation,0,0,1,1,1968
Lyudmila Ignatyeva-Samotyosova,Russian Federation,0,0,1,1,1968
Valentina Kozyr,Soviet Union,0,0,1,1,1968
Vera Popkova,Soviet Union,0,0,1,1,1968
Lyudmila Zharkova-Maslakova,Russian Federation,0,0,1,1,1968
Tatyana Talysheva,Russian Federation,0,0,1,1,1968
Valentin Gavrilov,Russian Federation,0,0,1,1,1968
Eduard Gushchin,Russian Federation,0,0,1,1,1968
Nikolay Smaga,Soviet Union,0,0,1,1,1968
Ralph Boston,United States,0,0,1,1,1968
John Carlos,United States,0,0,1,1,1968
Tom Farrell,United States,0,0,1,1,1968
George Young,United States,0,0,1,1,1968
Larry Young,United States,0,0,1,1,1968
Gino Pancino,Italy,0,0,1,1,1968
Mark Spitz,United States,7,0,0,7,1972
Sawao Kato,Japan,3,2,0,5,1972
Shane Gould,Australia,3,1,1,5,1972
Olga Korbut,Belarus,3,1,0,4,1972
Melissa Belote,United States,3,0,0,3,1972
Sandy Neilson,United States,3,0,0,3,1972
Karin Janz,East Germany,2,2,1,5,1972
Lyudmila Turishcheva,Russian Federation,2,1,1,4,1972
Akinori Nakayama,Japan,2,1,1,4,1972
Roland Matthes,East Germany,2,1,1,4,1972
Jerry Heidenreich,United States,2,1,1,4,1972
Renate Stecher,East Germany,2,1,0,3,1972
Heide Rosendahl,West Germany,2,1,0,3,1972
Valery Borzov,Soviet Union,2,1,0,3,1972
Mitsuo Tsukahara,Japan,2,0,1,3,1972
Richard Meade,Great Britain,2,0,0,2,1972
Csaba Fenyvesi,Hungary,2,0,0,2,1972
Witold Woyda,Poland,2,0,0,2,1972
Wim Ruska,Netherlands,2,0,0,2,1972
Gunnar Larsson,Sweden,2,0,0,2,1972
Cathy Carr,United States,2,0,0,2,1972
Lasse Virén,Finland,2,0,0,2,1972
Monika Zehrt,East Germany,2,0,0,2,1972
Viktor Klimenko,Russian Federation,1,2,0,3,1972
Shirley Babashoff,United States,1,2,0,3,1972
Steve Genter,United States,1,2,0,3,1972
Mike Stamm,United States,1,2,0,3,1972
Tamara Lazakovich,Belarus,1,1,2,4,1972
Shigeru Kasamatsu,Japan,1,1,2,4,1972
Eizo Kenmotsu,Japan,1,1,2,4,1972
Nikolay Andrianov,Russian Federation,1,1,1,3,1972
Ivan Patzaichin,Romania,1,1,0,2,1972
Liselott Linsenhoff,Germany,1,1,0,2,1972
Yelena Petushkova,Russian Federation,1,1,0,2,1972
Viktor Sidyak,Belarus,1,1,0,2,1972
András Balczó,Hungary,1,1,0,2,1972
Boris Onishchenko,Soviet Union,1,1,0,2,1972
Ulrika Knape,Sweden,1,1,0,2,1972
Tom Bruce,United States,1,1,0,2,1972
Kip Keino,Kenya,1,1,0,2,1972
Larry Black,United States,1,1,0,2,1972
Robert Taylor,United States,1,1,0,2,1972
Graziano Mancinelli,Italy,1,0,1,2,1972
Galina Gorokhova,Russian Federation,1,0,1,2,1972
Győző Kulcsár,Hungary,1,0,1,2,1972
Klaus Köste,East Germany,1,0,1,2,1972
Pavel Lednyov,Russian Federation,1,0,1,2,1972
Beverley Whitfield,Australia,1,0,1,2,1972
Nobutaka Taguchi,Japan,1,0,1,2,1972
Keena Rothhammer,United States,1,0,1,2,1972
John Hencken,United States,1,0,1,2,1972
John Murphy,United States,1,0,1,2,1972
Hildegard Falck,West Germany,1,0,1,2,1972
Julius Sang,Kenya,1,0,1,2,1972
Georgi Kostadinov,Bulgaria,1,0,0,1,1972
Emilio Correa,Cuba,1,0,0,1,1972
Orlando Martínez,Cuba,1,0,0,1,1972
Teófilo Stevenson,Cuba,1,0,0,1,1972
Doreen Wilber,United States,1,0,0,1,1972
John Williams,United States,1,0,0,1,1972
Ivan Yedeshko,Belarus,1,0,0,1,1972
Dieter Kottysch,West Germany,1,0,0,1,1972
György Gedó,Hungary,1,0,0,1,1972
Aleksandr Belov,Russian Federation,1,0,0,1,1972
Sergey Belov,Russian Federation,1,0,0,1,1972
Aleksandr Boloshev,Russian Federation,1,0,0,1,1972
Ivan Dvorny,Russian Federation,1,0,0,1,1972
Mikheil Korkia,Georgia,1,0,0,1,1972
Sergey Kovalenko,Soviet Union,1,0,0,1,1972
Modestas Paulauskas,Lithuania,1,0,0,1,1972
Anatoly Polivoda,Soviet Union,1,0,0,1,1972
Zurab Sak'andelidze,Georgia,1,0,0,1,1972
Alzhan Zharmukhamedov,Russian Federation,1,0,0,1,1972
Gennady Volnov,Russian Federation,1,0,0,1,1972
Jan Szczepański,Poland,1,0,0,1,1972
Boris Kuznetsov,Russian Federation,1,0,0,1,1972
Vyacheslav Lemeshev,Russian Federation,1,0,0,1,1972
Ray Seales,United States,1,0,0,1,1972
Mate Parlov,Croatia,1,0,0,1,1972
Angelika Bahmann,East Germany,1,0,0,1,1972
Rolf-Dieter Amend,East Germany,1,0,0,1,1972
Reinhard Eiben,East Germany,1,0,0,1,1972
Walter Hofmann,East Germany,1,0,0,1,1972
Siegbert Horn,East Germany,1,0,0,1,1972
Yekaterina Kuryshko,Soviet Union,1,0,0,1,1972
Lyudmila Khvedosyuk-Pinayeva,Russian Federation,1,0,0,1,1972
Yuliya Ryabchinskaya,Soviet Union,1,0,0,1,1972
Valery Didenko,Russian Federation,1,0,0,1,1972
Yury Filatov,Soviet Union,1,0,0,1,1972
Nikolay Gorbachov,Belarus,1,0,0,1,1972
Vikt'or K'rat'asiuk'i,Georgia,1,0,0,1,1972
Yury Lobanov,Soviet Union,1,0,0,1,1972
Vladimir Morozov,Soviet Union,1,0,0,1,1972
Aleksandr Shaparenko,Soviet Union,1,0,0,1,1972
Yury Stetsenko,Soviet Union,1,0,0,1,1972
Vladas Česiūnas,Lithuania,1,0,0,1,1972
Mary Gordon-Watson,Great Britain,1,0,0,1,1972
Bridget Parker,Great Britain,1,0,0,1,1972
Ivan Kalita,Russian Federation,1,0,0,1,1972
Ivan Kizimov,Russian Federation,1,0,0,1,1972
Fritz Ligges,Germany,1,0,0,1,1972
Mark Phillips,Great Britain,1,0,0,1,1972
Hartwig Steenken,West Germany,1,0,0,1,1972
Gerd Wiltfang,West Germany,1,0,0,1,1972
Hans Günter Winkler,Germany,1,0,0,1,1972
Jürgen Colombo,West Germany,1,0,0,1,1972
Niels Fredborg,Denmark,1,0,0,1,1972
Günter Haritz,West Germany,1,0,0,1,1972
Udo Hempel,West Germany,1,0,0,1,1972
Valery Yardy,Russian Federation,1,0,0,1,1972
Knut Knudsen,Norway,1,0,0,1,1972
Gennady Komnatov,Russian Federation,1,0,0,1,1972
Hennie Kuiper,Netherlands,1,0,0,1,1972
Valery Likhachov,Russian Federation,1,0,0,1,1972
Daniel Morelon,France,1,0,0,1,1972
Günther Schumacher,West Germany,1,0,0,1,1972
Vladimir Semenets,Soviet Union,1,0,0,1,1972
Boris Shukhov,Russian Federation,1,0,0,1,1972
Igor Tselovalnikov,Soviet Union,1,0,0,1,1972
Peter Vonhof,West Germany,1,0,0,1,1972
Wolfgang Baumgart,West Germany,1,0,0,1,1972
Horst Dröse,West Germany,1,0,0,1,1972
Dieter Freise,West Germany,1,0,0,1,1972
Carsten Keller,Germany,1,0,0,1,1972
Detlev Kittstein,West Germany,1,0,0,1,1972
Ulrich Klaes,West Germany,1,0,0,1,1972
Peter Kraus,West Germany,1,0,0,1,1972
Michael Krause,Germany,1,0,0,1,1972
Werner Kaessmann,West Germany,1,0,0,1,1972
Michael Peter,West Germany,1,0,0,1,1972
Wolfgang Rott,West Germany,1,0,0,1,1972
Fritz Schmidt,West Germany,1,0,0,1,1972
Rainer Seifert,West Germany,1,0,0,1,1972
Wolfgang Strödter,West Germany,1,0,0,1,1972
Eckardt Suhl,West Germany,1,0,0,1,1972
Eduard Thelen,West Germany,1,0,0,1,1972
Peter Trump,West Germany,1,0,0,1,1972
Uli Vos,West Germany,1,0,0,1,1972
Antonella Ragno-Lonzi,Italy,1,0,0,1,1972
Yelena Novikova-Belova,Belarus,1,0,0,1,1972
Tatyana Petrenko-Samusenko,Belarus,1,0,0,1,1972
Svetlana Tširkova,Estonia,1,0,0,1,1972
Aleksandra Zabelina,Russian Federation,1,0,0,1,1972
Sándor Erdős,Hungary,1,0,0,1,1972
István Osztrics,Hungary,1,0,0,1,1972
Pál Schmitt,Hungary,1,0,0,1,1972
Michele Maffei,Italy,1,0,0,1,1972
Mario Aldo Montano,Italy,1,0,0,1,1972
Mario Tullio Montano,Italy,1,0,0,1,1972
Rolando Rigoli,Italy,1,0,0,1,1972
Cesare Salvadori,Italy,1,0,0,1,1972
Marek Dąbrowski,Poland,1,0,0,1,1972
Arkadiusz Godel,Poland,1,0,0,1,1972
Jerzy Kaczmarek,Poland,1,0,0,1,1972
Lech Koziejowski,Poland,1,0,0,1,1972
Zygmunt Anczok,Poland,1,0,0,1,1972
Lesław Ćmikiewicz,Poland,1,0,0,1,1972
Kazimierz Deyna,Poland,1,0,0,1,1972
Robert Gadocha,Poland,1,0,0,1,1972
Jerzy Gorgoń,Poland,1,0,0,1,1972
Zbigniew Gut,Poland,1,0,0,1,1972
Kazimierz Kmiecik,Poland,1,0,0,1,1972
Hubert Kostka,Poland,1,0,0,1,1972
Jerzy Kraska,Poland,1,0,0,1,1972
Grzegorz Lato,Poland,1,0,0,1,1972
Włodzimierz Lubański,Poland,1,0,0,1,1972
Joachim Marx,Poland,1,0,0,1,1972
Zygmunt Maszczyk,Poland,1,0,0,1,1972
Marian Ostafiński,Poland,1,0,0,1,1972
Zygfryd Szołtysik,Poland,1,0,0,1,1972
Antoni Szymanowski,Poland,1,0,0,1,1972
Ryszard Szymczak,Poland,1,0,0,1,1972
Lyubov Burda,Russian Federation,1,0,0,1,1972
Antanina Koshal,Belarus,1,0,0,1,1972
Elvira Saadi,Soviet Union,1,0,0,1,1972
Teruichi Okamura,Japan,1,0,0,1,1972
Abas Arslanagić,Bosnia and Herzegovina,1,0,0,1,1972
Petar Fajfrić,Serbia,1,0,0,1,1972
Hrvoje Horvat,Croatia,1,0,0,1,1972
Milorad Karalić,Yugoslavia,1,0,0,1,1972
Đorđe Lavrnić,Yugoslavia,1,0,0,1,1972
Milan Lazarević,Serbia,1,0,0,1,1972
Zdravko Miljak,Croatia,1,0,0,1,1972
Slobodan Mišković,Serbia,1,0,0,1,1972
Branislav Pokrajac,Serbia,1,0,0,1,1972
Nebojša Popović,Yugoslavia,1,0,0,1,1972
Miroslav Pribanić,Croatia,1,0,0,1,1972
Albin Vidović,Croatia,1,0,0,1,1972
Zoran Živković,Serbia,1,0,0,1,1972
Zdenko Zorko,Croatia,1,0,0,1,1972
Takao Kawaguchi,Japan,1,0,0,1,1972
Shota Chochishvili,Georgia,1,0,0,1,1972
Toyokazu Nomura,Japan,1,0,0,1,1972
Shinobu Sekine,Japan,1,0,0,1,1972
Vladimir Shmelyov,Russian Federation,1,0,0,1,1972
Siegfried Brietzke,East Germany,1,0,0,1,1972
Frank Forberger,East Germany,1,0,0,1,1972
Dieter Grahn,East Germany,1,0,0,1,1972
Wolfgang Gunkel,East Germany,1,0,0,1,1972
Jörg Lucke,East Germany,1,0,0,1,1972
Wolfgang Mager,East Germany,1,0,0,1,1972
Klaus-Dieter Neubert,East Germany,1,0,0,1,1972
Frank Rühle,East Germany,1,0,0,1,1972
Dieter Schubert,East Germany,1,0,0,1,1972
Gerhard Auer,West Germany,1,0,0,1,1972
Uwe Benter,West Germany,1,0,0,1,1972
Peter Berger,West Germany,1,0,0,1,1972
Alois Bierl,West Germany,1,0,0,1,1972
Hans-Johann Färber,West Germany,1,0,0,1,1972
Trevor Coker,New Zealand,1,0,0,1,1972
Simon Dickie,New Zealand,1,0,0,1,1972
Joe Earl,New Zealand,1,0,0,1,1972
John Hunter,New Zealand,1,0,0,1,1972
Tony Hurt,New Zealand,1,0,0,1,1972
Dick Joyce,New Zealand,1,0,0,1,1972
Gary Robertson,New Zealand,1,0,0,1,1972
Wybo Veldman,New Zealand,1,0,0,1,1972
Lew Wilson,New Zealand,1,0,0,1,1972
Gennady Korshikov,Russian Federation,1,0,0,1,1972
Yury Malyshev,Russian Federation,1,0,0,1,1972
Aleksandr Timoshinin,Russian Federation,1,0,0,1,1972
Konrad Wirnhier,West Germany,1,0,0,1,1972
Angelo Scalzone,Italy,1,0,0,1,1972
Józef Zapędzki,Poland,1,0,0,1,1972
Li Ho-Jun,Democratic People's Republic of Korea,1,0,0,1,1972
Ragnar Skanåker,Sweden,1,0,0,1,1972
Yakov Zheleznyak,Soviet Union,1,0,0,1,1972
Lones Wigger,United States,1,0,0,1,1972
John Writer,United States,1,0,0,1,1972
Gail Neall,Australia,1,0,0,1,1972
Brad Cooper,Australia,1,0,0,1,1972
Klaus Dibiasi,Italy,1,0,0,1,1972
Mayumi Aoki,Japan,1,0,0,1,1972
Vladimir Vasin,Russian Federation,1,0,0,1,1972
Jane Barkman,United States,1,0,0,1,1972
Deena Deardurff,United States,1,0,0,1,1972
Jenny Kemp,United States,1,0,0,1,1972
Micki King,United States,1,0,0,1,1972
Karen Moe-Thornton,United States,1,0,0,1,1972
Mike Burton,United States,1,0,0,1,1972
Dave Edgar,United States,1,0,0,1,1972
John Kinsella,United States,1,0,0,1,1972
Fred Tyler,United States,1,0,0,1,1972
Yoshihide Fukao,Japan,1,0,0,1,1972
Kenji Kimura,Japan,1,0,0,1,1972
Masayuki Minami,Japan,1,0,0,1,1972
Jungo Morita,Japan,1,0,0,1,1972
Yuzo Nakamura,Japan,1,0,0,1,1972
Katsutoshi Nekoda,Japan,1,0,0,1,1972
Tetsuo Nishimoto,Japan,1,0,0,1,1972
Yasuhiro Noguchi,Japan,1,0,0,1,1972
Seiji Oko,Japan,1,0,0,1,1972
Tetsuo Sato,Japan,1,0,0,1,1972
Kenji Shimaoka,Japan,1,0,0,1,1972
Tadayoshi Yokota,Japan,1,0,0,1,1972
Lyudmila Borozna,Russian Federation,1,0,0,1,1972
Lyudmila Buldakova,Russian Federation,1,0,0,1,1972
Vera Galushka-Duyunova,Soviet Union,1,0,0,1,1972
Tatyana Gonobobleva,Russian Federation,1,0,0,1,1972
Nataliya Kudreva,Russian Federation,1,0,0,1,1972
Galina Leontyeva,Russian Federation,1,0,0,1,1972
Tatyana Ponyayeva-Tretyakova,Russian Federation,1,0,0,1,1972
Inna Ryskal,Azerbaijan,1,0,0,1,1972
Roza Salikhova,Russian Federation,1,0,0,1,1972
Tatyana Sarycheva,Russian Federation,1,0,0,1,1972
Nina Smoleyeva,Kazakhstan,1,0,0,1,1972
Lyubov Tyurina,Russian Federation,1,0,0,1,1972
Anatoly Akimov,Russian Federation,1,0,0,1,1972
Aleksey Barkalov,Soviet Union,1,0,0,1,1972
Aleksandr Dolgushin,Russian Federation,1,0,0,1,1972
Aleksandr Dreval,Russian Federation,1,0,0,1,1972
Vadim Gulyayev,Russian Federation,1,0,0,1,1972
Aleksandr Kabanov,Russian Federation,1,0,0,1,1972
Nikolay Melnikov,Russian Federation,1,0,0,1,1972
Leonid Osipov,Russian Federation,1,0,0,1,1972
Aleksandr Shidlovsky,Russian Federation,1,0,0,1,1972
Vladimir Zhmudsky,Russian Federation,1,0,0,1,1972
Vyacheslav Sobchenko,Russian Federation,1,0,0,1,1972
Yordan Bikov,Bulgaria,1,0,0,1,1972
Andon Nikolov,Bulgaria,1,0,0,1,1972
Norayr Nurikyan,Bulgaria,1,0,0,1,1972
Imre Földi,Hungary,1,0,0,1,1972
Leif Jensen,Norway,1,0,0,1,1972
Zygmunt Smalcerz,Poland,1,0,0,1,1972
Vasily Alekseyev,Russian Federation,1,0,0,1,1972
Mukharby Kirzhinov,Russian Federation,1,0,0,1,1972
Jaan Talts,Estonia,1,0,0,1,1972
Petar Kirov,Bulgaria,1,0,0,1,1972
Georgi Markov,Bulgaria,1,0,0,1,1972
Csaba Hegedűs,Hungary,1,0,0,1,1972
Kiyomi Kato,Japan,1,0,0,1,1972
Hideaki Yanagida,Japan,1,0,0,1,1972
Gheorghe Berceanu,Romania,1,0,0,1,1972
Nicolae Martinescu,Romania,1,0,0,1,1972
Vítězslav Mácha,Czech Republic,1,0,0,1,1972
Zagalav Abdulbekov,Russian Federation,1,0,0,1,1972
Roman Dmitriyev,Russian Federation,1,0,0,1,1972
Rustem Kazakov,Soviet Union,1,0,0,1,1972
Shamil Khisamutdinov,Russian Federation,1,0,0,1,1972
Aliaksandr Miadved,Belarus,1,0,0,1,1972
Valery Rezantsev,Kazakhstan,1,0,0,1,1972
Anatoly Roshchin,Russian Federation,1,0,0,1,1972
Ivan Yarygin,Russian Federation,1,0,0,1,1972
Levan Tediashvili,Georgia,1,0,0,1,1972
Dan Gable,United States,1,0,0,1,1972
Ben Peterson,United States,1,0,0,1,1972
Wayne Wells,United States,1,0,0,1,1972
Bill Allen,United States,1,0,0,1,1972
John Anderson,Australia,1,0,0,1,1972
Tom Anderson,Australia,1,0,0,1,1972
Bill Bentsen,United States,1,0,0,1,1972
John Cuneo,Australia,1,0,0,1,1972
Christopher Davies,Great Britain,1,0,0,1,1972
Vitaly Dyrdyra,Soviet Union,1,0,0,1,1972
David Forbes,Australia,1,0,0,1,1972
Valentin Mankin,Soviet Union,1,0,0,1,1972
Serge Maury,France,1,0,0,1,1972
"Buddy Melges, Jr.",United States,1,0,0,1,1972
Rodney Pattisson,Great Britain,1,0,0,1,1972
John Shaw,Australia,1,0,0,1,1972
Pekka Vasala,Finland,1,0,0,1,1972
Mary Peters,Great Britain,1,0,0,1,1972
Annelie Ehrhardt,East Germany,1,0,0,1,1972
Helga Seidler,East Germany,1,0,0,1,1972
Ruth Fuchs,East Germany,1,0,0,1,1972
Rita Kühne,East Germany,1,0,0,1,1972
Dagmar Käsling,East Germany,1,0,0,1,1972
Peter Frenkel,East Germany,1,0,0,1,1972
Wolfgang Nordwig,East Germany,1,0,0,1,1972
Ingrid Mickler-Becker,Germany,1,0,0,1,1972
Annegret Richter,West Germany,1,0,0,1,1972
Christiane Krause,West Germany,1,0,0,1,1972
Ulrike Meyfarth,West Germany,1,0,0,1,1972
Bernd Kannenberg,West Germany,1,0,0,1,1972
Klaus Wolfermann,West Germany,1,0,0,1,1972
Charles Asati,Kenya,1,0,0,1,1972
Munyoro Nyamau,Kenya,1,0,0,1,1972
Robert Ouko,Kenya,1,0,0,1,1972
Władysław Komar,Poland,1,0,0,1,1972
Ludvík Daněk,Czech Republic,1,0,0,1,1972
John Akii-Bua,Uganda,1,0,0,1,1972
Lyudmila Bragina,Russian Federation,1,0,0,1,1972
Nadezhda Chizhova,Russian Federation,1,0,0,1,1972
Faina Melnik,Armenia,1,0,0,1,1972
Nikolay Avilov,Soviet Union,1,0,0,1,1972
Anatoly Bondarchuk,Soviet Union,1,0,0,1,1972
Viktor Saneyev,Georgia,1,0,0,1,1972
Jüri Tarmak,Estonia,1,0,0,1,1972
Eddie Hart,United States,1,0,0,1,1972
Vince Matthews,United States,1,0,0,1,1972
Rod Milburn,United States,1,0,0,1,1972
Frank Shorter,United States,1,0,0,1,1972
Gerald Tinker,United States,1,0,0,1,1972
Randy Williams,United States,1,0,0,1,1972
Dave Wottle,United States,1,0,0,1,1972
Erika Zuchold,East Germany,0,3,0,3,1972
Kornelia Ender,East Germany,0,3,0,3,1972
Ildikó Farkasinszky-Bóbis,Hungary,0,2,0,2,1972
Mikhail Voronin,Russian Federation,0,2,0,2,1972
Roswitha Beier,East Germany,0,2,0,2,1972
Tim McKee,United States,0,2,0,2,1972
Raelene Boyle,Australia,0,2,0,2,1972
Novella Calligaris,Italy,0,1,2,3,1972
Vladimir Bure,Russian Federation,0,1,2,3,1972
Josef Neckermann,Germany,0,1,1,2,1972
Neal Shapiro,United States,0,1,1,2,1972
Péter Marót,Hungary,0,1,1,2,1972
Vladimir Nazlymov,Russian Federation,0,1,1,2,1972
Vladimír Petříček,Czech Republic,0,1,1,2,1972
Bruce Robertson,Canada,0,1,1,2,1972
Lutz Unger,East Germany,0,1,1,2,1972
Werner Lampe,West Germany,0,1,1,2,1972
Andrea Gyarmati,Hungary,0,1,1,2,1972
Franco Cagnotto,Italy,0,1,1,2,1972
Galina Prozumenshchikova-Stepanova,Soviet Union,0,1,1,2,1972
Igor Grivennikov,Russian Federation,0,1,1,2,1972
Viktor Mazanov,Russian Federation,0,1,1,2,1972
Susie Atwood,United States,0,1,1,2,1972
Jan Karlsson,Sweden,0,1,1,2,1972
Dave Hemery,Great Britain,0,1,1,2,1972
Gunhild Hoffmeister,East Germany,0,1,1,2,1972
Rita Jahn-Wilden,West Germany,0,1,1,2,1972
Kathy Hammond,United States,0,1,1,2,1972
Gilberto Carrillo,Cuba,0,1,0,1,1972
Irena Szydłowska,Poland,0,1,0,1,1972
Gunnar Jervill,Sweden,0,1,0,1,1972
Reima Virtanen,Finland,0,1,0,1,1972
János Kajdi,Hungary,0,1,0,1,1972
László Orbán,Hungary,0,1,0,1,1972
Philip Waruinge,Kenya,0,1,0,1,1972
Alfonso Zamora,Mexico,0,1,0,1,1972
Mike Bantom,United States,0,1,0,1,1972
Jim Brewer,United States,0,1,0,1,1972
Tommy Burleson,United States,0,1,0,1,1972
Doug Collins,United States,0,1,0,1,1972
Kenny Davis,United States,0,1,0,1,1972
Jim Forbes,United States,0,1,0,1,1972
Tom Henderson,United States,0,1,0,1,1972
Dwight Jones,United States,0,1,0,1,1972
Bobby Jones,United States,0,1,0,1,1972
Kevin Joyce,United States,0,1,0,1,1972
Tom McMillen,United States,0,1,0,1,1972
Ed Ratleff,United States,0,1,0,1,1972
Angel Angelov,Bulgaria,0,1,0,1,1972
Wiesław Rudkowski,Poland,0,1,0,1,1972
Kim U-Gil,Democratic People's Republic of Korea,0,1,0,1,1972
Ion Alexe,Romania,0,1,0,1,1972
Leo Rwabwogo,Uganda,0,1,0,1,1972
Norbert Sattler,Austria,0,1,0,1,1972
Petra Grabowski,East Germany,0,1,0,1,1972
Ilse Kaschube,East Germany,0,1,0,1,1972
Gisela Grothaus,West Germany,0,1,0,1,1972
Willi Baues,West Germany,0,1,0,1,1972
Reinhold Kauder,West Germany,0,1,0,1,1972
Hans-Otto Schumacher,West Germany,0,1,0,1,1972
József Deme,Hungary,0,1,0,1,1972
János Rátkai,Hungary,0,1,0,1,1972
Tamás Wichmann,Hungary,0,1,0,1,1972
Mieke Jaapies,Netherlands,0,1,0,1,1972
Serghei Covaliov,Romania,0,1,0,1,1972
Atanasie Sciotnic,Romania,0,1,0,1,1972
Roman Vartolomeu,Romania,0,1,0,1,1972
Aurel Vernescu,Romania,0,1,0,1,1972
Mihai Zafiu,Romania,0,1,0,1,1972
Rolf Peterson,Sweden,0,1,0,1,1972
Kathy Kusner,United States,0,1,0,1,1972
Ann Moore,Great Britain,0,1,0,1,1972
Karin Schlüter,West Germany,0,1,0,1,1972
Alessandro Argenton,Italy,0,1,0,1,1972
Frank Chapot,United States,0,1,0,1,1972
Bruce Davidson,United States,0,1,0,1,1972
Kevin Freeman,United States,0,1,0,1,1972
J. Michael Plumb,United States,0,1,0,1,1972
Bill Steinkraus,United States,0,1,0,1,1972
Jimmy Wofford,United States,0,1,0,1,1972
Edward Barcik,Poland,0,1,0,1,1972
Danny Clark,Australia,0,1,0,1,1972
Hans-Jürgen Geschke,East Germany,0,1,0,1,1972
Thomas Huschke,East Germany,0,1,0,1,1972
Xaver Kurmann,Switzerland,0,1,0,1,1972
Lucjan Lis,Poland,0,1,0,1,1972
John Nicholson,Australia,0,1,0,1,1972
Werner Otto,East Germany,0,1,0,1,1972
Heinz Richter,East Germany,0,1,0,1,1972
Herbert Richter,East Germany,0,1,0,1,1972
Clyde Sefton,Australia,0,1,0,1,1972
Stanisław Szozda,Poland,0,1,0,1,1972
Ryszard Szurkowski,Poland,0,1,0,1,1972
Uwe Unterwalder,East Germany,0,1,0,1,1972
Abdul Rashid,Pakistan,0,1,0,1,1972
Akhtar Rasool,Pakistan,0,1,0,1,1972
Akhtarul Islam,Pakistan,0,1,0,1,1972
Jahangir Butt,Pakistan,0,1,0,1,1972
Fazalur Rehman,Pakistan,0,1,0,1,1972
Islah-ud-Din,Pakistan,0,1,0,1,1972
Muhammad Asad Malik,Pakistan,0,1,0,1,1972
Munawaruz Zaman,Pakistan,0,1,0,1,1972
Riaz Ahmed,Pakistan,0,1,0,1,1972
Saeed Anwar,Pakistan,0,1,0,1,1972
Shahnaz Sheikh,Pakistan,0,1,0,1,1972
Salim Sherwani,Pakistan,0,1,0,1,1972
Iftikhar Ahmed Syed,Pakistan,0,1,0,1,1972
Mudassar Asghar,Pakistan,0,1,0,1,1972
Muhammad Zahid Sheikh,Pakistan,0,1,0,1,1972
Ildikó Rónay-Matuscsák,Hungary,0,1,0,1,1972
Ildikó Rejtő-Ujlaky-Sági,Hungary,0,1,0,1,1972
Ildikó Schwarczenberger-Tordasi,Hungary,0,1,0,1,1972
Jacques Ladègaillerie,France,0,1,0,1,1972
Jenő Kamuti,Hungary,0,1,0,1,1972
Guy Evéquoz,Switzerland,0,1,0,1,1972
Daniel Giger,Switzerland,0,1,0,1,1972
Christian Kauter,Switzerland,0,1,0,1,1972
Peter Loetscher,Switzerland,0,1,0,1,1972
François Suchanecki,Switzerland,0,1,0,1,1972
Viktor Bazhenov,Russian Federation,0,1,0,1,1972
Vladimir Denisov,Russian Federation,0,1,0,1,1972
Anatoly Koteshev,Russian Federation,0,1,0,1,1972
Viktor Putyatin,Soviet Union,0,1,0,1,1972
Mark Rakita,Russian Federation,0,1,0,1,1972
Leonid Romanov,Russian Federation,0,1,0,1,1972
Vasily Stankovich,Soviet Union,0,1,0,1,1972
Eduard Vinokurov,Russian Federation,0,1,0,1,1972
László Bálint,Hungary,0,1,0,1,1972
László Branikovits,Hungary,0,1,0,1,1972
Antal Dunai,Hungary,0,1,0,1,1972
Ede Dunai,Hungary,0,1,0,1,1972
István Géczi,Hungary,0,1,0,1,1972
Péter Juhász,Hungary,0,1,0,1,1972
Lajos Kocsis,Hungary,0,1,0,1,1972
József Kovács,Hungary,0,1,0,1,1972
Mihály Kozma,Hungary,0,1,0,1,1972
Lajos Kű,Hungary,0,1,0,1,1972
Miklós Páncsics,Hungary,0,1,0,1,1972
Ádám Rothermel,Hungary,0,1,0,1,1972
Lajos Szűcs,Hungary,0,1,0,1,1972
Kálmán Tóth,Hungary,0,1,0,1,1972
Béla Várady,Hungary,0,1,0,1,1972
Péter Vépi,Hungary,0,1,0,1,1972
Csaba Vidáts,Hungary,0,1,0,1,1972
Irene Abel,East Germany,0,1,0,1,1972
Angelika Hellmann,East Germany,0,1,0,1,1972
Richarda Schmeißer,East Germany,0,1,0,1,1972
Christine Schmitt,East Germany,0,1,0,1,1972
Aleksandr Maleyev,Belarus,0,1,0,1,1972
Edvard Mikayelyan,Armenia,0,1,0,1,1972
Vladimir Shchukin,Belarus,0,1,0,1,1972
Ladislav Beneš,Czech Republic,0,1,0,1,1972
František Brůna,Czech Republic,0,1,0,1,1972
Vladimír Haber,Czech Republic,0,1,0,1,1972
Vladimír Jarý,Czech Republic,0,1,0,1,1972
Jiří Kavan,Czech Republic,0,1,0,1,1972
Arnošt Klimčík,Czech Republic,0,1,0,1,1972
Jaroslav Konečný,Czech Republic,0,1,0,1,1972
František Králík,Czech Republic,0,1,0,1,1972
Jindřich Krepindl,Czech Republic,0,1,0,1,1972
Vincent Lafko,Czechoslovakia,0,1,0,1,1972
Andrej Lukošík,Czechoslovakia,0,1,0,1,1972
Pavel Mikeš,Czech Republic,0,1,0,1,1972
Peter Pospíšil,Czechoslovakia,0,1,0,1,1972
Ivan Satrapa,Czech Republic,0,1,0,1,1972
Zdeněk Škára,Czech Republic,0,1,0,1,1972
Jaroslav Škarvan,Czech Republic,0,1,0,1,1972
Klaus Glahn,Germany,0,1,0,1,1972
Vitaly Kuznetsov,Russian Federation,0,1,0,1,1972
Oh Seung-Rip,Republic of Korea,0,1,0,1,1972
David Starbrook,Great Britain,0,1,0,1,1972
Antoni Zajkowski,Poland,0,1,0,1,1972
Pál Bakó,Hungary,0,1,0,1,1972
Zsigmond Villányi,Hungary,0,1,0,1,1972
Alberto Demiddi,Argentina,0,1,0,1,1972
Reinhard Gust,East Germany,0,1,0,1,1972
Rolf Jobst,East Germany,0,1,0,1,1972
Klaus-Dieter Ludwig,East Germany,0,1,0,1,1972
Eckhard Martens,East Germany,0,1,0,1,1972
Dietrich Zander,East Germany,0,1,0,1,1972
Frank Hansen,Norway,0,1,0,1,1972
Svein Thøgersen,Norway,0,1,0,1,1972
Ross Collinge,New Zealand,0,1,0,1,1972
Noel Mills,New Zealand,0,1,0,1,1972
Dudley Storey,New Zealand,0,1,0,1,1972
Dick Tonks,New Zealand,0,1,0,1,1972
Fredy Bachmann,Switzerland,0,1,0,1,1972
Heini Fischer,Switzerland,0,1,0,1,1972
Oldřich Svojanovský,Czech Republic,0,1,0,1,1972
Pavel Svojanovský,Czech Republic,0,1,0,1,1972
Gene Clapp,United States,0,1,0,1,1972
Franklin Hobbs,United States,0,1,0,1,1972
Bill Hobbs,United States,0,1,0,1,1972
Paul Hoffman,United States,0,1,0,1,1972
Cleve Livingston,United States,0,1,0,1,1972
Mike Livingston,United States,0,1,0,1,1972
Tim Mickelson,United States,0,1,0,1,1972
Pete Raymond,United States,0,1,0,1,1972
Lawrence Terry,United States,0,1,0,1,1972
Helmut Bellingrodt,Colombia,0,1,0,1,1972
Michel Carrega,France,0,1,0,1,1972
Dan Iuga,Romania,0,1,0,1,1972
Ladislav Falta,Czech Republic,0,1,0,1,1972
Boris Melnik,Soviet Union,0,1,0,1,1972
Yevgeny Petrov,Russian Federation,0,1,0,1,1972
Vic Auer,United States,0,1,0,1,1972
Lanny Bassham,United States,0,1,0,1,1972
Graham Windeatt,Australia,0,1,0,1,1972
Leslie Cliff,Canada,0,1,0,1,1972
David Wilkie,Great Britain,0,1,0,1,1972
Andrea Eife,East Germany,0,1,0,1,1972
Christine Herbst,East Germany,0,1,0,1,1972
Elke Sehmisch,East Germany,0,1,0,1,1972
Renate Vogel,East Germany,0,1,0,1,1972
Gabriele Wetzko,East Germany,0,1,0,1,1972
Hartmut Flöckner,East Germany,0,1,0,1,1972
Klaus Katzur,East Germany,0,1,0,1,1972
Hans Faßnacht,West Germany,0,1,0,1,1972
Klaus Steinbach,Germany,0,1,0,1,1972
Hans-Günther Vosseler,West Germany,0,1,0,1,1972
Milena Duchková,Czech Republic,0,1,0,1,1972
Viktor Aboimov,Kazakhstan,0,1,0,1,1972
Lynn Colella,United States,0,1,0,1,1972
Dana Schoenfield,United States,0,1,0,1,1972
Gary Hall,United States,0,1,0,1,1972
Dick Rydze,United States,0,1,0,1,1972
Horst Hagen,East Germany,0,1,0,1,1972
Wolfgang Löwe,East Germany,0,1,0,1,1972
Wolfgang Maibohm,East Germany,0,1,0,1,1972
Jürgen Maune,East Germany,0,1,0,1,1972
Horst Peter,East Germany,0,1,0,1,1972
Eckehard Pietzsch,East Germany,0,1,0,1,1972
Siegfried Schneider,East Germany,0,1,0,1,1972
Arnold Schulz,East Germany,0,1,0,1,1972
Rudi Schumann,East Germany,0,1,0,1,1972
Rainer Tscharke,East Germany,0,1,0,1,1972
Wolfgang Webner,East Germany,0,1,0,1,1972
Wolfgang Weise,East Germany,0,1,0,1,1972
Makiko Furukawa,Japan,0,1,0,1,1972
Keiko Hama,Japan,0,1,0,1,1972
Takako Iida,Japan,0,1,0,1,1972
Toyoko Iwahara,Japan,0,1,0,1,1972
Katsumi Matsumura,Japan,0,1,0,1,1972
Sumie Oinuma,Japan,0,1,0,1,1972
Mariko Okamoto,Japan,0,1,0,1,1972
Seiko Shimakage,Japan,0,1,0,1,1972
Michiko Shiokawa,Japan,0,1,0,1,1972
Takako Shirai,Japan,0,1,0,1,1972
Noriko Yamashita,Japan,0,1,0,1,1972
Yaeko Yamazaki,Japan,0,1,0,1,1972
András Bodnár,Hungary,0,1,0,1,1972
Tibor Cservenyák,Hungary,0,1,0,1,1972
Tamás Faragó,Hungary,0,1,0,1,1972
István Görgényi,Hungary,0,1,0,1,1972
Zoltán Kásás,Hungary,0,1,0,1,1972
Ferenc Konrád,Hungary,0,1,0,1,1972
István Magas,Hungary,0,1,0,1,1972
Endre Molnár,Hungary,0,1,0,1,1972
Dénes Pócsik,Hungary,0,1,0,1,1972
László Sárosi,Hungary,0,1,0,1,1972
"István Szívós, Jr.",Hungary,0,1,0,1,1972
Aleksandar Kraychev,Bulgaria,0,1,0,1,1972
Mladen Kuchev,Bulgaria,0,1,0,1,1972
Atanas Shopov,Bulgaria,0,1,0,1,1972
Rudolf Mang,West Germany,0,1,0,1,1972
Lajos Szűcs,Hungary,0,1,0,1,1972
Mohammad Nassiri,Islamic Republic of Iran,0,1,0,1,1972
Mohamed Kheir Tarabulsi,Lebanon,0,1,0,1,1972
Norbert Ozimek,Poland,0,1,0,1,1972
Dito Shanidze,Georgia,0,1,0,1,1972
Stoyan Apostolov,Bulgaria,0,1,0,1,1972
Osman Duraliev,Bulgaria,0,1,0,1,1972
Ognyan Nikolov,Bulgaria,0,1,0,1,1972
Aleksandar Tomov,Bulgaria,0,1,0,1,1972
Heinz-Helmut Wehling,East Germany,0,1,0,1,1972
Hans-Jürgen Veil,West Germany,0,1,0,1,1972
Petros Galaktopoulos,Greece,0,1,0,1,1972
Rahim Aliabadi,Islamic Republic of Iran,0,1,0,1,1972
Koichiro Hirayama,Japan,0,1,0,1,1972
Kikuo Wada,Japan,0,1,0,1,1972
Khorloogiin Bayanmönkh,Mongolia,0,1,0,1,1972
Vehbi Akdağ,Turkey,0,1,0,1,1972
Arsen Alakhverdiyev,Russian Federation,0,1,0,1,1972
Nikolay Yakovenko,Russian Federation,0,1,0,1,1972
Anatoly Nazarenko,Kazakhstan,0,1,0,1,1972
Gennady Strakhov,Russian Federation,0,1,0,1,1972
John Peterson,United States,0,1,0,1,1972
Rich Sanders,United States,0,1,0,1,1972
Josip Čorak,Croatia,0,1,0,1,1972
Paul Borowski,East Germany,0,1,0,1,1972
Ilias Khatzipavlis,Greece,0,1,0,1,1972
David Hunt,Great Britain,0,1,0,1,1972
Bo Knape,Sweden,0,1,0,1,1972
Stefan Krook,Sweden,0,1,0,1,1972
Marc Pajot,France,0,1,0,1,1972
Yves Pajot,France,0,1,0,1,1972
Pelle Petterson,Sweden,0,1,0,1,1972
Lennart Roslund,Sweden,0,1,0,1,1972
Karl-Heinz Thun,East Germany,0,1,0,1,1972
Alan Warren,Great Britain,0,1,0,1,1972
Konrad Weichert,East Germany,0,1,0,1,1972
Stig Wennerström,Sweden,0,1,0,1,1972
Stellan Westerdahl,Sweden,0,1,0,1,1972
Karel Lismont,Belgium,0,1,0,1,1972
Miel Puttemans,Belgium,0,1,0,1,1972
Yordanka Blagoeva,Bulgaria,0,1,0,1,1972
Diana Yorgova,Bulgaria,0,1,0,1,1972
Guy Drut,France,0,1,0,1,1972
David Jenkins,Great Britain,0,1,0,1,1972
Alan Pascoe,Great Britain,0,1,0,1,1972
Martin Reynolds,Great Britain,0,1,0,1,1972
Christina Heinich,East Germany,0,1,0,1,1972
Margitta Helmbold-Gummel,East Germany,0,1,0,1,1972
Evelin Kaufer,East Germany,0,1,0,1,1972
Bärbel Struppert,East Germany,0,1,0,1,1972
Jacqueline Todten-Hein,East Germany,0,1,0,1,1972
Jörg Drehmel,East Germany,0,1,0,1,1972
Stefan Junge,East Germany,0,1,0,1,1972
Jochen Sachse,East Germany,0,1,0,1,1972
Hans Baumgartner,West Germany,0,1,0,1,1972
Ben Jipcho,Kenya,0,1,0,1,1972
Valeria Bufanu-Ștefănescu,Romania,0,1,0,1,1972
Argentina Menis,Romania,0,1,0,1,1972
Mohamad Gammoudi,Tunisia,0,1,0,1,1972
Nijolė Sabaitė,Lithuania,0,1,0,1,1972
Yevgeny Arzhanov,Soviet Union,0,1,0,1,1972
Vladimir Golubnichy,Soviet Union,0,1,0,1,1972
Aleksandr Kornelyuk,Azerbaijan,0,1,0,1,1972
Leonid Litvinenko,Soviet Union,0,1,0,1,1972
Vladimir Lovetsky,Belarus,0,1,0,1,1972
Jānis Lūsis,Latvia,0,1,0,1,1972
Juris Silovs,Latvia,0,1,0,1,1972
Veniamin Soldatenko,Kazakhstan,0,1,0,1,1972
Mable Fergerson,United States,0,1,0,1,1972
Madeline Manning-Jackson,United States,0,1,0,1,1972
Cheryl Toussaint,United States,0,1,0,1,1972
Wayne Collett,United States,0,1,0,1,1972
Ralph Mann,United States,0,1,0,1,1972
Bob Seagren,United States,0,1,0,1,1972
Jay Silvester,United States,0,1,0,1,1972
George Woods,United States,0,1,0,1,1972
Mária Szolnoki,Hungary,0,1,0,1,1972
Christian Noël,France,0,0,2,2,1972
Marina Janicke,East Germany,0,0,2,2,1972
Gudrun Beckmann,West Germany,0,0,2,2,1972
Heidi Reineck,West Germany,0,0,2,2,1972
Silvia Chivás,Cuba,0,0,2,2,1972
Kyösti Laasonen,Finland,0,0,1,1,1972
Alfonso Pérez,Colombia,0,0,1,1,1972
Clemente Rojas,Colombia,0,0,1,1,1972
Douglas Rodríguez,Cuba,0,0,1,1,1972
Emma Gapchenko,Russian Federation,0,0,1,1,1972
Miguel Calderón,Cuba,0,0,1,1,1972
Juan Domecq,Cuba,0,0,1,1,1972
Dacal Rodríguez,Spain,0,0,1,1,1972
Tomás Herrera,Cuba,0,0,1,1,1972
Ruperto Herrera,Cuba,0,0,1,1,1972
Ralph Evans,Great Britain,0,0,1,1,1972
Alan Minter,Great Britain,0,0,1,1,1972
George Turpin,Great Britain,0,0,1,1,1972
Peter Tiepold,East Germany,0,0,1,1,1972
Peter Hussing,West Germany,0,0,1,1,1972
Prince Amartey,Ghana,0,0,1,1,1972
András Botos,Hungary,0,0,1,1,1972
Samuel Mbugua,Kenya,0,0,1,1,1972
Dick Murunga,Kenya,0,0,1,1,1972
Isaac Ikhouria,Nigeria,0,0,1,1,1972
Issaka Daboré,Niger,0,0,1,1,1972
Conrado Pérez,Cuba,0,0,1,1,1972
José Miguel Álvarez,Cuba,0,0,1,1,1972
Rafael Cañizares,Cuba,0,0,1,1,1972
Pedro Chappé,Cuba,0,0,1,1,1972
Juan Roca,Cuba,0,0,1,1,1972
Franklin Standard,Cuba,0,0,1,1,1972
Alejandro Urgellés,Cuba,0,0,1,1,1972
Óscar Varona,Cuba,0,0,1,1,1972
Leszek Błażyński,Poland,0,0,1,1,1972
Janusz Gortat,Poland,0,0,1,1,1972
Hasse Thomsén,Sweden,0,0,1,1,1972
Ricardo Carreras,United States,0,0,1,1,1972
Marvin Johnson,United States,0,0,1,1,1972
Jesse Valdez,United States,0,0,1,1,1972
Zvonko Vujin,Serbia,0,0,1,1,1972
Ivan Burchin,Bulgaria,0,0,1,1,1972
Fedi Damyanov,Bulgaria,0,0,1,1,1972
Jean-Claude Olry,France,0,0,1,1,1972
Jean-Louis Olry,France,0,0,1,1,1972
Harald Gimpel,East Germany,0,0,1,1,1972
Magdalena Wunderlich,West Germany,0,0,1,1,1972
Detlef Lewe,Germany,0,0,1,1,1972
Anna Pfeffer,Hungary,0,0,1,1,1972
Géza Csapó,Hungary,0,0,1,1,1972
Steinar Amundsen,Norway,0,0,1,1,1972
Tore Berger,Norway,0,0,1,1,1972
Jan Johansen,Norway,0,0,1,1,1972
Egil Søby,Norway,0,0,1,1,1972
Rafał Piszcz,Poland,0,0,1,1,1972
Władysław Szuszkiewicz,Poland,0,0,1,1,1972
Viorica Dumitru,Romania,0,0,1,1,1972
Maria Nichiforov,Romania,0,0,1,1,1972
Jamie McEwan,United States,0,0,1,1,1972
Ulla Håkansson,Sweden,0,0,1,1,1972
Ninna Swaab,Sweden,0,0,1,1,1972
Maud von Rosen,Sweden,0,0,1,1,1972
Piero D'Inzeo,Italy,0,0,1,1,1972
Raimondo D'Inzeo,Italy,0,0,1,1,1972
Lutz Gössing,West Germany,0,0,1,1,1972
Jan Jönsson,Sweden,0,0,1,1,1972
Horst Karsten,Germany,0,0,1,1,1972
Harry Klugmann,West Germany,0,0,1,1,1972
Vittorio Orlandi,Italy,0,0,1,1,1972
Karl Schultz,West Germany,0,0,1,1,1972
Andrzej Bek,Poland,0,0,1,1,1972
Mick Bennett,Great Britain,0,0,1,1,1972
Ian Hallam,Great Britain,0,0,1,1,1972
Ron Keeble,Great Britain,0,0,1,1,1972
Benedykt Kocot,Poland,0,0,1,1,1972
Hans Lutz,West Germany,0,0,1,1,1972
Willi Moore,Great Britain,0,0,1,1,1972
Omar Pkhak'adze,Georgia,0,0,1,1,1972
Jürgen Schütze,East Germany,0,0,1,1,1972
Charles Cornelius,India,0,0,1,1,1972
Manuel Frederick,India,0,0,1,1,1972
B. P. Govinda,India,0,0,1,1,1972
Michael Kindo,India,0,0,1,1,1972
Ashok Kumar,India,0,0,1,1,1972
M. P. Ganesh,India,0,0,1,1,1972
Krishnamurty Perumal,India,0,0,1,1,1972
Ajitpal Singh,India,0,0,1,1,1972
Harbinder Singh,India,0,0,1,1,1972
Harcharan Singh,India,0,0,1,1,1972
Harmik Singh,India,0,0,1,1,1972
Kulwant Singh,India,0,0,1,1,1972
Mukhbain Singh,India,0,0,1,1,1972
Varinder Singh,India,0,0,1,1,1972
Ana Derșidan-Ene-Pascu,Romania,0,0,1,1,1972
Ileana Gyulai-Drîmbă-Jenei,Romania,0,0,1,1,1972
Ecaterina Stahl-Iencic,Romania,0,0,1,1,1972
Olga Orban-Szabo,Romania,0,0,1,1,1972
Risto Hurme,Finland,0,0,1,1,1972
Veikko Salminen,Finland,0,0,1,1,1972
Gilles Berolatti,France,0,0,1,1,1972
Jean-Claude Magnan,France,0,0,1,1,1972
Daniel Revenu,France,0,0,1,1,1972
Bernard Talvard,France,0,0,1,1,1972
Péter Bakonyi,Hungary,0,0,1,1,1972
Pál Gerevich,Hungary,0,0,1,1,1972
Tamás Kovács,Hungary,0,0,1,1,1972
Tibor Pézsa,Hungary,0,0,1,1,1972
Grigory Kriss,Soviet Union,0,0,1,1,1972
Viktor Modzalevsky,Russian Federation,0,0,1,1,1972
Sergey Paramonov,Soviet Union,0,0,1,1,1972
Igor Valetov,Kazakhstan,0,0,1,1,1972
Georgi Zažitski,Estonia,0,0,1,1,1972
Bernd Bransch,East Germany,0,0,1,1,1972
Jürgen Croy,East Germany,0,0,1,1,1972
Peter Ducke,East Germany,0,0,1,1,1972
Frank Ganzera,East Germany,0,0,1,1,1972
Reinhard Häfner,East Germany,0,0,1,1,1972
Harald Irmscher,East Germany,0,0,1,1,1972
Hansi Kreische,East Germany,0,0,1,1,1972
Lothar Kurbjuweit,East Germany,0,0,1,1,1972
Jürgen Pommerenke,East Germany,0,0,1,1,1972
Ralf Schulenberg,East Germany,0,0,1,1,1972
Wolfgang Seguin,East Germany,0,0,1,1,1972
Jürgen Sparwasser,East Germany,0,0,1,1,1972
Joachim Streich,East Germany,0,0,1,1,1972
Eberhard Vogel,East Germany,0,0,1,1,1972
Konrad Weise,East Germany,0,0,1,1,1972
Siegmar Wätzlich,East Germany,0,0,1,1,1972
Manfred Zapf,East Germany,0,0,1,1,1972
Arkadi Andriasyan,Armenia,0,0,1,1,1972
Oleg Blokhin,Soviet Union,0,0,1,1,1972
Revaz Dzodzuashvili,Georgia,0,0,1,1,1972
Yury Yeliseyev,Soviet Union,0,0,1,1,1972
Gennady Yevryuzhikhin,Russian Federation,0,0,1,1,1972
Yury Istomin,Russian Federation,0,0,1,1,1972
Andrey Yakubik,Russian Federation,0,0,1,1,1972
Vladimir Kaplichny,Russian Federation,0,0,1,1,1972
Viktor Kolotov,Soviet Union,0,0,1,1,1972
Anatoly Kuksov,Soviet Union,0,0,1,1,1972
Murtaz Khurtsilava,Georgia,0,0,1,1,1972
Yevgeny Lovchev,Russian Federation,0,0,1,1,1972
Sergey Olshansky,Russian Federation,0,0,1,1,1972
Vladimir Onishchenko,Soviet Union,0,0,1,1,1972
Vladimir Pilguy,Russian Federation,0,0,1,1,1972
Yevgeny Rudakov,Soviet Union,0,0,1,1,1972
Yozhef Sabo,Soviet Union,0,0,1,1,1972
Vyacheslav Semyonov,Soviet Union,0,0,1,1,1972
Hovhannes Zanazanyan,Armenia,0,0,1,1,1972
Ilona Békési,Hungary,0,0,1,1,1972
Mónika Császár,Hungary,0,0,1,1,1972
Márta Kelemen,Hungary,0,0,1,1,1972
Anikó Kéry,Hungary,0,0,1,1,1972
Krisztina Medveczky,Hungary,0,0,1,1,1972
Zsuzsa Nagy,Hungary,0,0,1,1,1972
Matthias Brehme,East Germany,0,0,1,1,1972
Wolfgang Klotz,East Germany,0,0,1,1,1972
Jürgen Paeke,East Germany,0,0,1,1,1972
Reinhard Rychly,East Germany,0,0,1,1,1972
Wolfgang Thüne,East Germany,0,0,1,1,1972
Ștefan Birtalan,Romania,0,0,1,1,1972
Adrian Cosma,Romania,0,0,1,1,1972
Alexandru Dincă,Romania,0,0,1,1,1972
Cristian Gațu,Romania,0,0,1,1,1972
Gheorghe Gruia,Romania,0,0,1,1,1972
Roland Guneš,Romania,0,0,1,1,1972
Gabriel Kicsid,Romania,0,0,1,1,1972
Ghiță Licu,Romania,0,0,1,1,1972
Dan Marin,Romania,0,0,1,1,1972
Cornel Penu,Romania,0,0,1,1,1972
Valentin Samungi,Romania,0,0,1,1,1972
Simion Schobel,Romania,0,0,1,1,1972
Werner Stöckl,Romania,0,0,1,1,1972
Constantin Tudosie,Romania,0,0,1,1,1972
Radu Voina,Romania,0,0,1,1,1972
Paul Barth,West Germany,0,0,1,1,1972
Jean-Claude Brondani,France,0,0,1,1,1972
Jean-Paul Coche,France,0,0,1,1,1972
Dietmar Hötger,East Germany,0,0,1,1,1972
Chiaki Ishii,Brazil,0,0,1,1,1972
Brian Jacks,Great Britain,0,0,1,1,1972
Kim Yong-Ik,Democratic People's Republic of Korea,0,0,1,1,1972
Jean-Jacques Mounier,France,0,0,1,1,1972
Motoki Nishimura,Japan,0,0,1,1,1972
Anatoly Novikov,Soviet Union,0,0,1,1,1972
Givi Onashvili,Georgia,0,0,1,1,1972
Angelo Parisi,France,0,0,1,1,1972
Martti Ketelä,Finland,0,0,1,1,1972
Hans-Joachim Borzym,East Germany,0,0,1,1,1972
Joachim Böhmer,East Germany,0,0,1,1,1972
Harold Dimke,East Germany,0,0,1,1,1972
Wolfgang Güldenpfennig,East Germany,0,0,1,1,1972
Bernd Landvoigt,East Germany,0,0,1,1,1972
Jörg Landvoigt,East Germany,0,0,1,1,1972
Heinrich Mederow,East Germany,0,0,1,1,1972
Uli Schmied,East Germany,0,0,1,1,1972
Manfred Schmorde,East Germany,0,0,1,1,1972
Manfred Schneider,East Germany,0,0,1,1,1972
Hartmut Schreiber,East Germany,0,0,1,1,1972
Dietmar Schwarz,East Germany,0,0,1,1,1972
Joachim Ehrig,West Germany,0,0,1,1,1972
Peter Funnekötter,West Germany,0,0,1,1,1972
Franz Held,West Germany,0,0,1,1,1972
Wolfgang Plottke,West Germany,0,0,1,1,1972
Roel Luynenburg,Netherlands,0,0,1,1,1972
Ruud Stokvis,Netherlands,0,0,1,1,1972
Petre Ceapura,Romania,0,0,1,1,1972
Ladislau Lovrenschi,Romania,0,0,1,1,1972
Ștefan Tudor,Romania,0,0,1,1,1972
Vladimír Jánoš,Czech Republic,0,0,1,1,1972
Otakar Mareček,Czech Republic,0,0,1,1,1972
Karel Neffe,Czech Republic,0,0,1,1,1972
František Provazník,Czech Republic,0,0,1,1,1972
Rudolf Dollinger,Austria,0,0,1,1,1972
John Kynoch,Great Britain,0,0,1,1,1972
Michael Buchheim,East Germany,0,0,1,1,1972
Werner Lippoldt,East Germany,0,0,1,1,1972
Lajos Papp,Hungary,0,0,1,1,1972
Silvano Basagni,Italy,0,0,1,1,1972
Nicolae Rotaru,Romania,0,0,1,1,1972
Viktor Torshin,Russian Federation,0,0,1,1,1972
Donna-Marie Gurr,Canada,0,0,1,1,1972
Erik Fish,Canada,0,0,1,1,1972
Bob Kasting,Canada,0,0,1,1,1972
Bill Mahony,Canada,0,0,1,1,1972
Gudrun Wegner,East Germany,0,0,1,1,1972
Peter Bruch,East Germany,0,0,1,1,1972
Wilfried Hartung,East Germany,0,0,1,1,1972
Vreni Eberle,West Germany,0,0,1,1,1972
Silke Pielen,West Germany,0,0,1,1,1972
Angela Steinbach,West Germany,0,0,1,1,1972
Jutta Weber,West Germany,0,0,1,1,1972
András Hargitay,Hungary,0,0,1,1,1972
Georgijs Kuļikovs,Latvia,0,0,1,1,1972
Ellie Daniel,United States,0,0,1,1,1972
Lynn Vidali,United States,0,0,1,1,1972
Robin Backhaus,United States,0,0,1,1,1972
Steve Furniss,United States,0,0,1,1,1972
Mitch Ivey,United States,0,0,1,1,1972
Craig Lincoln,United States,0,0,1,1,1972
Tom McBreen,United States,0,0,1,1,1972
Doug Northway,United States,0,0,1,1,1972
Viktor Borshch,Russian Federation,0,0,1,1,1972
Vyacheslav Domani,Russian Federation,0,0,1,1,1972
Vladimir Kondra,Russian Federation,0,0,1,1,1972
Valery Kravchenko,Kazakhstan,0,0,1,1,1972
Yevgeny Lapinsky,Soviet Union,0,0,1,1,1972
Vladimir Patkin,Russian Federation,0,0,1,1,1972
Yury Poyarkov,Soviet Union,0,0,1,1,1972
Vladimir Putyatov,Russian Federation,0,0,1,1,1972
Aleksandr Saprykin,Russian Federation,0,0,1,1,1972
Yury Starunsky,Russian Federation,0,0,1,1,1972
Yefim Chulak,Russian Federation,0,0,1,1,1972
Leonid Zayko,Russian Federation,0,0,1,1,1972
Peter Asch,United States,0,0,1,1,1972
Steve Barnett,United States,0,0,1,1,1972
Bruce Bradley,United States,0,0,1,1,1972
Stan Cole,United States,0,0,1,1,1972
Jim Ferguson,United States,0,0,1,1,1972
Eric Lindroth,United States,0,0,1,1,1972
John Parker,United States,0,0,1,1,1972
Gary Sheerer,United States,0,0,1,1,1972
Jim Slatton,United States,0,0,1,1,1972
Russ Webb,United States,0,0,1,1,1972
Barry Weitzenberg,United States,0,0,1,1,1972
Gerd Bonk,East Germany,0,0,1,1,1972
Stefan Grützner,East Germany,0,0,1,1,1972
János Benedek,Hungary,0,0,1,1,1972
Sándor Holczreiter,Hungary,0,0,1,1,1972
György Horváth,Hungary,0,0,1,1,1972
Anselmo Silvino,Italy,0,0,1,1,1972
Zbigniew Kaczmarek,Poland,0,0,1,1,1972
Hans Bettembourg,Sweden,0,0,1,1,1972
Gennady Chetin,Russian Federation,0,0,1,1,1972
Stefan Angelov,Bulgaria,0,0,1,1,1972
Ivan Krastev,Bulgaria,0,0,1,1,1972
Risto Björlin,Finland,0,0,1,1,1972
Adolf Seger,West Germany,0,0,1,1,1972
Károly Bajkó,Hungary,0,0,1,1,1972
József Csatári,Hungary,0,0,1,1,1972
Ferenc Kiss,Hungary,0,0,1,1,1972
László Klinga,Hungary,0,0,1,1,1972
Ibrahim Javadi,Islamic Republic of Iran,0,0,1,1,1972
Giuseppe Bognanni,Italy,0,0,1,1,1972
Gian Matteo Ranzi,Italy,0,0,1,1,1972
Czesław Kwieciński,Poland,0,0,1,1,1972
Kazimierz Lipień,Poland,0,0,1,1,1972
Kim Gwong-Hyong,Democratic People's Republic of Korea,0,0,1,1,1972
Victor Dolipschi,Romania,0,0,1,1,1972
Vasile Iorga,Romania,0,0,1,1,1972
Ruslan Ashuraliyev,Russian Federation,0,0,1,1,1972
Chris Taylor,United States,0,0,1,1,1972
Milan Nenadić,Croatia,0,0,1,1,1972
Don Cohan,United States,0,0,1,1,1972
Paul Côté,Canada,0,0,1,1,1972
Peter Dean,United States,0,0,1,1,1972
John Ekels,Canada,0,0,1,1,1972
Glen Foster,United States,0,0,1,1,1972
Charles Horter,United States,0,0,1,1,1972
Willi Kuhweide,Germany,0,0,1,1,1972
Ulli Libor,West Germany,0,0,1,1,1972
John Marshall,United States,0,0,1,1,1972
Karsten Meyer,Germany,0,0,1,1,1972
Dave Miller,Canada,0,0,1,1,1972
Peter Naumann,West Germany,0,0,1,1,1972
Viktor Potapov,Russian Federation,0,0,1,1,1972
Ilona Gusenbauer,Austria,0,0,1,1,1972
Nélson Prudêncio,Brazil,0,0,1,1,1972
Ivanka Khristova,Bulgaria,0,0,1,1,1972
Vasilka Stoeva,Bulgaria,0,0,1,1,1972
Marlene Elejalde,Cuba,0,0,1,1,1972
Fulgencia Romay,Cuba,0,0,1,1,1972
Carmen Valdés,Cuba,0,0,1,1,1972
Mamo Wolde,Ethiopia,0,0,1,1,1972
Miruts Yifter,Ethiopia,0,0,1,1,1972
Tapio Kantanen,Finland,0,0,1,1,1972
Gilles Bertould,France,0,0,1,1,1972
Jacques Carette,France,0,0,1,1,1972
Francis Kerbiriou,France,0,0,1,1,1972
Roger Vélasquez,France,0,0,1,1,1972
Ian Stewart,Great Britain,0,0,1,1,1972
Burglinde Pollak,East Germany,0,0,1,1,1972
Karin Richert-Balzer,East Germany,0,0,1,1,1972
Hartmut Briesenick,East Germany,0,0,1,1,1972
Hans-Georg Reimann,East Germany,0,0,1,1,1972
Inge Bödding,West Germany,0,0,1,1,1972
Anette Rückes,West Germany,0,0,1,1,1972
Klaus Ehl,West Germany,0,0,1,1,1972
Jobst Hirscht,West Germany,0,0,1,1,1972
Karlheinz Klotz,West Germany,0,0,1,1,1972
Gerhard Wucherer,West Germany,0,0,1,1,1972
Paola Pigni-Cacchi,Italy,0,0,1,1,1972
Pietro Mennea,Italy,0,0,1,1,1972
Lennox Miller,Jamaica,0,0,1,1,1972
Mike Boit,Kenya,0,0,1,1,1972
Rod Dixon,New Zealand,0,0,1,1,1972
Irena Kirszenstein-Szewińska,Poland,0,0,1,1,1972
Ryszard Katus,Poland,0,0,1,1,1972
Ricky Bruch,Sweden,0,0,1,1,1972
Eva Šuranová,Czechoslovakia,0,0,1,1,1972
Vasily Khmelevsky,Belarus,0,0,1,1,1972
Kate Schmidt,United States,0,0,1,1,1972
Tom Hill,United States,0,0,1,1,1972
Jan Johnson,United States,0,0,1,1,1972
Arnie Robinson,United States,0,0,1,1,1972
Bill Schmidt,United States,0,0,1,1,1972
Dwight Stones,United States,0,0,1,1,1972
Larry Young,United States,0,0,1,1,1972
Ri Chun-Ok,Democratic People's Republic of Korea,0,0,1,1,1972
Kim Myong-Suk,Democratic People's Republic of Korea,0,0,1,1,1972
Kim Zung-Bok,Democratic People's Republic of Korea,0,0,1,1,1972
Kang Ok-Sun,Democratic People's Republic of Korea,0,0,1,1,1972
Kim Yeun-Ja,Democratic People's Republic of Korea,0,0,1,1,1972
Hwang He-Suk,Democratic People's Republic of Korea,0,0,1,1,1972
Jang Ok-Rim,Democratic People's Republic of Korea,0,0,1,1,1972
Paek Myong-Suk,Democratic People's Republic of Korea,0,0,1,1,1972
Ryom Chun-Ja,Democratic People's Republic of Korea,0,0,1,1,1972
Kim Su-Dae,Democratic People's Republic of Korea,0,0,1,1,1972
Jong Ok-Jin,Democratic People's Republic of Korea,0,0,1,1,1972
Nikolay Andrianov,Russian Federation,4,2,1,7,1976
Kornelia Ender,East Germany,4,1,0,5,1976
John Naber,United States,4,1,0,5,1976
Nadia Comăneci,Romania,3,1,1,5,1976
Nelli Kim,Belarus,3,1,0,4,1976
Jim Montgomery,United States,3,0,1,4,1976
Ulrike Richter,East Germany,3,0,0,3,1976
Andrea Pollack,East Germany,2,2,0,4,1976
Mitsuo Tsukahara,Japan,2,1,2,5,1976
Sawao Kato,Japan,2,1,0,3,1976
John Hencken,United States,2,1,0,3,1976
Sergey Petrenko,Soviet Union,2,0,0,2,1976
Aleksandr Vinogradov,Russian Federation,2,0,0,2,1976
Tad Coffin,United States,2,0,0,2,1976
Gregor Braun,West Germany,2,0,0,2,1976
Viktor Krovopuskov,Russian Federation,2,0,0,2,1976
Hannelore Anke,East Germany,2,0,0,2,1976
Petra Thümer,East Germany,2,0,0,2,1976
Mike Bruner,United States,2,0,0,2,1976
Bruce Furniss,United States,2,0,0,2,1976
Brian Goodell,United States,2,0,0,2,1976
Matt Vogel,United States,2,0,0,2,1976
Alberto Juantorena,Cuba,2,0,0,2,1976
Lasse Virén,Finland,2,0,0,2,1976
Bärbel Eckert-Wöckel,East Germany,2,0,0,2,1976
Tatyana Kazankina,Russian Federation,2,0,0,2,1976
Shirley Babashoff,United States,1,4,0,5,1976
Lyudmila Turishcheva,Russian Federation,1,2,1,4,1976
Eizo Kenmotsu,Japan,1,2,0,3,1976
Annegret Richter,West Germany,1,2,0,3,1976
Renate Stecher,East Germany,1,1,1,3,1976
Joachim Mattern,East Germany,1,1,0,2,1976
Bernd Olbricht,East Germany,1,1,0,2,1976
Sergey Nagorny,Soviet Union,1,1,0,2,1976
Vladimir Romanovsky,Belarus,1,1,0,2,1976
Christine Stückelberger,Switzerland,1,1,0,2,1976
Harry Boldt,Germany,1,1,0,2,1976
J. Michael Plumb,United States,1,1,0,2,1976
Alwin Schockemöhle,Germany,1,1,0,2,1976
Alexander Pusch,West Germany,1,1,0,2,1976
Fabio Dal Zotto,Italy,1,1,0,2,1976
Vladimir Nazlymov,Russian Federation,1,1,0,2,1976
Olga Korbut,Belarus,1,1,0,2,1976
David Wilkie,Great Britain,1,1,0,2,1976
Ulrike Tauber,East Germany,1,1,0,2,1976
Christina Brehmer-Lathan,East Germany,1,1,0,2,1976
Don Quarrie,Jamaica,1,1,0,2,1976
Millard Hampton,United States,1,1,0,2,1976
Fred Newhouse,United States,1,1,0,2,1976
Rüdiger Helm,East Germany,1,0,2,3,1976
Carola Zirzow,East Germany,1,0,1,2,1976
Vasile Dîba,Romania,1,0,1,2,1976
Matija Ljubek,Croatia,1,0,1,2,1976
Reiner Klimke,Germany,1,0,1,2,1976
Ildikó Schwarczenberger-Tordasi,Hungary,1,0,1,2,1976
Yelena Novikova-Belova,Belarus,1,0,1,2,1976
Viktor Sidyak,Belarus,1,0,1,2,1976
Hiroshi Kajiyama,Japan,1,0,1,2,1976
Marina Koshevaya,Russian Federation,1,0,1,2,1976
Wendy Boglioli,United States,1,0,1,2,1976
Ellen Strophal-Streidt,East Germany,1,0,1,2,1976
Herman Frazier,United States,1,0,1,2,1976
Jorge Hernández,Cuba,1,0,0,1,1976
Ángel Herrera,Cuba,1,0,0,1,1976
Teófilo Stevenson,Cuba,1,0,0,1,1976
Luann Ryon,United States,1,0,0,1,1976
Darrell Pace,United States,1,0,0,1,1976
Jochen Bachfeld,East Germany,1,0,0,1,1976
Olga Barysheva-Korostelyova,Russian Federation,1,0,0,1,1976
Tamāra Dauniene,Latvia,1,0,0,1,1976
Nelli Feryabnikova,Russian Federation,1,0,0,1,1976
Nataliya Klimova,Soviet Union,1,0,0,1,1976
Raïsa Kurv'iakova,Soviet Union,1,0,0,1,1976
Tatyana Ovechkina,Russian Federation,1,0,0,1,1976
Angelė Rupšienė,Lithuania,1,0,0,1,1976
Uļjana Semjonova,Latvia,1,0,0,1,1976
Nadezhda Shuvayeva-Olkhova,Russian Federation,1,0,0,1,1976
Olga Sukharnova,Russian Federation,1,0,0,1,1976
Nadezhda Zakharova,Russian Federation,1,0,0,1,1976
Tatyana Zakharova-Nadyrova,Soviet Union,1,0,0,1,1976
Tate Armstrong,United States,1,0,0,1,1976
Quinn Buckner,United States,1,0,0,1,1976
Kenny Carr,United States,1,0,0,1,1976
Adrian Dantley,United States,1,0,0,1,1976
Walter Davis,United States,1,0,0,1,1976
Phil Ford,United States,1,0,0,1,1976
Ernie Grunfeld,United States,1,0,0,1,1976
Phil Hubbard,United States,1,0,0,1,1976
Mitch Kupchak,United States,1,0,0,1,1976
Tom LaGarde,United States,1,0,0,1,1976
Scott May,United States,1,0,0,1,1976
Steve Sheppard,United States,1,0,0,1,1976
Jerzy Rybicki,Poland,1,0,0,1,1976
Gu Yong-Jo,Democratic People's Republic of Korea,1,0,0,1,1976
"Howard Davis, Jr.",United States,1,0,0,1,1976
Sugar Ray Leonard,United States,1,0,0,1,1976
Leo Randolph,United States,1,0,0,1,1976
Leon Spinks,United States,1,0,0,1,1976
Michael Spinks,United States,1,0,0,1,1976
Nina Gopova-Trofimova,Russian Federation,1,0,0,1,1976
Galina Kreft-Alekseyeva,Russian Federation,1,0,0,1,1976
Aleksandr Degtyaryov,Russian Federation,1,0,0,1,1976
Yury Filatov,Soviet Union,1,0,0,1,1976
Vladimir Morozov,Russian Federation,1,0,0,1,1976
Aleksandr Rogov,Russian Federation,1,0,0,1,1976
Sergey Chukhray,Soviet Union,1,0,0,1,1976
Gabriela Grillo,West Germany,1,0,0,1,1976
Mary Anne Tauskey,United States,1,0,0,1,1976
Bruce Davidson,United States,1,0,0,1,1976
Hubert Parot,France,1,0,0,1,1976
Michel Roche,France,1,0,0,1,1976
Marc Roguet,France,1,0,0,1,1976
Marcel Rozier,France,1,0,0,1,1976
Klaus-Jürgen Grünke,East Germany,1,0,0,1,1976
Bernt Johansson,Sweden,1,0,0,1,1976
Vladimir Kaminsky,Belarus,1,0,0,1,1976
Hans Lutz,West Germany,1,0,0,1,1976
Aavo Pikkuus,Estonia,1,0,0,1,1976
Günther Schumacher,West Germany,1,0,0,1,1976
Valery Chaplygin,Russian Federation,1,0,0,1,1976
Anatoly Chukanov,Soviet Union,1,0,0,1,1976
Anton Tkáč,Czechoslovakia,1,0,0,1,1976
Peter Vonhof,West Germany,1,0,0,1,1976
Paul Ackerley,New Zealand,1,0,0,1,1976
Jeff Archibald,New Zealand,1,0,0,1,1976
Thur Borren,New Zealand,1,0,0,1,1976
Alan Chesney,New Zealand,1,0,0,1,1976
John Christensen,New Zealand,1,0,0,1,1976
Greg Dayman,New Zealand,1,0,0,1,1976
Tony Ineson,New Zealand,1,0,0,1,1976
Barry Maister,New Zealand,1,0,0,1,1976
Selwyn Maister,New Zealand,1,0,0,1,1976
Trevor Manning,New Zealand,1,0,0,1,1976
Alan McIntyre,New Zealand,1,0,0,1,1976
Arthur Parkin,New Zealand,1,0,0,1,1976
Mohan Patel,New Zealand,1,0,0,1,1976
Ramesh Patel,New Zealand,1,0,0,1,1976
Nailya Gilyazova,Russian Federation,1,0,0,1,1976
Olga Knyazeva,Russian Federation,1,0,0,1,1976
Valentina Nikonova,Russian Federation,1,0,0,1,1976
Valentina Sidorova,Russian Federation,1,0,0,1,1976
Thomas Bach,Germany,1,0,0,1,1976
Matthias Behr,West Germany,1,0,0,1,1976
Harald Hein,West Germany,1,0,0,1,1976
Klaus Reichert,West Germany,1,0,0,1,1976
Erk Sens-Gorius,West Germany,1,0,0,1,1976
Rolf Edling,Sweden,1,0,0,1,1976
Göran Flodström,Sweden,1,0,0,1,1976
Leif Högström,Sweden,1,0,0,1,1976
Carl von Essen,Sweden,1,0,0,1,1976
Mikhail Burtsev,Russian Federation,1,0,0,1,1976
Eduard Vinokurov,Russian Federation,1,0,0,1,1976
Bernd Bransch,East Germany,1,0,0,1,1976
Jürgen Croy,East Germany,1,0,0,1,1976
Hans-Jürgen Dörner,East Germany,1,0,0,1,1976
Hans-Ullrich Grapenthin,East Germany,1,0,0,1,1976
Wilfried Gröbner,East Germany,1,0,0,1,1976
Gert Heidler,East Germany,1,0,0,1,1976
Martin Hoffmann,East Germany,1,0,0,1,1976
Reinhard Häfner,East Germany,1,0,0,1,1976
Gerd Kische,East Germany,1,0,0,1,1976
Lothar Kurbjuweit,East Germany,1,0,0,1,1976
Reinhard Lauck,East Germany,1,0,0,1,1976
Wolfram Löwe,East Germany,1,0,0,1,1976
Dieter Riedel,East Germany,1,0,0,1,1976
Hans-Jürgen Riediger,East Germany,1,0,0,1,1976
Hartmut Schade,East Germany,1,0,0,1,1976
Gerd Weber,East Germany,1,0,0,1,1976
Konrad Weise,East Germany,1,0,0,1,1976
Mariya Filatova,Russian Federation,1,0,0,1,1976
Svetlana Grozdova,Russian Federation,1,0,0,1,1976
Elvira Saadi,Soviet Union,1,0,0,1,1976
Zoltán Magyar,Hungary,1,0,0,1,1976
Shun Fujimoto,Japan,1,0,0,1,1976
Hisato Igarashi,Japan,1,0,0,1,1976
Lyubov Berezhnaya-Odinokova,Soviet Union,1,0,0,1,1976
Lyudmila Bobrus-Poradnik,Soviet Union,1,0,0,1,1976
Tatyana Glushchenko,Soviet Union,1,0,0,1,1976
Larisa Karlova,Soviet Union,1,0,0,1,1976
Mariya Litoshenko,Soviet Union,1,0,0,1,1976
Nina Lobova,Soviet Union,1,0,0,1,1976
Tatyana Makarets-Kochergina,Soviet Union,1,0,0,1,1976
Lyudmila Panchuk,Soviet Union,1,0,0,1,1976
Nataliya Sherstyuk-Timoshkina,Soviet Union,1,0,0,1,1976
Rafiga Shabanova,Azerbaijan,1,0,0,1,1976
Lyudmila Shubina,Azerbaijan,1,0,0,1,1976
Aldona Česaitytė-Nenėnienė,Lithuania,1,0,0,1,1976
Zinaida Turchina,Soviet Union,1,0,0,1,1976
Galina Zakharova,Soviet Union,1,0,0,1,1976
Aleksandre Anp'ilogovi,Georgia,1,0,0,1,1976
Anatoly Fedyukin,Russian Federation,1,0,0,1,1976
Valery Gassy,Russian Federation,1,0,0,1,1976
Vasily Ilyin,Russian Federation,1,0,0,1,1976
Mikhail Ishchenko,Soviet Union,1,0,0,1,1976
Yury Kidyayev,Russian Federation,1,0,0,1,1976
Yury Klimov,Russian Federation,1,0,0,1,1976
Vladimir Kravtsov,Russian Federation,1,0,0,1,1976
Sergey Kushniryuk,Soviet Union,1,0,0,1,1976
Yury Lagutin,Soviet Union,1,0,0,1,1976
Vladimir Maksimov,Russian Federation,1,0,0,1,1976
Aleksandr Rezanov,Soviet Union,1,0,0,1,1976
Yevgeny Chernyshov,Russian Federation,1,0,0,1,1976
Nikolay Tomin,Soviet Union,1,0,0,1,1976
Vladimir Nevzorov,Russian Federation,1,0,0,1,1976
Kazuhiro Ninomiya,Japan,1,0,0,1,1976
Sergey Novikov,Soviet Union,1,0,0,1,1976
Héctor Rodríguez,Cuba,1,0,0,1,1976
Isamu Sonoda,Japan,1,0,0,1,1976
Haruki Uemura,Japan,1,0,0,1,1976
Jim Fox,Great Britain,1,0,0,1,1976
Danny Nightingale,Great Britain,1,0,0,1,1976
Adrian Parker,Great Britain,1,0,0,1,1976
Janusz Pyciak-Peciak,Poland,1,0,0,1,1976
Hans Jacobson,Sweden,1,0,0,1,1976
Stoyanka Gruycheva-Kurbatova,Bulgaria,1,0,0,1,1976
Zdravka Yordanova,Bulgaria,1,0,0,1,1976
Siyka Kelbecheva-Barbulova,Bulgaria,1,0,0,1,1976
Svetla Otsetova,Bulgaria,1,0,0,1,1976
Pertti Karppinen,Finland,1,0,0,1,1976
Brigitte Ahrenholz,East Germany,1,0,0,1,1976
Anke Borchmann,East Germany,1,0,0,1,1976
Henrietta Ebert,East Germany,1,0,0,1,1976
Viola Goretzki,East Germany,1,0,0,1,1976
Sabine Heß,East Germany,1,0,0,1,1976
Monika Kallies,East Germany,1,0,0,1,1976
Christiane Knetsch-Köpke,East Germany,1,0,0,1,1976
Andrea Kurth,East Germany,1,0,0,1,1976
Jutta Lau,East Germany,1,0,0,1,1976
Helma Lehmann,East Germany,1,0,0,1,1976
Gabi Lohs-Kühn,East Germany,1,0,0,1,1976
Karin Metze,East Germany,1,0,0,1,1976
Irina Müller,East Germany,1,0,0,1,1976
Viola Poley,East Germany,1,0,0,1,1976
Ilona Richter,East Germany,1,0,0,1,1976
Christine Scheiblich,East Germany,1,0,0,1,1976
Bianka Schwede,East Germany,1,0,0,1,1976
Liane Weigelt-Buhr,East Germany,1,0,0,1,1976
Marina Wilke,East Germany,1,0,0,1,1976
Roswietha Zobelt,East Germany,1,0,0,1,1976
Bernd Baumgart,East Germany,1,0,0,1,1976
Siegfried Brietzke,East Germany,1,0,0,1,1976
Karl-Heinz Bußert,East Germany,1,0,0,1,1976
Karl-Heinz Danielowski,East Germany,1,0,0,1,1976
Andreas Decker,East Germany,1,0,0,1,1976
Gottfried Döhn,East Germany,1,0,0,1,1976
Wolfgang Güldenpfennig,East Germany,1,0,0,1,1976
Harald Jährling,East Germany,1,0,0,1,1976
Ulrich Karnatz,East Germany,1,0,0,1,1976
Werner Klatt,East Germany,1,0,0,1,1976
Roland Kostulski,East Germany,1,0,0,1,1976
Bernd Landvoigt,East Germany,1,0,0,1,1976
Jörg Landvoigt,East Germany,1,0,0,1,1976
Hans-Joachim Lück,East Germany,1,0,0,1,1976
Wolfgang Mager,East Germany,1,0,0,1,1976
Karl-Heinz Prudöhl,East Germany,1,0,0,1,1976
Rüdiger Reiche,East Germany,1,0,0,1,1976
Stefan Semmler,East Germany,1,0,0,1,1976
Georg Spohr,East Germany,1,0,0,1,1976
Friedrich-Wilhelm Ulrich,East Germany,1,0,0,1,1976
Dieter Wendisch,East Germany,1,0,0,1,1976
Michael Wolfgramm,East Germany,1,0,0,1,1976
Alf Hansen,Norway,1,0,0,1,1976
Frank Hansen,Norway,1,0,0,1,1976
Aleksandr Lukyanov,Russian Federation,1,0,0,1,1976
Nikolay Ivanov,Russian Federation,1,0,0,1,1976
Vladimir Yeshinov,Russian Federation,1,0,0,1,1976
Aleksandr Klepikov,Russian Federation,1,0,0,1,1976
Mikhail Kuznetsov,Russian Federation,1,0,0,1,1976
Aleksandr Sema,Russian Federation,1,0,0,1,1976
Norbert Klaar,East Germany,1,0,0,1,1976
Uwe Potteck,East Germany,1,0,0,1,1976
Karlheinz Smieszek,West Germany,1,0,0,1,1976
Josef Panáček,Czech Republic,1,0,0,1,1976
Aleksandr Gazov,Belarus,1,0,0,1,1976
Lanny Bassham,United States,1,0,0,1,1976
Don Haldeman,United States,1,0,0,1,1976
Klaus Dibiasi,Italy,1,0,0,1,1976
Yelena Vaytsekhovskaya,Russian Federation,1,0,0,1,1976
Jennifer Chandler,United States,1,0,0,1,1976
Kim Peyton,United States,1,0,0,1,1976
Jill Sterkel,United States,1,0,0,1,1976
Phil Boggs,United States,1,0,0,1,1976
Rod Strachan,United States,1,0,0,1,1976
Yuko Arakida,Japan,1,0,0,1,1976
Takako Iida,Japan,1,0,0,1,1976
Katsuko Kanesaka,Japan,1,0,0,1,1976
Kiyomi Kato,Japan,1,0,0,1,1976
Echiko Maeda,Japan,1,0,0,1,1976
Noriko Matsuda,Japan,1,0,0,1,1976
Mariko Okamoto,Japan,1,0,0,1,1976
Takako Shirai,Japan,1,0,0,1,1976
Shoko Takayanagi,Japan,1,0,0,1,1976
Hiromi Yano,Japan,1,0,0,1,1976
Juri Yokoyama,Japan,1,0,0,1,1976
Mariko Yoshida,Japan,1,0,0,1,1976
Bronisław Bebel,Poland,1,0,0,1,1976
Ryszard Bosek,Poland,1,0,0,1,1976
Wiesław Gawłowski,Poland,1,0,0,1,1976
Marek Karbarz,Poland,1,0,0,1,1976
Lech Łasko,Poland,1,0,0,1,1976
Zbigniew Lubiejewski,Poland,1,0,0,1,1976
Mirosław Rybaczewski,Poland,1,0,0,1,1976
Włodzimierz Sadalski,Poland,1,0,0,1,1976
Edward Skorek,Poland,1,0,0,1,1976
Włodzimierz Stefański,Poland,1,0,0,1,1976
Tomasz Wójtowicz,Poland,1,0,0,1,1976
Zbigniew Zarzycki,Poland,1,0,0,1,1976
Gábor Csapó,Hungary,1,0,0,1,1976
Tibor Cservenyák,Hungary,1,0,0,1,1976
Tamás Faragó,Hungary,1,0,0,1,1976
György Gerendás,Hungary,1,0,0,1,1976
György Horkai,Hungary,1,0,0,1,1976
György Kenéz,Hungary,1,0,0,1,1976
Ferenc Konrád,Hungary,1,0,0,1,1976
Endre Molnár,Hungary,1,0,0,1,1976
László Sárosi,Hungary,1,0,0,1,1976
Attila Sudár,Hungary,1,0,0,1,1976
"István Szívós, Jr.",Hungary,1,0,0,1,1976
Yordan Mitkov,Bulgaria,1,0,0,1,1976
Norayr Nurikyan,Bulgaria,1,0,0,1,1976
Vasily Alekseyev,Russian Federation,1,0,0,1,1976
Nikolay Kolesnikov,Russian Federation,1,0,0,1,1976
Pyotr Korol,Soviet Union,1,0,0,1,1976
David Rigert,Russian Federation,1,0,0,1,1976
Valery Shary,Belarus,1,0,0,1,1976
Aleksandr Voronin,Russian Federation,1,0,0,1,1976
Yury Zaytsev,Kazakhstan,1,0,0,1,1976
Khasan Isaev,Bulgaria,1,0,0,1,1976
Pertti Ukkola,Finland,1,0,0,1,1976
Jiichiro Date,Japan,1,0,0,1,1976
Yuji Takada,Japan,1,0,0,1,1976
Yang Jeong-Mo,Republic of Korea,1,0,0,1,1976
Kazimierz Lipień,Poland,1,0,0,1,1976
Soslan Andiyev,Russian Federation,1,0,0,1,1976
Nikolay Balboshin,Russian Federation,1,0,0,1,1976
Anatoly Bykov,Kazakhstan,1,0,0,1,1976
Vladimir Yumin,Russian Federation,1,0,0,1,1976
Aleksandr Kolchinsky,Soviet Union,1,0,0,1,1976
Vitaly Konstantinov,Russian Federation,1,0,0,1,1976
Suren Nalbandyan,Russian Federation,1,0,0,1,1976
Pavel Pinigin,Russian Federation,1,0,0,1,1976
Valery Rezantsev,Kazakhstan,1,0,0,1,1976
Ivan Yarygin,Russian Federation,1,0,0,1,1976
Aleksey Shumakov,Russian Federation,1,0,0,1,1976
Levan Tediashvili,Georgia,1,0,0,1,1976
John Peterson,United States,1,0,0,1,1976
Momir Petković,Serbia,1,0,0,1,1976
John Albrechtson,Sweden,1,0,0,1,1976
Valdemar Bandolowski,Denmark,1,0,0,1,1976
Harro Bode,West Germany,1,0,0,1,1976
Eckart Diesch,West Germany,1,0,0,1,1976
Jörg Diesch,West Germany,1,0,0,1,1976
Erik Hansen,Denmark,1,0,0,1,1976
Ingvar Hansson,Sweden,1,0,0,1,1976
Frank Hübner,West Germany,1,0,0,1,1976
Poul Richard Høj Jensen,Denmark,1,0,0,1,1976
John Osborn,Great Britain,1,0,0,1,1976
Jochen Schümann,East Germany,1,0,0,1,1976
Reg White,Great Britain,1,0,0,1,1976
Ivanka Khristova,Bulgaria,1,0,0,1,1976
Guy Drut,France,1,0,0,1,1976
Carla Bodendorf,East Germany,1,0,0,1,1976
Ruth Fuchs,East Germany,1,0,0,1,1976
Doris Maletzki,East Germany,1,0,0,1,1976
Marlies Oelsner-Göhr,East Germany,1,0,0,1,1976
Brigitte Rohde,East Germany,1,0,0,1,1976
Johanna Schaller-Klier,East Germany,1,0,0,1,1976
Evelin Schlaak-Jahl,East Germany,1,0,0,1,1976
Angela Voigt,East Germany,1,0,0,1,1976
Siegrun Siegl,East Germany,1,0,0,1,1976
Rosie Witschas-Ackermann,East Germany,1,0,0,1,1976
Waldemar Cierpinski,East Germany,1,0,0,1,1976
Udo Beyer,East Germany,1,0,0,1,1976
Miklós Németh,Hungary,1,0,0,1,1976
Daniel Bautista,Mexico,1,0,0,1,1976
John Walker,New Zealand,1,0,0,1,1976
Irena Kirszenstein-Szewińska,Poland,1,0,0,1,1976
Tadeusz Ślusarski,Poland,1,0,0,1,1976
Jacek Wszoła,Poland,1,0,0,1,1976
Anders Gärderud,Sweden,1,0,0,1,1976
Hasely Crawford,Trinidad and Tobago,1,0,0,1,1976
Viktor Saneyev,Georgia,1,0,0,1,1976
Yury Sedykh,Soviet Union,1,0,0,1,1976
Benny Brown,United States,1,0,0,1,1976
Harvey Glance,United States,1,0,0,1,1976
Bruce Jenner,United States,1,0,0,1,1976
Johnny Jones,United States,1,0,0,1,1976
Edwin Moses,United States,1,0,0,1,1976
Maxie Parks,United States,1,0,0,1,1976
Steve Riddick,United States,1,0,0,1,1976
Arnie Robinson,United States,1,0,0,1,1976
Mac Wilkins,United States,1,0,0,1,1976
Teodora Ungureanu,Romania,0,2,1,3,1976
Hans-Jürgen Hehn,West Germany,0,2,0,2,1976
Aleksandr Dityatin,Russian Federation,0,2,0,2,1976
Vladimir Marchenko,Russian Federation,0,2,0,2,1976
Petra Priemer,East Germany,0,2,0,2,1976
Birgit Treiber,East Germany,0,2,0,2,1976
Peter Rocca,United States,0,2,0,2,1976
Ivo Van Damme,Belgium,0,2,0,2,1976
Klára Rajnai,Hungary,0,1,1,2,1976
Karl Schultz,West Germany,0,1,1,2,1976
Mieczysław Nowicki,Poland,0,1,1,2,1976
Carola Dombeck,East Germany,0,1,1,2,1976
Jan Bártů,Czech Republic,0,1,1,2,1976
Lyubov Rusanova,Russian Federation,0,1,1,2,1976
Vladimir Raskatov,Soviet Union,0,1,1,2,1976
Inge Helten,West Germany,0,1,1,2,1976
Andrés Aldama,Cuba,0,1,0,1,1976
Ramón Duvalón,Cuba,0,1,0,1,1976
Sixto Soria,Cuba,0,1,0,1,1976
Hiroshi Michinaga,Japan,0,1,0,1,1976
Valentina Kovpan,Soviet Union,0,1,0,1,1976
Mirza Delibašić,Bosnia and Herzegovina,0,1,0,1,1976
Richard Nowakowski,East Germany,0,1,0,1,1976
Cindy Brogdon,United States,0,1,0,1,1976
Nancy Dunkle,United States,0,1,0,1,1976
Lucy Harris,United States,0,1,0,1,1976
Pat Head,United States,0,1,0,1,1976
Charlotte Lewis,United States,0,1,0,1,1976
Nancy Lieberman,United States,0,1,0,1,1976
Gail Marquis,United States,0,1,0,1,1976
Ann Meyers,United States,0,1,0,1,1976
Mary Anne O'Connor,United States,0,1,0,1,1976
Trish Roberts,United States,0,1,0,1,1976
Sue Rojcewicz,United States,0,1,0,1,1976
Juliene Simpson,United States,0,1,0,1,1976
Krešimir Ćosić,Croatia,0,1,0,1,1976
Dražen Dalipagić,Serbia,0,1,0,1,1976
Blagoja Georgievski,North Macedonia,0,1,0,1,1976
Vinko Jelovac,Croatia,0,1,0,1,1976
Željko Jerkov,Croatia,0,1,0,1,1976
Dragan Kićanović,Serbia,0,1,0,1,1976
Andro Knego,Croatia,0,1,0,1,1976
Zoran Slavnić,Serbia,0,1,0,1,1976
Damir Šolman,Croatia,0,1,0,1,1976
Žarko Varajić,Yugoslavia,0,1,0,1,1976
Rajko Žižić,Montenegro,0,1,0,1,1976
Li Byong-Uk,Democratic People's Republic of Korea,0,1,0,1,1976
Simion Cuțov,Romania,0,1,0,1,1976
Mircea Şimon,Romania,0,1,0,1,1976
Rufat Riskiyev,Soviet Union,0,1,0,1,1976
Charlie Mooney,United States,0,1,0,1,1976
Pedro José Gamarro,Venezuela,0,1,0,1,1976
Tadija Kačar,Serbia,0,1,0,1,1976
John Wood,Canada,0,1,0,1,1976
José María Esteban,Spain,0,1,0,1,1976
José Ramón López,Spain,0,1,0,1,1976
Herminio Menéndez,Spain,0,1,0,1,1976
Luis Ramos,Spain,0,1,0,1,1976
Anna Pfeffer,Hungary,0,1,0,1,1976
Géza Csapó,Hungary,0,1,0,1,1976
Zoltán Sztanity,Hungary,0,1,0,1,1976
Andrzej Gronowicz,Poland,0,1,0,1,1976
Jerzy Opara,Poland,0,1,0,1,1976
Gheorghe Danielov,Romania,0,1,0,1,1976
Gheorghe Simionov,Romania,0,1,0,1,1976
Tatyana Korshunova,Russian Federation,0,1,0,1,1976
Vasily Yurchenko,Soviet Union,0,1,0,1,1976
Doris Ramseier,Switzerland,0,1,0,1,1976
Otto Ammermann,West Germany,0,1,0,1,1976
Herbert Blöcker,Germany,0,1,0,1,1976
Ulrich Lehmann,Switzerland,0,1,0,1,1976
Helmut Rethemeier,West Germany,0,1,0,1,1976
Paul Schockemöhle,West Germany,0,1,0,1,1976
Sönke Sönksen,West Germany,0,1,0,1,1976
Michel Vaillancourt,Canada,0,1,0,1,1976
Hans Günter Winkler,Germany,0,1,0,1,1976
Giuseppe Martinelli,Italy,0,1,0,1,1976
Daniel Morelon,France,0,1,0,1,1976
Tadeusz Mytnik,Poland,0,1,0,1,1976
Vladimir Osokin,Russian Federation,0,1,0,1,1976
Vitaly Petrakov,Russian Federation,0,1,0,1,1976
Aleksandr Perov,Russian Federation,0,1,0,1,1976
Herman Ponsteen,Netherlands,0,1,0,1,1976
Viktor Sokolov,Russian Federation,0,1,0,1,1976
Stanisław Szozda,Poland,0,1,0,1,1976
Ryszard Szurkowski,Poland,0,1,0,1,1976
Michel Vaarten,Belgium,0,1,0,1,1976
David Bell,Australia,0,1,0,1,1976
Greg Browning,Australia,0,1,0,1,1976
Ric Charlesworth,Australia,0,1,0,1,1976
Ian Cooke,Australia,0,1,0,1,1976
Barry Dancer,Australia,0,1,0,1,1976
Doug Golder,Australia,0,1,0,1,1976
Robert Haigh,Australia,0,1,0,1,1976
Wayne Hammond,Australia,0,1,0,1,1976
Jim Irvine,Australia,0,1,0,1,1976
Malcolm Poole,Australia,0,1,0,1,1976
Bob Proctor,Australia,0,1,0,1,1976
Graeme Reid,Australia,0,1,0,1,1976
Ron Riley,Australia,0,1,0,1,1976
Trevor Smith,Australia,0,1,0,1,1976
Terry Walsh,Australia,0,1,0,1,1976
Brigitte Dumont-Gapais,France,0,1,0,1,1976
Claudie Herbster-Josland,France,0,1,0,1,1976
Brigitte Latrille-Gaudin,France,0,1,0,1,1976
Christine Muzio,France,0,1,0,1,1976
Véronique Trinquet,France,0,1,0,1,1976
Maria Consolata Collino,Italy,0,1,0,1,1976
Reinhold Behr,West Germany,0,1,0,1,1976
Volker Fischer,West Germany,0,1,0,1,1976
Hanns Jana,West Germany,0,1,0,1,1976
Angelo Arcidiacono,Italy,0,1,0,1,1976
Attilio Calatroni,Italy,0,1,0,1,1976
Giovanni Battista Coletti,Italy,0,1,0,1,1976
Michele Maffei,Italy,0,1,0,1,1976
Carlo Montano,Italy,0,1,0,1,1976
Mario Aldo Montano,Italy,0,1,0,1,1976
Mario Tullio Montano,Italy,0,1,0,1,1976
Tommaso Montano,Italy,0,1,0,1,1976
Stefano Simoncelli,Italy,0,1,0,1,1976
Jiří Adam,Czech Republic,0,1,0,1,1976
Aleksandr Romankov,Belarus,0,1,0,1,1976
Jan Benigier,Poland,0,1,0,1,1976
Lesław Ćmikiewicz,Poland,0,1,0,1,1976
Kazimierz Deyna,Poland,0,1,0,1,1976
Jerzy Gorgoń,Poland,0,1,0,1,1976
Henryk Kasperczak,Poland,0,1,0,1,1976
Kazimierz Kmiecik,Poland,0,1,0,1,1976
Grzegorz Lato,Poland,0,1,0,1,1976
Zygmunt Maszczyk,Poland,0,1,0,1,1976
Piotr Mowlik,Poland,0,1,0,1,1976
Roman Ogaza,Poland,0,1,0,1,1976
Wojciech Rudy,Poland,0,1,0,1,1976
Andrzej Szarmach,Poland,0,1,0,1,1976
Antoni Szymanowski,Poland,0,1,0,1,1976
Jan Tomaszewski,Poland,0,1,0,1,1976
Henryk Wawrowski,Poland,0,1,0,1,1976
Henryk Wieczorek,Poland,0,1,0,1,1976
Władysław Żmuda,Poland,0,1,0,1,1976
Mariana Constantin,Romania,0,1,0,1,1976
Georgeta Gabor,Romania,0,1,0,1,1976
Anca Grigoraș,Romania,0,1,0,1,1976
Gabriela Trușcă,Romania,0,1,0,1,1976
Gennady Krysin,Russian Federation,0,1,0,1,1976
Vladimir Markelov,Russian Federation,0,1,0,1,1976
Vladimir Tikhonov,Russian Federation,0,1,0,1,1976
Gabriele Badorek,East Germany,0,1,0,1,1976
Hannelore Burosch,East Germany,0,1,0,1,1976
Waltraud Kretzschmar,East Germany,0,1,0,1,1976
Evelyn Matz,East Germany,0,1,0,1,1976
Liane Michaelis,East Germany,0,1,0,1,1976
Eva Paskuy,East Germany,0,1,0,1,1976
Kristina Richter,East Germany,0,1,0,1,1976
Christina Rost,East Germany,0,1,0,1,1976
Silvia Siefert,East Germany,0,1,0,1,1976
Marion Tietz,East Germany,0,1,0,1,1976
Petra Uhlig,East Germany,0,1,0,1,1976
Christina Voß,East Germany,0,1,0,1,1976
Hannelore Zober,East Germany,0,1,0,1,1976
Ștefan Birtalan,Romania,0,1,0,1,1976
Adrian Cosma,Romania,0,1,0,1,1976
Cezar Drăgăniță,Romania,0,1,0,1,1976
Alexandru Fölker,Romania,0,1,0,1,1976
Cristian Gațu,Romania,0,1,0,1,1976
Mircea Grabovschi,Romania,0,1,0,1,1976
Roland Guneš,Romania,0,1,0,1,1976
Gabriel Kicsid,Romania,0,1,0,1,1976
Ghiță Licu,Romania,0,1,0,1,1976
Nicolae Munteanu,Romania,0,1,0,1,1976
Cornel Penu,Romania,0,1,0,1,1976
Werner Stöckl,Romania,0,1,0,1,1976
Constantin Tudosie,Romania,0,1,0,1,1976
Radu Voina,Romania,0,1,0,1,1976
Jang Eun-Gyeong,Republic of Korea,0,1,0,1,1976
Valery Dvoynikov,Soviet Union,0,1,0,1,1976
Ramaz Kharshiladze,Georgia,0,1,0,1,1976
Koji Kuramoto,Japan,0,1,0,1,1976
Günther Neureuther,West Germany,0,1,0,1,1976
Keith Remfry,Great Britain,0,1,0,1,1976
Bohumil Starnovský,Czech Republic,0,1,0,1,1976
Pavel Lednyov,Russian Federation,0,1,0,1,1976
Kapka Georgieva,Bulgaria,0,1,0,1,1976
Ginka Gyurova,Bulgaria,0,1,0,1,1976
Reni Yordanova,Bulgaria,0,1,0,1,1976
Mariyka Modeva,Bulgaria,0,1,0,1,1976
Lilyana Vaseva,Bulgaria,0,1,0,1,1976
Chris Baillieu,Great Britain,0,1,0,1,1976
Jim Clark,Great Britain,0,1,0,1,1976
Tim Crooks,Great Britain,0,1,0,1,1976
Mike Hart,Great Britain,0,1,0,1,1976
Richard Lester,Great Britain,0,1,0,1,1976
Hugh Matheson,Great Britain,0,1,0,1,1976
David Maxwell,Great Britain,0,1,0,1,1976
Lenny Robertson,Great Britain,0,1,0,1,1976
Fred Smallbone,Great Britain,0,1,0,1,1976
Patrick Sweeney,Great Britain,0,1,0,1,1976
John Yallop,Great Britain,0,1,0,1,1976
Petra Boesler,East Germany,0,1,0,1,1976
Sabine Dähne,East Germany,0,1,0,1,1976
Sabine Jahn,East Germany,0,1,0,1,1976
Angelika Noack,East Germany,0,1,0,1,1976
Ullrich Dießner,East Germany,0,1,0,1,1976
Walter Dießner,East Germany,0,1,0,1,1976
Rüdiger Kunze,East Germany,0,1,0,1,1976
Andreas Schulz,East Germany,0,1,0,1,1976
Johannes Thomas,East Germany,0,1,0,1,1976
Peter-Michael Kolbe,West Germany,0,1,0,1,1976
Rolf Andreassen,Norway,0,1,0,1,1976
Arne Bergodd,Norway,0,1,0,1,1976
Ole Nafstad,Norway,0,1,0,1,1976
Finn Tveter,Norway,0,1,0,1,1976
Larisa Aleksandrova-Popova,Republic of Moldova,0,1,0,1,1976
Mira Bryunina,Russian Federation,0,1,0,1,1976
Olga Guzenko,Soviet Union,0,1,0,1,1976
Galina Yermolayeva,Russian Federation,0,1,0,1,1976
Olga Kolkova,Soviet Union,0,1,0,1,1976
Anna Kondrashina,Russian Federation,0,1,0,1,1976
Klavdija Koženkova,Lithuania,0,1,0,1,1976
Olga Pugovskaya,Soviet Union,0,1,0,1,1976
Nadezhda Rozgon,Soviet Union,0,1,0,1,1976
Nadezhda Roshchina,Russian Federation,0,1,0,1,1976
Nelli Tarakanova,Soviet Union,0,1,0,1,1976
Lyubov Talalayeva,Russian Federation,0,1,0,1,1976
Nadezhda Chernyshova,Russian Federation,0,1,0,1,1976
Yelena Zubko,Soviet Union,0,1,0,1,1976
Dmitry Bekhterev,Russian Federation,0,1,0,1,1976
Vytautas Butkus,Lithuania,0,1,0,1,1976
Yevgeny Duleyev,Russian Federation,0,1,0,1,1976
Yury Yakimov,Russian Federation,0,1,0,1,1976
Aivars Lazdenieks,Latvia,0,1,0,1,1976
Yury Lorentsson,Russian Federation,0,1,0,1,1976
Yury Shurkalov,Russian Federation,0,1,0,1,1976
Joan Lind,United States,0,1,0,1,1976
Calvin Coffey,United States,0,1,0,1,1976
Mike Staines,United States,0,1,0,1,1976
Harald Vollmar,East Germany,0,1,0,1,1976
Jürgen Wiefel,East Germany,0,1,0,1,1976
Ulrich Lind,West Germany,0,1,0,1,1976
Eric Swinkels,Netherlands,0,1,0,1,1976
Armando Marques,Portugal,0,1,0,1,1976
Aleksandr Kedyarov,Belarus,0,1,0,1,1976
Margaret Murdock,United States,0,1,0,1,1976
Cheryl Gibson,Canada,0,1,0,1,1976
Clay Evans,Canada,0,1,0,1,1976
Gary MacDonald,Canada,0,1,0,1,1976
Steve Pickell,Canada,0,1,0,1,1976
Graham Smith,Canada,0,1,0,1,1976
Claudia Hempel,East Germany,0,1,0,1,1976
Roswitha Krause,East Germany,0,1,0,1,1976
Christa Köhler,East Germany,0,1,0,1,1976
Franco Cagnotto,Italy,0,1,0,1,1976
Ulrika Knape,Sweden,0,1,0,1,1976
Marina Yurchenya,Soviet Union,0,1,0,1,1976
Andrey Bogdanov,Russian Federation,0,1,0,1,1976
Sergey Koplyakov,Belarus,0,1,0,1,1976
Andrey Krylov,Russian Federation,0,1,0,1,1976
Linda Jezek,United States,0,1,0,1,1976
Lauri Siering,United States,0,1,0,1,1976
Camille Wright,United States,0,1,0,1,1976
Jack Babashoff,United States,0,1,0,1,1976
Joe Bottom,United States,0,1,0,1,1976
Steve Gregg,United States,0,1,0,1,1976
Bobby Hackett,United States,0,1,0,1,1976
Greg Louganis,United States,0,1,0,1,1976
Tim McKee,United States,0,1,0,1,1976
Tim Shaw,United States,0,1,0,1,1976
Larisa Bergen,Russian Federation,0,1,0,1,1976
Zoya Yusova,Russian Federation,0,1,0,1,1976
Olga Kozakova,Soviet Union,0,1,0,1,1976
Nataliya Kushnir,Russian Federation,0,1,0,1,1976
Nina Muradyan,Russian Federation,0,1,0,1,1976
Liliya Osadchaya,Soviet Union,0,1,0,1,1976
Anna Rostova,Soviet Union,0,1,0,1,1976
Lyubov Rudovskaya,Soviet Union,0,1,0,1,1976
Inna Ryskal,Azerbaijan,0,1,0,1,1976
Lyudmila Shchetinina,Russian Federation,0,1,0,1,1976
Nina Smoleyeva,Kazakhstan,0,1,0,1,1976
Lyudmila Chernyshova,Russian Federation,0,1,0,1,1976
Vladimir Dorokhov,Russian Federation,0,1,0,1,1976
Aleksandr Yermilov,Russian Federation,0,1,0,1,1976
Vladimir Kondra,Russian Federation,0,1,0,1,1976
Oleg Moliboga,Soviet Union,0,1,0,1,1976
Anatoly Polishchuk,Soviet Union,0,1,0,1,1976
Aleksandr Savin,Russian Federation,0,1,0,1,1976
Pāvels Seļivanovs,Latvia,0,1,0,1,1976
Yury Starunsky,Russian Federation,0,1,0,1,1976
Vladimir Chernyshov,Russian Federation,0,1,0,1,1976
Yefim Chulak,Russian Federation,0,1,0,1,1976
Vladimir Ulanov,Russian Federation,0,1,0,1,1976
Vyacheslav Zaytsev,Russian Federation,0,1,0,1,1976
Alberto Alberani Samaritani,Italy,0,1,0,1,1976
Silvio Baracchini,Italy,0,1,0,1,1976
Luigi Castagnola,Italy,0,1,0,1,1976
Enzo D'Angelo,Italy,0,1,0,1,1976
Gianni De Magistris,Italy,0,1,0,1,1976
Riccardo De Magistris,Italy,0,1,0,1,1976
Marcello Del Duca,Italy,0,1,0,1,1976
Alessandro Ghibellini,Italy,0,1,0,1,1976
Sante Marsili,Italy,0,1,0,1,1976
Umberto Panerai,Italy,0,1,0,1,1976
Roldano Simeoni,Italy,0,1,0,1,1976
Krastyu Semerdzhiev,Bulgaria,0,1,0,1,1976
Trendafil Stoychev,Bulgaria,0,1,0,1,1976
Georgi Todorov,Bulgaria,0,1,0,1,1976
Daniel Senet,France,0,1,0,1,1976
Gerd Bonk,East Germany,0,1,0,1,1976
György Kőszegi,Hungary,0,1,0,1,1976
Grzegorz Cziura,Poland,0,1,0,1,1976
Vardan Militosyan,Armenia,0,1,0,1,1976
Lee James,United States,0,1,0,1,1976
Kamen Goranov,Bulgaria,0,1,0,1,1976
Stoyan Nikolov,Bulgaria,0,1,0,1,1976
Aleksandar Tomov,Bulgaria,0,1,0,1,1976
Hans-Dieter Brüchert,East Germany,0,1,0,1,1976
József Balla,Hungary,0,1,0,1,1976
Mansour Barzegar,Islamic Republic of Iran,0,1,0,1,1976
Zevegiin Oidov,Mongolia,0,1,0,1,1976
Gheorghe Berceanu,Romania,0,1,0,1,1976
Nicu Gingă,Romania,0,1,0,1,1976
Ștefan Rusu,Romania,0,1,0,1,1976
Vítězslav Mácha,Czech Republic,0,1,0,1,1976
Nelson Davidyan,Soviet Union,0,1,0,1,1976
Roman Dmitriyev,Russian Federation,0,1,0,1,1976
Aleksandr Ivanov,Russian Federation,0,1,0,1,1976
Viktor Novozhilov,Russian Federation,0,1,0,1,1976
Vladimir Cheboksarov,Russian Federation,0,1,0,1,1976
Russ Hellickson,United States,0,1,0,1,1976
Butch Keaser,United States,0,1,0,1,1976
Ben Peterson,United States,0,1,0,1,1976
Ivica Frgić,Serbia,0,1,0,1,1976
Vladislav Akimenko,Soviet Union,0,1,0,1,1976
Andrey Balashov,Russian Federation,0,1,0,1,1976
Julian Brooke-Houghton,Great Britain,0,1,0,1,1976
"Walter Glasgow, Jr.",United States,0,1,0,1,1976
Antonio Gorostegui,Spain,0,1,0,1,1976
Richard Hoepfner,United States,0,1,0,1,1976
John Kolius,United States,0,1,0,1,1976
Valentin Mankin,Soviet Union,0,1,0,1,1976
David McFaull,United States,0,1,0,1,1976
Pedro Millet,Spain,0,1,0,1,1976
Rodney Pattisson,Great Britain,0,1,0,1,1976
Mike Rothwell,United States,0,1,0,1,1976
Nikolina Shtereva,Bulgaria,0,1,0,1,1976
Mariya Vergova-Petkova,Bulgaria,0,1,0,1,1976
Greg Joy,Canada,0,1,0,1,1976
Alejandro Casañas,Cuba,0,1,0,1,1976
Antti Kalliomäki,Finland,0,1,0,1,1976
Hannu Siitonen,Finland,0,1,0,1,1976
Christine Bodner-Laser,East Germany,0,1,0,1,1976
Gunhild Hoffmeister,East Germany,0,1,0,1,1976
Manfred Kokot,East Germany,0,1,0,1,1976
Klaus-Dieter Kurrat,East Germany,0,1,0,1,1976
Jörg Pfeifer,East Germany,0,1,0,1,1976
Hans-Georg Reimann,East Germany,0,1,0,1,1976
Wolfgang Schmidt,East Germany,0,1,0,1,1976
Alexander Thieme,East Germany,0,1,0,1,1976
Marion Becker,Romania,0,1,0,1,1976
Anne Kroniger,West Germany,0,1,0,1,1976
Elvira Poßekel,West Germany,0,1,0,1,1976
Guido Kratschmer,West Germany,0,1,0,1,1976
Sara Simeoni,Italy,0,1,0,1,1976
Dick Quax,New Zealand,0,1,0,1,1976
Zbigniew Jaremski,Poland,0,1,0,1,1976
Bronisław Malinowski,Poland,0,1,0,1,1976
Jerzy Pietrzyk,Poland,0,1,0,1,1976
Ryszard Podlas,Poland,0,1,0,1,1976
Jan Werner,Poland,0,1,0,1,1976
Carlos Lopes,Portugal,0,1,0,1,1976
Tatyana Anisimova,Russian Federation,0,1,0,1,1976
Nadezhda Chizhova,Russian Federation,0,1,0,1,1976
Yevgeny Mironov,Russian Federation,0,1,0,1,1976
Aleksey Spiridonov,Russian Federation,0,1,0,1,1976
Rosalyn Bryant,United States,0,1,0,1,1976
Sheila Ingram,United States,0,1,0,1,1976
Pam Jiles,United States,0,1,0,1,1976
Debra Sapenter,United States,0,1,0,1,1976
James Butts,United States,0,1,0,1,1976
Mike Shine,United States,0,1,0,1,1976
Frank Shorter,United States,0,1,0,1,1976
Randy Williams,United States,0,1,0,1,1976
Kathy McMillan,United States,0,1,0,1,1976
Tamás Buday,Hungary,0,0,2,2,1976
Oszkár Frey,Hungary,0,0,2,2,1976
François Mathy,Belgium,0,0,2,2,1976
Bernard Talvard,France,0,0,2,2,1976
Michael Nikolay,East Germany,0,0,2,2,1976
Nancy Garapick,Canada,0,0,2,2,1976
Anne Jardin,Canada,0,0,2,2,1976
Becky Smith,Canada,0,0,2,2,1976
Peter Nocke,West Germany,0,0,2,2,1976
Enith Brigitha,Netherlands,0,0,2,2,1976
Valery Borzov,Soviet Union,0,0,2,2,1976
Vladimir Kolev,Bulgaria,0,0,1,1,1976
Rolando Garbey,Cuba,0,0,1,1,1976
Luis Felipe Martínez,Cuba,0,0,1,1,1976
Giancarlo Ferrari,Italy,0,0,1,1,1976
Zebiniso Rustamova,Soviet Union,0,0,1,1,1976
Ivan Yedeshko,Belarus,0,0,1,1,1976
Pat Cowdell,Great Britain,0,0,1,1,1976
Reinhard Skricek,West Germany,0,0,1,1,1976
Juan Paredes,Mexico,0,0,1,1,1976
Krasimira Bogdanova,Bulgaria,0,0,1,1,1976
Diana Dilova-Braynova,Bulgaria,0,0,1,1,1976
Krasimira Gyurova,Bulgaria,0,0,1,1,1976
Nadka Golcheva,Bulgaria,0,0,1,1,1976
Todorka Yordanova,Bulgaria,0,0,1,1,1976
Petkana Makaveeva,Bulgaria,0,0,1,1,1976
Penka Metodieva,Bulgaria,0,0,1,1,1976
Snezhana Mikhaylova,Bulgaria,0,0,1,1,1976
Margarita Shtarkelova,Bulgaria,0,0,1,1,1976
Gergina Skerlatova,Bulgaria,0,0,1,1,1976
Mariya Stoyanova,Bulgaria,0,0,1,1,1976
Penka Stoyanova,Bulgaria,0,0,1,1,1976
Vladimir Arzamaskov,Russian Federation,0,0,1,1,1976
Aleksandr Belov,Russian Federation,0,0,1,1,1976
Sergey Belov,Russian Federation,0,0,1,1,1976
Mikheil Korkia,Georgia,0,0,1,1,1976
Andrey Makeyev,Russian Federation,0,0,1,1,1976
Valery Miloserdov,Russian Federation,0,0,1,1,1976
Anatoly Myshkin,Russian Federation,0,0,1,1,1976
Aleksandr Salnikov,Soviet Union,0,0,1,1,1976
Alzhan Zharmukhamedov,Russian Federation,0,0,1,1,1976
Vladimir Tkachenko,Soviet Union,0,0,1,1,1976
Vladimir Zhigily,Russian Federation,0,0,1,1,1976
Clarence Hill,Bermuda,0,0,1,1,1976
Leszek Błażyński,Poland,0,0,1,1,1976
Janusz Gortat,Poland,0,0,1,1,1976
Leszek Kosedowski,Poland,0,0,1,1,1976
Kazimierz Szczerba,Poland,0,0,1,1,1976
Orlando Maldonado,Puerto Rico,0,0,1,1,1976
Costică Dafinoiu,Romania,0,0,1,1,1976
Alec Năstac,Romania,0,0,1,1,1976
Victor Zilberman,Romania,0,0,1,1,1976
Payao Poontarat,Thailand,0,0,1,1,1976
Viktor Rybakov,Russian Federation,0,0,1,1,1976
Viktor Savchenko,Soviet Union,0,0,1,1,1976
Vasily Solomin,Russian Federation,0,0,1,1,1976
Davit Torosyan,Armenia,0,0,1,1,1976
Johnny Tate,United States,0,0,1,1,1976
Ace Rusevski,North Macedonia,0,0,1,1,1976
Bärbel Köster,East Germany,0,0,1,1,1976
Frank-Peter Bischof,East Germany,0,0,1,1,1976
Bernd Duvigneau,East Germany,0,0,1,1,1976
Jürgen Lehnert,East Germany,0,0,1,1,1976
Zoltán Bakó,Hungary,0,0,1,1,1976
István Szabó,Hungary,0,0,1,1,1976
Tamás Wichmann,Hungary,0,0,1,1,1976
Policarp Malîhin,Romania,0,0,1,1,1976
Larion Serghei,Romania,0,0,1,1,1976
Hilda Gurney,United States,0,0,1,1,1976
Edith Master,United States,0,0,1,1,1976
Dorothy Morkis,United States,0,0,1,1,1976
Mervyn Bennett,Australia,0,0,1,1,1976
Edgar Henri Cuepper,Belgium,0,0,1,1,1976
Denis Pigott,Australia,0,0,1,1,1976
Bill Roycroft,Australia,0,0,1,1,1976
Wayne Roycroft,Australia,0,0,1,1,1976
Stanny Van Paesschen,Belgium,0,0,1,1,1976
Eric Wauters,Belgium,0,0,1,1,1976
Ian Banbury,Great Britain,0,0,1,1,1976
Mick Bennett,Great Britain,0,0,1,1,1976
Verner Blaudzun,Denmark,0,0,1,1,1976
Robin Croker,Great Britain,0,0,1,1,1976
Gert Frank,Denmark,0,0,1,1,1976
Niels Fredborg,Denmark,0,0,1,1,1976
Hans-Jürgen Geschke,East Germany,0,0,1,1,1976
Ian Hallam,Great Britain,0,0,1,1,1976
Jørgen Emil Hansen,Denmark,0,0,1,1,1976
Thomas Huschke,East Germany,0,0,1,1,1976
Jørn Lund,Denmark,0,0,1,1,1976
Abdul Rashid,Pakistan,0,0,1,1,1976
Akhtar Rasool,Pakistan,0,0,1,1,1976
Arshad Mahmood,Pakistan,0,0,1,1,1976
Arshad Ali Chaudry,Pakistan,0,0,1,1,1976
Hanif Khan,Pakistan,0,0,1,1,1976
Islah-ud-Din,Pakistan,0,0,1,1,1976
Samiullah,Pakistan,0,0,1,1,1976
Manzoor-ul Hassan,Pakistan,0,0,1,1,1976
Manzoor Hussain,Pakistan,0,0,1,1,1976
Munawaruz Zaman,Pakistan,0,0,1,1,1976
Qamar Zia,Pakistan,0,0,1,1,1976
Saleem Nazim,Pakistan,0,0,1,1,1976
Shahnaz Sheikh,Pakistan,0,0,1,1,1976
Salim Sherwani,Pakistan,0,0,1,1,1976
Iftikhar Ahmed Syed,Pakistan,0,0,1,1,1976
Mudassar Asghar,Pakistan,0,0,1,1,1976
Ildikó Farkasinszky-Bóbis,Hungary,0,0,1,1,1976
Edit Kovács,Hungary,0,0,1,1,1976
Magda Maros,Hungary,0,0,1,1,1976
Ildikó Rejtő-Ujlaky-Sági,Hungary,0,0,1,1,1976
Didier Flament,France,0,0,1,1,1976
Christian Noël,France,0,0,1,1,1976
Frédéric Pietruszka,France,0,0,1,1,1976
Daniel Revenu,France,0,0,1,1,1976
Győző Kulcsár,Hungary,0,0,1,1,1976
Dan Irimiciuc,Romania,0,0,1,1,1976
Cornel Marin,Romania,0,0,1,1,1976
Marin Mustață,Romania,0,0,1,1,1976
Alexandru Nilca,Romania,0,0,1,1,1976
Ioan Pop,Romania,0,0,1,1,1976
Jean-Blaise Evéquoz,Switzerland,0,0,1,1,1976
Daniel Giger,Switzerland,0,0,1,1,1976
Christian Kauter,Switzerland,0,0,1,1,1976
Michel Poffet,Switzerland,0,0,1,1,1976
François Suchanecki,Switzerland,0,0,1,1,1976
Vladimir Astapovsky,Russian Federation,0,0,1,1,1976
Oleg Blokhin,Soviet Union,0,0,1,1,1976
Leonid Buryak,Soviet Union,0,0,1,1,1976
Vladimir Fyodorov,Soviet Union,0,0,1,1,1976
Mikhail Fomenko,Soviet Union,0,0,1,1,1976
Viktor Kolotov,Soviet Union,0,0,1,1,1976
Anatoly Konkov,Soviet Union,0,0,1,1,1976
Viktor Matviyenko,Soviet Union,0,0,1,1,1976
Aleksandr Minayev,Russian Federation,0,0,1,1,1976
Leonid Nazarenko,Russian Federation,0,0,1,1,1976
Vladimir Onishchenko,Soviet Union,0,0,1,1,1976
Stefan Reshko,Soviet Union,0,0,1,1,1976
Vladimir Troshkin,Soviet Union,0,0,1,1,1976
Vladimir Veremeyev,Soviet Union,0,0,1,1,1976
Viktor Zvyagintsev,Soviet Union,0,0,1,1,1976
Gitta Escher,East Germany,0,0,1,1,1976
Kerstin Gerschau,East Germany,0,0,1,1,1976
Angelika Hellmann,East Germany,0,0,1,1,1976
Marion Kische,East Germany,0,0,1,1,1976
Steffi Kräker,East Germany,0,0,1,1,1976
Márta Egervári,Hungary,0,0,1,1,1976
Henri Boërio,France,0,0,1,1,1976
Roland Brückner,East Germany,0,0,1,1,1976
Rainer Hanschke,East Germany,0,0,1,1,1976
Bernd Jäger,East Germany,0,0,1,1,1976
Wolfgang Klotz,East Germany,0,0,1,1,1976
Lutz Mack,East Germany,0,0,1,1,1976
Eberhard Gienger,West Germany,0,0,1,1,1976
Dan Grecu,Romania,0,0,1,1,1976
Peter Kormann,United States,0,0,1,1,1976
Éva Angyal,Hungary,0,0,1,1,1976
Mária Berzsenyi,Hungary,0,0,1,1,1976
Ágota Bujdosó,Hungary,0,0,1,1,1976
Klára Horváth-Csik,Hungary,0,0,1,1,1976
Zsuzsanna Pethő,Hungary,0,0,1,1,1976
Katalin Tóth Harsányi-Laki,Hungary,0,0,1,1,1976
Rozália Tomann-Lelkes,Hungary,0,0,1,1,1976
Márta Pacsai-Megyeri,Hungary,0,0,1,1,1976
Ilona Nagy,Hungary,0,0,1,1,1976
Marianna Nagy-Gódor,Hungary,0,0,1,1,1976
Erzsébet Németh-Csajbók,Hungary,0,0,1,1,1976
Amália Sterbinszky,Hungary,0,0,1,1,1976
Borbála Tóth Harsányi,Hungary,0,0,1,1,1976
Mária Vanya-Vadász,Hungary,0,0,1,1,1976
Zdzisław Antczak,Poland,0,0,1,1,1976
Janusz Brzozowski,Poland,0,0,1,1,1976
Piotr Cieśla,Poland,0,0,1,1,1976
Jan Gmyrek,Poland,0,0,1,1,1976
Alfred Kałuziński,Poland,0,0,1,1,1976
Jerzy Klempel,Poland,0,0,1,1,1976
Zygfryd Kuchta,Poland,0,0,1,1,1976
Jerzy Melcer,Poland,0,0,1,1,1976
Ryszard Przybysz,Poland,0,0,1,1,1976
Henryk Rozmiarek,Poland,0,0,1,1,1976
Andrzej Sokołowski,Poland,0,0,1,1,1976
Andrzej Szymczak,Poland,0,0,1,1,1976
Mieczysław Wojczak,Poland,0,0,1,1,1976
Włodzimierz Zieliński,Poland,0,0,1,1,1976
Jo Jae-Gi,Republic of Korea,0,0,1,1,1976
Allen Coage,United States,0,0,1,1,1976
Sumio Endo,Japan,0,0,1,1,1976
Shota Chochishvili,Georgia,0,0,1,1,1976
Felice Mariani,Italy,0,0,1,1,1976
Slavko Obadov,Serbia,0,0,1,1,1976
Park Yeong-Cheol,Republic of Korea,0,0,1,1,1976
Jürg Röthlisberger,Switzerland,0,0,1,1,1976
David Starbrook,Great Britain,0,0,1,1,1976
Marian Tałaj,Poland,0,0,1,1,1976
József Tuncsik,Hungary,0,0,1,1,1976
Patrick Vial,France,0,0,1,1,1976
Tamás Kancsal,Hungary,0,0,1,1,1976
Tibor Maracskó,Hungary,0,0,1,1,1976
Szvetiszláv Sasics,Hungary,0,0,1,1,1976
Jürgen Bertow,East Germany,0,0,1,1,1976
Joachim Dreifke,East Germany,0,0,1,1,1976
Uli Schmied,East Germany,0,0,1,1,1976
Edith Eckbauer,West Germany,0,0,1,1,1976
Thea Einöder,West Germany,0,0,1,1,1976
Siegfried Fricke,West Germany,0,0,1,1,1976
Hans-Johann Färber,West Germany,0,0,1,1,1976
Ralph Kubail,West Germany,0,0,1,1,1976
Peter Niehusen,West Germany,0,0,1,1,1976
Thomas Strauß,West Germany,0,0,1,1,1976
Peter van Roye,West Germany,0,0,1,1,1976
Hartmut Wenzel,West Germany,0,0,1,1,1976
Trevor Coker,New Zealand,0,0,1,1,1976
Simon Dickie,New Zealand,0,0,1,1,1976
Peter Dignan,New Zealand,0,0,1,1,1976
Joe Earl,New Zealand,0,0,1,1,1976
Tony Hurt,New Zealand,0,0,1,1,1976
Alec McLean,New Zealand,0,0,1,1,1976
Dave Rodger,New Zealand,0,0,1,1,1976
Ivan Sutherland,New Zealand,0,0,1,1,1976
Lew Wilson,New Zealand,0,0,1,1,1976
Felicia Afrăsiloaie,Romania,0,0,1,1,1976
Elena Giurcă,Romania,0,0,1,1,1976
Elisabeta Lazăr,Romania,0,0,1,1,1976
Maria Micșa-Macoviciuc,Romania,0,0,1,1,1976
Ioana Tudoran,Romania,0,0,1,1,1976
Jaroslav Hellebrand,Czech Republic,0,0,1,1,1976
Vladek Lacina,Czech Republic,0,0,1,1,1976
Zdeněk Pecka,Czech Republic,0,0,1,1,1976
Oldřich Svojanovský,Czech Republic,0,0,1,1,1976
Pavel Svojanovský,Czech Republic,0,0,1,1,1976
Ludvík Vébr,Czech Republic,0,0,1,1,1976
Václav Vochoska,Czech Republic,0,0,1,1,1976
Yelena Antonova,Russian Federation,0,0,1,1,1976
Eleonora Kaminskaitė,Lithuania,0,0,1,1,1976
Lyudmila Krokhina,Russian Federation,0,0,1,1,1976
Lidiya Krylova,Russian Federation,0,0,1,1,1976
Galina Mishenina,Russian Federation,0,0,1,1,1976
Anna Pasokha,Russian Federation,0,0,1,1,1976
Genovaitė Ramoškienė,Lithuania,0,0,1,1,1976
Nadezhda Sevostiyanova,Russian Federation,0,0,1,1,1976
Raul Arnemann,Estonia,0,0,1,1,1976
Valery Dolinin,Russian Federation,0,0,1,1,1976
Anushavan Gassan-Dzhalilov,Russian Federation,0,0,1,1,1976
Nikolay Kuznetsov,Russian Federation,0,0,1,1,1976
Carol Brown,United States,0,0,1,1,1976
Carie Graves,United States,0,0,1,1,1976
Marion Greig,United States,0,0,1,1,1976
Peggy McCarthy,United States,0,0,1,1,1976
Gail Ricketson,United States,0,0,1,1,1976
Lynn Silliman,United States,0,0,1,1,1976
Anne Warner,United States,0,0,1,1,1976
Jackie Zoch,United States,0,0,1,1,1976
Anita DeFrantz,United States,0,0,1,1,1976
Conn Findlay,United States,0,0,1,1,1976
Rudolf Dollinger,Austria,0,0,1,1,1976
Werner Seibold,West Germany,0,0,1,1,1976
Ubaldesco Baldi,Italy,0,0,1,1,1976
Roberto Ferraris,Italy,0,0,1,1,1976
Wiesław Gawlikowski,Poland,0,0,1,1,1976
Jerzy Greszkiewicz,Poland,0,0,1,1,1976
Gennady Lushchikov,Russian Federation,0,0,1,1,1976
Steve Holland,Australia,0,0,1,1,1976
Gail Amundrud,Canada,0,0,1,1,1976
Barbara Clark,Canada,0,0,1,1,1976
Wendy Cook-Hogg,Canada,0,0,1,1,1976
Robin Corsiglia,Canada,0,0,1,1,1976
Shannon Smith,Canada,0,0,1,1,1976
Susan Sloan,Canada,0,0,1,1,1976
Brian Brinkley,Great Britain,0,0,1,1,1976
Gordon Downie,Great Britain,0,0,1,1,1976
David Dunne,Great Britain,0,0,1,1,1976
Alan McClatchey,Great Britain,0,0,1,1,1976
Rosemarie Kother-Gabriel,East Germany,0,0,1,1,1976
Roland Matthes,East Germany,0,0,1,1,1976
Michael Kraus,West Germany,0,0,1,1,1976
Walter Kusch,West Germany,0,0,1,1,1976
Klaus Steinbach,Germany,0,0,1,1,1976
Vladimir Aleynik,Belarus,0,0,1,1,1976
Arvydas Juozaitis,Lithuania,0,0,1,1,1976
Aleksandr Kosenkov,Belarus,0,0,1,1,1976
Andrey Smirnov,Russian Federation,0,0,1,1,1976
Cynthia Potter-McIngvale,United States,0,0,1,1,1976
Wendy Weinberg,United States,0,0,1,1,1976
Debbie Wilson,United States,0,0,1,1,1976
Rick Colella,United States,0,0,1,1,1976
Bill Forrester,United States,0,0,1,1,1976
Gary Hall,United States,0,0,1,1,1976
Dan Harrigan,United States,0,0,1,1,1976
Alfredo Figueredo,Cuba,0,0,1,1,1976
Víctor García,Cuba,0,0,1,1,1976
Diego Lapera,Cuba,0,0,1,1,1976
Leonel Marshall,Cuba,0,0,1,1,1976
Lorenzo Martínez,Cuba,0,0,1,1,1976
Ernesto Martínez,Cuba,0,0,1,1,1976
Jorge Pérez Vento,Cuba,0,0,1,1,1976
Antonio Rodríguez,Cuba,0,0,1,1,1976
Carlos Salas,Cuba,0,0,1,1,1976
Victoriano Sarmientos,Cuba,0,0,1,1,1976
Jesús Savigne,Cuba,0,0,1,1,1976
Raúl Vilches,Cuba,0,0,1,1,1976
Baek Myeong-Seon,Republic of Korea,0,0,1,1,1976
Byeon Gyeong-Ja,Republic of Korea,0,0,1,1,1976
Jang Hye-Suk,Republic of Korea,0,0,1,1,1976
Jo Hye-Jeong,Republic of Korea,0,0,1,1,1976
Jeong Sun-Ok,Republic of Korea,0,0,1,1,1976
Lee Sun-Bok,Republic of Korea,0,0,1,1,1976
Lee Sun-Ok,Republic of Korea,0,0,1,1,1976
Ma Geum-Ja,Republic of Korea,0,0,1,1,1976
Park Mi-Geum,Republic of Korea,0,0,1,1,1976
Yun Yeong-Nae,Republic of Korea,0,0,1,1,1976
Yu Jeong-Hye,Republic of Korea,0,0,1,1,1976
Yu Gyeong-Hwa,Republic of Korea,0,0,1,1,1976
Ton Buunk,Netherlands,0,0,1,1,1976
Piet de Zwarte,Netherlands,0,0,1,1,1976
Andy Hoepelman,Netherlands,0,0,1,1,1976
Evert Kroon,Netherlands,0,0,1,1,1976
Nico Landeweerd,Netherlands,0,0,1,1,1976
Hans Smits,Netherlands,0,0,1,1,1976
Gijze Stroboer,Netherlands,0,0,1,1,1976
Rik Toonen,Netherlands,0,0,1,1,1976
Hans van Zeeland,Netherlands,0,0,1,1,1976
Jan Evert Veer,Netherlands,0,0,1,1,1976
Atanas Shopov,Bulgaria,0,0,1,1,1976
Helmut Losch,East Germany,0,0,1,1,1976
Peter Wenzel,East Germany,0,0,1,1,1976
Péter Baczakó,Hungary,0,0,1,1,1976
Mohammad Nassiri,Islamic Republic of Iran,0,0,1,1,1976
Kenkichi Ando,Japan,0,0,1,1,1976
Kazumasa Hirai,Japan,0,0,1,1,1976
Kazimierz Czarnecki,Poland,0,0,1,1,1976
Tadeusz Rutkowski,Poland,0,0,1,1,1976
Stefan Angelov,Bulgaria,0,0,1,1,1976
Ivan Kolev,Bulgaria,0,0,1,1,1976
Dimo Kostov,Bulgaria,0,0,1,1,1976
Heinz-Helmut Wehling,East Germany,0,0,1,1,1976
Karl-Heinz Helbing,West Germany,0,0,1,1,1976
Adolf Seger,West Germany,0,0,1,1,1976
László Réczi,Hungary,0,0,1,1,1976
Masao Arai,Japan,0,0,1,1,1976
Koichiro Hirayama,Japan,0,0,1,1,1976
Akira Kudo,Japan,0,0,1,1,1976
Yasaburo Sugawara,Japan,0,0,1,1,1976
Jeon Hae-Seop,Republic of Korea,0,0,1,1,1976
Czesław Kwieciński,Poland,0,0,1,1,1976
Andrzej Skrzydlewski,Poland,0,0,1,1,1976
Roman Codreanu,Romania,0,0,1,1,1976
Stelica Morcov,Romania,0,0,1,1,1976
Ladislau Șimon,Romania,0,0,1,1,1976
Farkhat Mustafin,Russian Federation,0,0,1,1,1976
Gene Davis,United States,0,0,1,1,1976
Stan Dziedzic,United States,0,0,1,1,1976
Dieter Below,East Germany,0,0,1,1,1976
John Bertrand,Australia,0,0,1,1,1976
Ian Brown,Australia,0,0,1,1,1976
Dennis Conner,United States,0,0,1,1,1976
Reinaldo Conrad,Brazil,0,0,1,1,1976
Olaf Engelhardt,East Germany,0,0,1,1,1976
Peter Ficker,Brazil,0,0,1,1,1976
Ian Ruff,Australia,0,0,1,1,1976
Jörg Schmall,West Germany,0,0,1,1,1976
Jörg Spengler,West Germany,0,0,1,1,1976
Michael Zachries,East Germany,0,0,1,1,1976
Karel Lismont,Belgium,0,0,1,1,1976
João do Pulo,Brazil,0,0,1,1,1976
Yordanka Blagoeva,Bulgaria,0,0,1,1,1976
Brendan Foster,Great Britain,0,0,1,1,1976
Gabriele Hinzmann,East Germany,0,0,1,1,1976
Ulrike Klapezynski-Bruns,East Germany,0,0,1,1,1976
Burglinde Pollak,East Germany,0,0,1,1,1976
Elfi Zinn,East Germany,0,0,1,1,1976
Frank Baumgartl,East Germany,0,0,1,1,1976
Peter Frenkel,East Germany,0,0,1,1,1976
Frank Wartenberg,East Germany,0,0,1,1,1976
Bernd Herrmann,West Germany,0,0,1,1,1976
Klaus-Peter Hildenbrand,West Germany,0,0,1,1,1976
Franz-Peter Hofmeister,West Germany,0,0,1,1,1976
Lothar Krieg,West Germany,0,0,1,1,1976
Harald Schmid,West Germany,0,0,1,1,1976
Paul-Heinz Wellmann,West Germany,0,0,1,1,1976
Gheorghe Megelea,Romania,0,0,1,1,1976
Helena Fibingerová,Czech Republic,0,0,1,1,1976
Lyudmila Aksyonova,Soviet Union,0,0,1,1,1976
Lidiya Alfeyeva,Russian Federation,0,0,1,1,1976
Vera Anisimova,Russian Federation,0,0,1,1,1976
Nadezhda Besfamilnaya,Russian Federation,0,0,1,1,1976
Inta Kļimoviča,Latvia,0,0,1,1,1976
Nadezhda Kolesnikova-Ilyina,Russian Federation,0,0,1,1,1976
Nataliya Sokolova,Russian Federation,0,0,1,1,1976
Nataliya Lebedeva,Russian Federation,0,0,1,1,1976
Tatyana Prorochenko,Soviet Union,0,0,1,1,1976
Lyudmila Zharkova-Maslakova,Russian Federation,0,0,1,1,1976
Aleksandr Aksinin,Russian Federation,0,0,1,1,1976
Nikolay Avilov,Soviet Union,0,0,1,1,1976
Aleksandr Baryshnikov,Russian Federation,0,0,1,1,1976
Anatoly Bondarchuk,Soviet Union,0,0,1,1,1976
Yevgeny Gavrilenko,Belarus,0,0,1,1,1976
Nikolay Kolesnikov,Russian Federation,0,0,1,1,1976
Juris Silovs,Latvia,0,0,1,1,1976
Kate Schmidt,United States,0,0,1,1,1976
Willie Davenport,United States,0,0,1,1,1976
Dwayne Evans,United States,0,0,1,1,1976
John Powell,United States,0,0,1,1,1976
Dave Roberts,United States,0,0,1,1,1976
Dwight Stones,United States,0,0,1,1,1976
Rick Wohlhuter,United States,0,0,1,1,1976
Aleksandr Dityatin,Russian Federation,3,4,1,8,1980
Caren Metschuck,East Germany,3,1,0,4,1980
Vladimir Parfenovich,Belarus,3,0,0,3,1980
Barbara Krause,East Germany,3,0,0,3,1980
Rica Reinisch,East Germany,3,0,0,3,1980
Vladimir Salnikov,Russian Federation,3,0,0,3,1980
Nikolay Andrianov,Russian Federation,2,2,1,5,1980
Ines Diers,East Germany,2,2,1,5,1980
Nadia Comăneci,Romania,2,2,0,4,1980
Yelena Davydova,Canada,2,1,0,3,1980
Aleksandr Tkachov,Russian Federation,2,1,0,3,1980
Sergey Koplyakov,Belarus,2,1,0,3,1980
Nataliya Shaposhnikova,Russian Federation,2,0,2,4,1980
Rüdiger Helm,East Germany,2,0,1,3,1980
Sergey Chukhray,Soviet Union,2,0,0,2,1980
Pascale Trinquet-Hachin,France,2,0,0,2,1980
Viktor Krovopuskov,Russian Federation,2,0,0,2,1980
Nelli Kim,Belarus,2,0,0,2,1980
Anatoly Starostin,Russian Federation,2,0,0,2,1980
Ute Geweniger,East Germany,2,0,0,2,1980
Miruts Yifter,Ethiopia,2,0,0,2,1980
Bärbel Eckert-Wöckel,East Germany,2,0,0,2,1980
Viktor Markin,Russian Federation,2,0,0,2,1980
Andrey Krylov,Russian Federation,1,2,0,3,1980
Maxi Gnauck,East Germany,1,1,2,4,1980
Roland Brückner,East Germany,1,1,2,4,1980
Vladimir Smirnov,Soviet Union,1,1,1,3,1980
Lyubomir Lyubenov,Bulgaria,1,1,0,2,1980
Ivan Patzaichin,Romania,1,1,0,2,1980
Sergey Postrekhin,Soviet Union,1,1,0,2,1980
Aleksandr Blinov,Kyrgyzstan,1,1,0,2,1980
Nikolay Korolkov,Russian Federation,1,1,0,2,1980
Yury Kovshov,Soviet Union,1,1,0,2,1980
Jan Kowalczyk,Poland,1,1,0,2,1980
Federico Roman,Italy,1,1,0,2,1980
Pascal Jolyot,France,1,1,0,2,1980
Mikhail Burtsev,Russian Federation,1,1,0,2,1980
Angelo Parisi,France,1,1,0,2,1980
Andrea Pollack,East Germany,1,1,0,2,1980
Petra Schneider,East Germany,1,1,0,2,1980
Jörg Woithe,East Germany,1,1,0,2,1980
Sergey Fesenko,Soviet Union,1,1,0,2,1980
Seb Coe,Great Britain,1,1,0,2,1980
Allan Wells,Great Britain,1,1,0,2,1980
Marita Koch,East Germany,1,1,0,2,1980
Marlies Oelsner-Göhr,East Germany,1,1,0,2,1980
Volker Beck,East Germany,1,1,0,2,1980
Vera Komisova,Russian Federation,1,1,0,2,1980
Bernd Olbricht,East Germany,1,0,1,2,1980
Yury Salnikov,Russian Federation,1,0,1,2,1980
Viktor Ugryumov,Belarus,1,0,1,2,1980
Philippe Riboud,France,1,0,1,2,1980
Mariya Filatova,Russian Federation,1,0,1,2,1980
Stoyan Delchev,Bulgaria,1,0,1,2,1980
Zoltán Magyar,Hungary,1,0,1,2,1980
Dietmar Lorenz,East Germany,1,0,1,2,1980
Pavel Lednyov,Russian Federation,1,0,1,2,1980
Michelle Ford,Australia,1,0,1,2,1980
Peter Evans,Australia,1,0,1,2,1980
Mark Kerry,Australia,1,0,1,2,1980
Duncan Goodhew,Great Britain,1,0,1,2,1980
Ivar Stukolkin,Estonia,1,0,1,2,1980
Steve Ovett,Great Britain,1,0,1,2,1980
Ingrid Auerswald-Lange,East Germany,1,0,1,2,1980
Pietro Mennea,Italy,1,0,1,2,1980
Nadezhda Olizarenko,Soviet Union,1,0,1,2,1980
Tomi Poikolainen,Finland,1,0,0,1,1980
Petar Lesov,Bulgaria,1,0,0,1,1980
Andrés Aldama,Cuba,1,0,0,1,1980
José Gómez,Cuba,1,0,0,1,1980
Juan Hernández Pérez,Cuba,1,0,0,1,1980
Ángel Herrera,Cuba,1,0,0,1,1980
Armando Martínez,Cuba,1,0,0,1,1980
Teófilo Stevenson,Cuba,1,0,0,1,1980
Ketevan Losaberidze,Georgia,1,0,0,1,1980
Mirza Delibašić,Bosnia and Herzegovina,1,0,0,1,1980
Rudi Fink,East Germany,1,0,0,1,1980
Patrizio Oliva,Italy,1,0,0,1,1980
Mihovil Nakić-Vojnović,Croatia,1,0,0,1,1980
Olga Barysheva-Korostelyova,Russian Federation,1,0,0,1,1980
Vida Beselienė,Lithuania,1,0,0,1,1980
Nelli Feryabnikova,Russian Federation,1,0,0,1,1980
Tatyana Ivinskaya,Belarus,1,0,0,1,1980
Tatyana Ovechkina,Russian Federation,1,0,0,1,1980
Lyudmila Rogozhina,Russian Federation,1,0,0,1,1980
Angelė Rupšienė,Lithuania,1,0,0,1,1980
Uļjana Semjonova,Latvia,1,0,0,1,1980
Lyubov Sharmay,Russian Federation,1,0,0,1,1980
Nadezhda Shuvayeva-Olkhova,Russian Federation,1,0,0,1,1980
Olga Sukharnova,Russian Federation,1,0,0,1,1980
Tatyana Zakharova-Nadyrova,Soviet Union,1,0,0,1,1980
Krešimir Ćosić,Croatia,1,0,0,1,1980
Dražen Dalipagić,Serbia,1,0,0,1,1980
Željko Jerkov,Croatia,1,0,0,1,1980
Dragan Kićanović,Serbia,1,0,0,1,1980
Andro Knego,Croatia,1,0,0,1,1980
Duje Krstulović,Croatia,1,0,0,1,1980
Ratko Radovanović,Serbia,1,0,0,1,1980
Branko Skroče,Croatia,1,0,0,1,1980
Zoran Slavnić,Serbia,1,0,0,1,1980
Rajko Žižić,Montenegro,1,0,0,1,1980
Shamil Sabirov,Russian Federation,1,0,0,1,1980
Slobodan Kačar,Serbia,1,0,0,1,1980
Martina Bischof,East Germany,1,0,0,1,1980
Carsta Genäuß,East Germany,1,0,0,1,1980
Bernd Duvigneau,East Germany,1,0,0,1,1980
Harald Marg,East Germany,1,0,0,1,1980
Birgit Fischer-Schmidt,East Germany,1,0,0,1,1980
László Foltán,Hungary,1,0,0,1,1980
István Vaskuti,Hungary,1,0,0,1,1980
Toma Simionov,Romania,1,0,0,1,1980
Vera Misevich,Soviet Union,1,0,0,1,1980
Sissy Max-Theurer,Austria,1,0,0,1,1980
Viktor Asmayev,Russian Federation,1,0,0,1,1980
Viktor Poganovsky,Soviet Union,1,0,0,1,1980
Sergey Rogozhin,Russian Federation,1,0,0,1,1980
Vyacheslav Chukanov,Russian Federation,1,0,0,1,1980
Valery Volkov,Russian Federation,1,0,0,1,1980
Robert Dill-Bundi,Switzerland,1,0,0,1,1980
Lutz Heßlich,East Germany,1,0,0,1,1980
Anatoly Yarkin,Russian Federation,1,0,0,1,1980
Yury Kashirin,Russian Federation,1,0,0,1,1980
Aleksandr Krasnov,Russian Federation,1,0,0,1,1980
Oleg Logvin,Belarus,1,0,0,1,1980
Viktor Manakov,Russian Federation,1,0,0,1,1980
Valery Movchan,Soviet Union,1,0,0,1,1980
Vladimir Osokin,Russian Federation,1,0,0,1,1980
Vitaly Petrakov,Russian Federation,1,0,0,1,1980
Sergey Shelpakov,Russian Federation,1,0,0,1,1980
Sergey Sukhoruchenkov,Russian Federation,1,0,0,1,1980
Lothar Thoms,East Germany,1,0,0,1,1980
Vasudevan Bhaskaran,India,1,0,0,1,1980
Bir Bahadur Chettri,India,1,0,0,1,1980
Dung Dung Sylvanus,India,1,0,0,1,1980
Merwyn Fernandis,India,1,0,0,1,1980
Maharaj Krishon Kaushik,India,1,0,0,1,1980
Charanjit Kumar,India,1,0,0,1,1980
Somaya Muttana Maneypandey,India,1,0,0,1,1980
Muhammad Shahid,India,1,0,0,1,1980
Allan Schofield,India,1,0,0,1,1980
Amarjit Rana,India,1,0,0,1,1980
Devinder Singh,India,1,0,0,1,1980
Gurmail Singh,India,1,0,0,1,1980
Rajinder Singh,India,1,0,0,1,1980
Ravinder Pal Singh,India,1,0,0,1,1980
Surinder Singh Sodhi,India,1,0,0,1,1980
Zafar Iqbal,India,1,0,0,1,1980
Liz Chase,Zimbabwe,1,0,0,1,1980
Sandy Chick,Zimbabwe,1,0,0,1,1980
Gill Cowley,Zimbabwe,1,0,0,1,1980
Trish Davies,Zimbabwe,1,0,0,1,1980
Sarah English,Zimbabwe,1,0,0,1,1980
Maureen George,Zimbabwe,1,0,0,1,1980
Ann Grant,Zimbabwe,1,0,0,1,1980
Sue Huggett,Zimbabwe,1,0,0,1,1980
Pat McKillop,Zimbabwe,1,0,0,1,1980
Brenda Phillips,Zimbabwe,1,0,0,1,1980
Chris Prinsloo,Zimbabwe,1,0,0,1,1980
Sonia Robertson,Zimbabwe,1,0,0,1,1980
Anthea Stewart,Zimbabwe,1,0,0,1,1980
Helen Volk,Zimbabwe,1,0,0,1,1980
Linda Watson,Zimbabwe,1,0,0,1,1980
Isabelle Boéri-Bégard,France,1,0,0,1,1980
Véronique Brouquier,France,1,0,0,1,1980
Brigitte Latrille-Gaudin,France,1,0,0,1,1980
Christine Muzio,France,1,0,0,1,1980
Philippe Boisse,France,1,0,0,1,1980
Philippe Bonnin,France,1,0,0,1,1980
Bruno Boscherie,France,1,0,0,1,1980
Didier Flament,France,1,0,0,1,1980
Hubert Gardas,France,1,0,0,1,1980
Patrick Picot,France,1,0,0,1,1980
Frédéric Pietruszka,France,1,0,0,1,1980
Michel Salesse,France,1,0,0,1,1980
Johan Harmenberg,Sweden,1,0,0,1,1980
Vladimir Nazlymov,Russian Federation,1,0,0,1,1980
Viktor Sidyak,Belarus,1,0,0,1,1980
Jan Berger,Czech Republic,1,0,0,1,1980
František Kunzo,Czechoslovakia,1,0,0,1,1980
Werner Lička,Czech Republic,1,0,0,1,1980
Luděk Macela,Czech Republic,1,0,0,1,1980
Josef Mazura,Czech Republic,1,0,0,1,1980
Petr Němec,Czech Republic,1,0,0,1,1980
Luboš Pokluda,Czech Republic,1,0,0,1,1980
Libor Radimec,Czech Republic,1,0,0,1,1980
Oldřich Rott,Czech Republic,1,0,0,1,1980
Zdeněk Rygel,Czech Republic,1,0,0,1,1980
Zdeněk Šreiner,Czech Republic,1,0,0,1,1980
František Štambacher,Czech Republic,1,0,0,1,1980
Jindřich Svoboda,Czech Republic,1,0,0,1,1980
Rostislav Václavíček,Czech Republic,1,0,0,1,1980
Ladislav Vízek,Czech Republic,1,0,0,1,1980
Stanislav Seman,Czechoslovakia,1,0,0,1,1980
Yelena Naimushina,Russian Federation,1,0,0,1,1980
Stella Zakharova,Soviet Union,1,0,0,1,1980
Eduard Azaryan,Armenia,1,0,0,1,1980
Bohdan Makuts,Soviet Union,1,0,0,1,1980
Vladimir Markelov,Russian Federation,1,0,0,1,1980
Hans-Georg Beyer,East Germany,1,0,0,1,1980
Lothar Doering,East Germany,1,0,0,1,1980
Günter Dreibrodt,East Germany,1,0,0,1,1980
Ernst Gerlach,East Germany,1,0,0,1,1980
Klaus Gruner,East Germany,1,0,0,1,1980
Rainer Höft,East Germany,1,0,0,1,1980
Hans-Georg Jaunich,East Germany,1,0,0,1,1980
Hartmut Krüger,East Germany,1,0,0,1,1980
Peter Rost,East Germany,1,0,0,1,1980
Dietmar Schmidt,East Germany,1,0,0,1,1980
Wieland Schmidt,East Germany,1,0,0,1,1980
Siegfried Voigt,East Germany,1,0,0,1,1980
Ingolf Wiegert,East Germany,1,0,0,1,1980
Frank-Michael Wahl,East Germany,1,0,0,1,1980
Lyubov Berezhnaya-Odinokova,Soviet Union,1,0,0,1,1980
Lyudmila Bobrus-Poradnik,Soviet Union,1,0,0,1,1980
Larisa Karlova,Soviet Union,1,0,0,1,1980
Valentina Lutayeva,Soviet Union,1,0,0,1,1980
Tatyana Makarets-Kochergina,Soviet Union,1,0,0,1,1980
Irina Palchikova,Soviet Union,1,0,0,1,1980
Yuliya Safina,Russian Federation,1,0,0,1,1980
Larisa Savkina,Azerbaijan,1,0,0,1,1980
Nataliya Sherstyuk-Timoshkina,Soviet Union,1,0,0,1,1980
Sigita Strečen-Mažeikaitė,Lithuania,1,0,0,1,1980
Aldona Česaitytė-Nenėnienė,Lithuania,1,0,0,1,1980
Zinaida Turchina,Soviet Union,1,0,0,1,1980
Olga Zubareva,Soviet Union,1,0,0,1,1980
Ezio Gamba,Italy,1,0,0,1,1980
Shota Khabareli,Georgia,1,0,0,1,1980
Thierry Rey,France,1,0,0,1,1980
Jürg Röthlisberger,Switzerland,1,0,0,1,1980
Nikolay Solodukhin,Russian Federation,1,0,0,1,1980
Robert Van de Walle,Belgium,1,0,0,1,1980
Yevgeny Lipeyev,Russian Federation,1,0,0,1,1980
Pertti Karppinen,Finland,1,0,0,1,1980
Martina Boesler,East Germany,1,0,0,1,1980
Silvia Fröhlich,East Germany,1,0,0,1,1980
Ramona Kapheim,East Germany,1,0,0,1,1980
Cornelia Klier,East Germany,1,0,0,1,1980
Christiane Knetsch-Köpke,East Germany,1,0,0,1,1980
Jutta Lau,East Germany,1,0,0,1,1980
Gabi Lohs-Kühn,East Germany,1,0,0,1,1980
Gisela Medefindt,East Germany,1,0,0,1,1980
Karin Metze,East Germany,1,0,0,1,1980
Kersten Neisser,East Germany,1,0,0,1,1980
Angelika Noack,East Germany,1,0,0,1,1980
Jutta Ploch,East Germany,1,0,0,1,1980
Sybille Reinhardt,East Germany,1,0,0,1,1980
Ilona Richter,East Germany,1,0,0,1,1980
Marita Sandig,East Germany,1,0,0,1,1980
Birgit Schütz,East Germany,1,0,0,1,1980
Ute Steindorf,East Germany,1,0,0,1,1980
Romy Saalfeld,East Germany,1,0,0,1,1980
Liane Weigelt-Buhr,East Germany,1,0,0,1,1980
Kirsten Wenzel,East Germany,1,0,0,1,1980
Marina Wilke,East Germany,1,0,0,1,1980
Roswietha Zobelt,East Germany,1,0,0,1,1980
Siegfried Brietzke,East Germany,1,0,0,1,1980
Carsten Bunk,East Germany,1,0,0,1,1980
Andreas Decker,East Germany,1,0,0,1,1980
Ullrich Dießner,East Germany,1,0,0,1,1980
Walter Dießner,East Germany,1,0,0,1,1980
Jens Doberschütz,East Germany,1,0,0,1,1980
Joachim Dreifke,East Germany,1,0,0,1,1980
Uwe Dühring,East Germany,1,0,0,1,1980
Frank Dundr,East Germany,1,0,0,1,1980
Gottfried Döhn,East Germany,1,0,0,1,1980
Jörg Friedrich,East Germany,1,0,0,1,1980
Andreas Gregor,East Germany,1,0,0,1,1980
Uwe Heppner,East Germany,1,0,0,1,1980
Bernd Höing,East Germany,1,0,0,1,1980
Harald Jährling,East Germany,1,0,0,1,1980
Ulrich Karnatz,East Germany,1,0,0,1,1980
Ulrich Kons,East Germany,1,0,0,1,1980
Hans-Peter Koppe,East Germany,1,0,0,1,1980
Bernd Krauß,East Germany,1,0,0,1,1980
Klaus Kröppelien,East Germany,1,0,0,1,1980
Bernd Landvoigt,East Germany,1,0,0,1,1980
Jörg Landvoigt,East Germany,1,0,0,1,1980
Klaus-Dieter Ludwig,East Germany,1,0,0,1,1980
Stefan Semmler,East Germany,1,0,0,1,1980
Georg Spohr,East Germany,1,0,0,1,1980
Jürgen Thiele,East Germany,1,0,0,1,1980
Friedrich-Wilhelm Ulrich,East Germany,1,0,0,1,1980
Dieter Wendisch,East Germany,1,0,0,1,1980
Martin Winter,East Germany,1,0,0,1,1980
Sanda Toma,Romania,1,0,0,1,1980
Larisa Aleksandrova-Popova,Republic of Moldova,1,0,0,1,1980
Yelena Khloptseva,Belarus,1,0,0,1,1980
Kjeld Rasmussen,Denmark,1,0,0,1,1980
Károly Varga,Hungary,1,0,0,1,1980
Luciano Giovannetti,Italy,1,0,0,1,1980
Corneliu Ion,Romania,1,0,0,1,1980
Aleksandr Melentyev,Kyrgyzstan,1,0,0,1,1980
Igor Sokolov,Russian Federation,1,0,0,1,1980
Viktor Vlasov,Russian Federation,1,0,0,1,1980
Neil Brooks,Australia,1,0,0,1,1980
Mark Tonelli,Australia,1,0,0,1,1980
Ines Geißler,East Germany,1,0,0,1,1980
Sarina Hülsenbeck,East Germany,1,0,0,1,1980
Martina Jäschke,East Germany,1,0,0,1,1980
Falk Hoffmann,East Germany,1,0,0,1,1980
Sándor Wladár,Hungary,1,0,0,1,1980
Pär Arvidsson,Sweden,1,0,0,1,1980
Bengt Baron,Sweden,1,0,0,1,1980
Irina Kalinina,Russian Federation,1,0,0,1,1980
Lina Kačiušytė,Lithuania,1,0,0,1,1980
Aleksandr Portnov,Belarus,1,0,0,1,1980
Aleksandr Sidorenko,Soviet Union,1,0,0,1,1980
Robertas Žulpa,Lithuania,1,0,0,1,1980
Yelena Akhaminova,Russian Federation,1,0,0,1,1980
Yelena Andreyuk,Russian Federation,1,0,0,1,1980
Svetlana Badulina,Russian Federation,1,0,0,1,1980
Lyubov Kozyreva,Russian Federation,1,0,0,1,1980
Lidiya Loginova,Russian Federation,1,0,0,1,1980
Irina Makogonova,Russian Federation,1,0,0,1,1980
Svetlana Nikishina,Russian Federation,1,0,0,1,1980
Nadezhda Radzevich,Russian Federation,1,0,0,1,1980
Nataliya Razumova,Russian Federation,1,0,0,1,1980
Olga Solovova,Russian Federation,1,0,0,1,1980
Lyudmila Chernyshova,Russian Federation,1,0,0,1,1980
Vladimir Dorokhov,Russian Federation,1,0,0,1,1980
Aleksandr Yermilov,Russian Federation,1,0,0,1,1980
Vladimir Kondra,Russian Federation,1,0,0,1,1980
Valery Krivov,Soviet Union,1,0,0,1,1980
Fyodor Lashchonov,Soviet Union,1,0,0,1,1980
Viljar Loor,Estonia,1,0,0,1,1980
Oleg Moliboga,Soviet Union,1,0,0,1,1980
Yury Panchenko,Soviet Union,1,0,0,1,1980
Aleksandr Savin,Russian Federation,1,0,0,1,1980
Pāvels Seļivanovs,Latvia,1,0,0,1,1980
Vladimir Chernyshov,Russian Federation,1,0,0,1,1980
Vyacheslav Zaytsev,Russian Federation,1,0,0,1,1980
Vladimir Akimov,Russian Federation,1,0,0,1,1980
Aleksey Barkalov,Soviet Union,1,0,0,1,1980
Yevgeny Grishin,Russian Federation,1,0,0,1,1980
Mikhail Ivanov,Russian Federation,1,0,0,1,1980
Aleksandr Kabanov,Russian Federation,1,0,0,1,1980
Sergey Kotenko,Kazakhstan,1,0,0,1,1980
Giorgi Mshvenieradze,Georgia,1,0,0,1,1980
Mait Riisman,Estonia,1,0,0,1,1980
Erkin Shagayev,Soviet Union,1,0,0,1,1980
Yevgeny Sharonov,Russian Federation,1,0,0,1,1980
Vyacheslav Sobchenko,Russian Federation,1,0,0,1,1980
Yanko Rusev,Bulgaria,1,0,0,1,1980
Asen Zlatev,Bulgaria,1,0,0,1,1980
Daniel Núñez,Cuba,1,0,0,1,1980
Péter Baczakó,Hungary,1,0,0,1,1980
Ota Zaremba,Czech Republic,1,0,0,1,1980
Viktor Mazin,Kazakhstan,1,0,0,1,1980
Kanybek Osmonaliyev,Kyrgyzstan,1,0,0,1,1980
Sultanbay Rakhmanov,Soviet Union,1,0,0,1,1980
Leonid Taranenko,Belarus,1,0,0,1,1980
Yuri Vardanyan,Armenia,1,0,0,1,1980
Ismail Abilov,Bulgaria,1,0,0,1,1980
Georgi Raykov,Bulgaria,1,0,0,1,1980
Valentin Raychev,Bulgaria,1,0,0,1,1980
Stelios Mygiakis,Greece,1,0,0,1,1980
Ferenc Kocsis,Hungary,1,0,0,1,1980
Norbert Növényi,Hungary,1,0,0,1,1980
Claudio Pollio,Italy,1,0,0,1,1980
Ștefan Rusu,Romania,1,0,0,1,1980
Saypulla Absaidov,Russian Federation,1,0,0,1,1980
Magomedgasan Abushev,Russian Federation,1,0,0,1,1980
Soslan Andiyev,Russian Federation,1,0,0,1,1980
Anatoly Beloglazov,Russian Federation,1,0,0,1,1980
Sergey Beloglazov,Russian Federation,1,0,0,1,1980
Vakht'ang Blagidze,Georgia,1,0,0,1,1980
Aleksandr Kolchinsky,Soviet Union,1,0,0,1,1980
Gennady Korban,Russian Federation,1,0,0,1,1980
Ilya Mate,Soviet Union,1,0,0,1,1980
Sanasar Oganisyan,Russian Federation,1,0,0,1,1980
Shamil Serikov,Kazakhstan,1,0,0,1,1980
Zhaksylyk Ushkempirov,Kazakhstan,1,0,0,1,1980
Alejandro Abascal,Spain,1,0,0,1,1980
Valdemar Bandolowski,Denmark,1,0,0,1,1980
Lars Bjorkstrom,Brazil,1,0,0,1,1980
Erik Hansen,Denmark,1,0,0,1,1980
Poul Richard Høj Jensen,Denmark,1,0,0,1,1980
Valentin Mankin,Soviet Union,1,0,0,1,1980
Aleksandrs Muzičenko,Latvia,1,0,0,1,1980
Miguel Noguer,Spain,1,0,0,1,1980
Eduardo Penido,Brazil,1,0,0,1,1980
Marcos Soares,Brazil,1,0,0,1,1980
Esko Rechardt,Finland,1,0,0,1,1980
Alex Welter,Brazil,1,0,0,1,1980
María Colón,Cuba,1,0,0,1,1980
Daley Thompson,Great Britain,1,0,0,1,1980
Romy Müller,East Germany,1,0,0,1,1980
Ilona Schoknecht-Slupianek,East Germany,1,0,0,1,1980
Evelin Schlaak-Jahl,East Germany,1,0,0,1,1980
Waldemar Cierpinski,East Germany,1,0,0,1,1980
Lutz Dombrowski,East Germany,1,0,0,1,1980
Thomas Munkelt,East Germany,1,0,0,1,1980
Gerd Wessig,East Germany,1,0,0,1,1980
Hartwig Gauder,East Germany,1,0,0,1,1980
Sara Simeoni,Italy,1,0,0,1,1980
Maurizio Damilano,Italy,1,0,0,1,1980
Władysław Kozakiewicz,Poland,1,0,0,1,1980
Bronisław Malinowski,Poland,1,0,0,1,1980
Irina Nazarova,Russian Federation,1,0,0,1,1980
Tatyana Goyshchik,Russian Federation,1,0,0,1,1980
Tatyana Kazankina,Russian Federation,1,0,0,1,1980
Tatyana Kolpakova,Kyrgyzstan,1,0,0,1,1980
Lyudmila Kondratyeva,Russian Federation,1,0,0,1,1980
Tatyana Prorochenko,Soviet Union,1,0,0,1,1980
Nadezhda Tkachenko,Soviet Union,1,0,0,1,1980
Nina Zyuskova,Soviet Union,1,0,0,1,1980
Aleksandr Aksinin,Russian Federation,1,0,0,1,1980
Nikolay Chernetsky,Russian Federation,1,0,0,1,1980
Vladimir Kiselyov,Soviet Union,1,0,0,1,1980
Dainis Kūla,Latvia,1,0,0,1,1980
Mikhail Linge,Russian Federation,1,0,0,1,1980
Vladimir Muravyov,Kazakhstan,1,0,0,1,1980
Andrey Prokofyev,Russian Federation,1,0,0,1,1980
Viktor Rashchupkin,Russian Federation,1,0,0,1,1980
Yury Sedykh,Soviet Union,1,0,0,1,1980
Nikolay Sidorov,Russian Federation,1,0,0,1,1980
Jaak Uudmäe,Estonia,1,0,0,1,1980
Remigijus Valiulis,Lithuania,1,0,0,1,1980
Nikolay Alyokhin,Belarus,1,0,0,1,1980
Arsens Miskarovs,Latvia,0,2,1,3,1980
Emilia Eberle,Romania,0,2,0,2,1980
Tamás Szombathelyi,Hungary,0,2,0,2,1980
Viktor Kuznetsov,Russian Federation,0,2,0,2,1980
Nataliya Bochina,Russian Federation,0,2,0,2,1980
Steffi Kräker,East Germany,0,1,2,3,1980
Melita Ruhn,Romania,0,1,2,3,1980
Herminio Menéndez,Spain,0,1,1,2,1980
Olaf Heukrodt,East Germany,0,1,1,2,1980
Vasile Dîba,Romania,0,1,1,2,1980
Magda Maros,Hungary,0,1,1,2,1980
Ashot Karagyan,Armenia,0,1,1,2,1980
Aleksandr Romankov,Belarus,0,1,1,2,1980
Michael Nikolay,East Germany,0,1,1,2,1980
Nataliya Kazak,Russian Federation,0,1,1,2,1980
Nina Cheremisina,Russian Federation,0,1,1,2,1980
Roger Pyttel,East Germany,0,1,1,2,1980
Zoltán Verrasztó,Hungary,0,1,1,2,1980
Elvira Vasilkova,Belarus,0,1,1,2,1980
Kaarlo Maaninka,Finland,0,1,1,2,1980
Christina Brehmer-Lathan,East Germany,0,1,1,2,1980
Frank Schaffer,East Germany,0,1,1,2,1980
Adolfo Horta,Cuba,0,1,0,1,1980
Hipólito Ramos,Cuba,0,1,0,1,1980
Nataliya Butuzova,Soviet Union,0,1,0,1,1980
Boris Isachenko,Belarus,0,1,0,1,1980
Krasimira Bogdanova,Bulgaria,0,1,0,1,1980
Vanya Dermendzhieva,Bulgaria,0,1,0,1,1980
Diana Dilova-Braynova,Bulgaria,0,1,0,1,1980
Silviya Germanova,Bulgaria,0,1,0,1,1980
Nadka Golcheva,Bulgaria,0,1,0,1,1980
Petkana Makaveeva,Bulgaria,0,1,0,1,1980
Penka Metodieva,Bulgaria,0,1,0,1,1980
Angelina Mikhaylova,Bulgaria,0,1,0,1,1980
Snezhana Mikhaylova,Bulgaria,0,1,0,1,1980
Kostadinka Radkova,Bulgaria,0,1,0,1,1980
Evladiya Slavcheva-Stefanova,Bulgaria,0,1,0,1,1980
Penka Stoyanova,Bulgaria,0,1,0,1,1980
Marco Bonamico,Italy,0,1,0,1,1980
Roberto Brunamonti,Italy,0,1,0,1,1980
Fabrizio Della Fiori,Italy,0,1,0,1,1980
Pietro Generali,Italy,0,1,0,1,1980
Enrico Gilardi,Italy,0,1,0,1,1980
Pierluigi Marzorati,Italy,0,1,0,1,1980
Dino Meneghin,Italy,0,1,0,1,1980
Romeo Sacchetti,Italy,0,1,0,1,1980
Marco Solfrini,Italy,0,1,0,1,1980
Mike Sylvester,Italy,0,1,0,1,1980
Renzo Vecchiato,Italy,0,1,0,1,1980
Renato Villalta,Italy,0,1,0,1,1980
Paweł Skrzecz,Poland,0,1,0,1,1980
John Mugabi,Uganda,0,1,0,1,1980
Viktor Demyanenko,Kazakhstan,0,1,0,1,1980
Serik Konakbayev,Kazakhstan,0,1,0,1,1980
Aleksandr Koshkin,Russian Federation,0,1,0,1,1980
Viktor Miroshnichenko,Soviet Union,0,1,0,1,1980
Viktor Savchenko,Soviet Union,0,1,0,1,1980
Pyotr Zayev,Russian Federation,0,1,0,1,1980
Bernardo Piñango,Venezuela,0,1,0,1,1980
John Sumegi,Australia,0,1,0,1,1980
Vanya Gesheva,Bulgaria,0,1,0,1,1980
Guillermo del Riego,Spain,0,1,0,1,1980
Alain Lebas,France,0,1,0,1,1980
Uwe Madeja,East Germany,0,1,0,1,1980
István Joós,Hungary,0,1,0,1,1980
István Szabó,Hungary,0,1,0,1,1980
Petre Capusta,Romania,0,1,0,1,1980
Nicușor Eșanu,Romania,0,1,0,1,1980
Ion Geantă,Romania,0,1,0,1,1980
Mihai Zafiu,Romania,0,1,0,1,1980
Nina Gopova-Trofimova,Russian Federation,0,1,0,1,1980
Galina Kreft-Alekseyeva,Russian Federation,0,1,0,1,1980
Anna Casagrande,Italy,0,1,0,1,1980
Marina Sciocchetti,Italy,0,1,0,1,1980
Janusz Bobik,Poland,0,1,0,1,1980
Georgi Gadzhev,Bulgaria,0,1,0,1,1980
Wiesław Hartman,Poland,0,1,0,1,1980
Svetoslav Ivanov,Bulgaria,0,1,0,1,1980
Marian Kozicki,Poland,0,1,0,1,1980
Petar Mandadzhiev,Bulgaria,0,1,0,1,1980
Mauro Roman,Italy,0,1,0,1,1980
Falk Boden,East Germany,0,1,0,1,1980
Alain Bondue,France,0,1,0,1,1980
Yavé Cahard,France,0,1,0,1,1980
Bernd Drogan,East Germany,0,1,0,1,1980
Hans-Joachim Hartnick,East Germany,0,1,0,1,1980
Czesław Lang,Poland,0,1,0,1,1980
Olaf Ludwig,East Germany,0,1,0,1,1980
Gerald Mortag,East Germany,0,1,0,1,1980
Aleksandr Panfilov,Soviet Union,0,1,0,1,1980
Uwe Unterwalder,East Germany,0,1,0,1,1980
Matthias Wiegand,East Germany,0,1,0,1,1980
Volker Winkler,East Germany,0,1,0,1,1980
Juan Amat,Spain,0,1,0,1,1980
Juan Arbós,Spain,0,1,0,1,1980
Jaime Arbós,Spain,0,1,0,1,1980
Javier Cabot,Spain,0,1,0,1,1980
Ricardo Cabot,Spain,0,1,0,1,1980
Miguel Chaves,Spain,0,1,0,1,1980
Juan Luis Coghen,Spain,0,1,0,1,1980
Miguel de Paz,Spain,0,1,0,1,1980
Francisco Fábregas,Spain,0,1,0,1,1980
José Miguel García,Spain,0,1,0,1,1980
Rafael Garralda,Spain,0,1,0,1,1980
Santiago Malgosa,Spain,0,1,0,1,1980
Paulino Monsalve,Spain,0,1,0,1,1980
Juan Pellón,Spain,0,1,0,1,1980
Carlos Roca,Spain,0,1,0,1,1980
Jaime Zumalacárregui,Spain,0,1,0,1,1980
Milada Blažková,Czech Republic,0,1,0,1,1980
Jiřina Čermáková,Czech Republic,0,1,0,1,1980
Jiřina Hájková,Czech Republic,0,1,0,1,1980
Berta Hrubá,Czech Republic,0,1,0,1,1980
Ida Hubáčková,Czech Republic,0,1,0,1,1980
Jiřina Kadlecová,Czech Republic,0,1,0,1,1980
Jarmila Králíčková,Czech Republic,0,1,0,1,1980
Jiřina Křížová,Czech Republic,0,1,0,1,1980
Alena Kyselicová,Czechoslovakia,0,1,0,1,1980
Jana Lahodová,Czech Republic,0,1,0,1,1980
Květa Petříčková,Czech Republic,0,1,0,1,1980
Viera Podhányiová,Czechoslovakia,0,1,0,1,1980
Iveta Šranková,Czechoslovakia,0,1,0,1,1980
Marie Sýkorová,Czech Republic,0,1,0,1,1980
Marta Urbanová,Czech Republic,0,1,0,1,1980
Lenka Vymazalová,Czech Republic,0,1,0,1,1980
Nailya Gilyazova,Russian Federation,0,1,0,1,1980
Yelena Novikova-Belova,Belarus,0,1,0,1,1980
Valentina Sidorova,Russian Federation,0,1,0,1,1980
Larisa Tsagarayeva,Russian Federation,0,1,0,1,1980
Irina Ushakova,Belarus,0,1,0,1,1980
Ernő Kolczonay,Hungary,0,1,0,1,1980
Michele Maffei,Italy,0,1,0,1,1980
Ferdinando Meglio,Italy,0,1,0,1,1980
Mario Aldo Montano,Italy,0,1,0,1,1980
Marco Romano,Italy,0,1,0,1,1980
Giovanni Scalzo,Italy,0,1,0,1,1980
Ludomir Chronowski,Poland,0,1,0,1,1980
Piotr Jabłkowski,Poland,0,1,0,1,1980
Andrzej Lis,Poland,0,1,0,1,1980
Marius Strzalka,Germany,0,1,0,1,1980
Leszek Swornowski,Poland,0,1,0,1,1980
Vladimir Lapitsky,Belarus,0,1,0,1,1980
Sabirzhan Ruziyev,Soviet Union,0,1,0,1,1980
Frank Baum,East Germany,0,1,0,1,1980
Jürgen Bähringer,East Germany,0,1,0,1,1980
Lothar Hause,East Germany,0,1,0,1,1980
Bernd Jakubowski,East Germany,0,1,0,1,1980
Dieter Kühn,East Germany,0,1,0,1,1980
Matthias Liebers,East Germany,0,1,0,1,1980
Matthias Müller,East Germany,0,1,0,1,1980
Wolf-Rüdiger Netz,East Germany,0,1,0,1,1980
Werner Peter,East Germany,0,1,0,1,1980
Bodo Rudwaleit,East Germany,0,1,0,1,1980
Rüdiger Schnuphase,East Germany,0,1,0,1,1980
Wolfgang Steinbach,East Germany,0,1,0,1,1980
Frank Terletzki,East Germany,0,1,0,1,1980
Traudl Trautmann,East Germany,0,1,0,1,1980
Norbert Trieloff,East Germany,0,1,0,1,1980
Frank Uhlig,East Germany,0,1,0,1,1980
Artur Ullrich,East Germany,0,1,0,1,1980
Rodica Dunca,Romania,0,1,0,1,1980
Cristina Elena Grigoraș,Romania,0,1,0,1,1980
Dumitrița Turner,Romania,0,1,0,1,1980
Andreas Bronst,East Germany,0,1,0,1,1980
Ralf-Peter Hemmann,East Germany,0,1,0,1,1980
Lutz Hoffmann,East Germany,0,1,0,1,1980
Lutz Mack,East Germany,0,1,0,1,1980
Jasna Kolar-Merdan,Austria,0,1,0,1,1980
Vesna Radović,Austria,0,1,0,1,1980
Aleksandre Anp'ilogovi,Georgia,0,1,0,1,1980
Vladimir Belov,Russian Federation,0,1,0,1,1980
Anatoly Fedyukin,Russian Federation,0,1,0,1,1980
Mikhail Ishchenko,Soviet Union,0,1,0,1,1980
Aleksandr Karshakevich,Belarus,0,1,0,1,1980
Yury Kidyayev,Russian Federation,0,1,0,1,1980
Vladimir Kravtsov,Russian Federation,0,1,0,1,1980
Sergey Kushniryuk,Soviet Union,0,1,0,1,1980
Viktor Makhorin,Russian Federation,0,1,0,1,1980
Voldemaras Novickis,Lithuania,0,1,0,1,1980
Vladimir Repyev,Russian Federation,0,1,0,1,1980
Yevgeny Chernyshov,Russian Federation,0,1,0,1,1980
Nikolay Tomin,Soviet Union,0,1,0,1,1980
Aleksey Zhuk,Russian Federation,0,1,0,1,1980
Svetlana Anastasovski-Obućina,Serbia,0,1,0,1,1980
Mirjana Đurica,Serbia,0,1,0,1,1980
Radmila Drljača,Yugoslavia,0,1,0,1,1980
Katica Ileš,Croatia,0,1,0,1,1980
Slavica Jeremić,Serbia,0,1,0,1,1980
Svetlana Dašić-Kitić,Yugoslavia,0,1,0,1,1980
Vesna Milošević,Serbia,0,1,0,1,1980
Mirjana Ognjenović,Croatia,0,1,0,1,1980
Rada Savić,Serbia,0,1,0,1,1980
Ana Titlić,Croatia,0,1,0,1,1980
Biserka Višnjić,Croatia,0,1,0,1,1980
Zorica Vojinović,Serbia,0,1,0,1,1980
Neil Adams,Great Britain,0,1,0,1,1980
Isaac Azcuy,Cuba,0,1,0,1,1980
Tsendiin Damdin,Mongolia,0,1,0,1,1980
Juan Ferrer,Cuba,0,1,0,1,1980
Tengiz Khubuluri,Georgia,0,1,0,1,1980
José Rodríguez,Cuba,0,1,0,1,1980
Dimitar Zapryanov,Bulgaria,0,1,0,1,1980
László Horváth,Hungary,0,1,0,1,1980
Tibor Maracskó,Hungary,0,1,0,1,1980
Nadya Filipova,Bulgaria,0,1,0,1,1980
Ginka Gyurova,Bulgaria,0,1,0,1,1980
Mariyka Modeva,Bulgaria,0,1,0,1,1980
Rita Todorova,Bulgaria,0,1,0,1,1980
Iskra Velinova,Bulgaria,0,1,0,1,1980
Henry Clay,Great Britain,0,1,0,1,1980
Andrew Justice,Great Britain,0,1,0,1,1980
Chris Mahoney,Great Britain,0,1,0,1,1980
Duncan McDougall,Great Britain,0,1,0,1,1980
Malcolm McGowan,Great Britain,0,1,0,1,1980
"Colin, Lord Moynihan",Great Britain,0,1,0,1,1980
John Pritchard,Great Britain,0,1,0,1,1980
Richard Stanhope,Great Britain,0,1,0,1,1980
Allan Whitwell,Great Britain,0,1,0,1,1980
Cornelia Linse,East Germany,0,1,0,1,1980
Heidi Westphal,East Germany,0,1,0,1,1980
Małgorzata Dłużewska,Poland,0,1,0,1,1980
Czesława Kościańska-Szczepińska,Poland,0,1,0,1,1980
Aleksandr Lukyanov,Russian Federation,0,1,0,1,1980
Nina Frolova,Russian Federation,0,1,0,1,1980
Nadezhda Lyubimova,Russian Federation,0,1,0,1,1980
Antonina Makhina-Dumcheva-Zelikovich,Russian Federation,0,1,0,1,1980
Yelena Matiyevskaya,Russian Federation,0,1,0,1,1980
Mariya Pazyun,Soviet Union,0,1,0,1,1980
Olga Pivovarova,Soviet Union,0,1,0,1,1980
Nina Preobrazhenskaya,Soviet Union,0,1,0,1,1980
Nadezhda Prishchepa,Soviet Union,0,1,0,1,1980
Antonina Pustovit,Soviet Union,0,1,0,1,1980
Tatyana Stetsenko,Soviet Union,0,1,0,1,1980
Yelena Teryoshina,Soviet Union,0,1,0,1,1980
Nina Umanets,Soviet Union,0,1,0,1,1980
Olga Vasilchenko,Russian Federation,0,1,0,1,1980
Valentina Zhulina,Russian Federation,0,1,0,1,1980
Yevgeny Barbakov,Russian Federation,0,1,0,1,1980
Juris Bērziņš,Latvia,0,1,0,1,1980
Valery Dolinin,Russian Federation,0,1,0,1,1980
Nikolay Dovgan,Soviet Union,0,1,0,1,1980
Artūrs Garonskis,Latvia,0,1,0,1,1980
Vasily Yakusha,Belarus,0,1,0,1,1980
Vitaly Yeliseyev,Russian Federation,0,1,0,1,1980
Aleksey Kamkin,Russian Federation,0,1,0,1,1980
Valery Kleshnyov,Russian Federation,0,1,0,1,1980
Dimants Krišjānis,Latvia,0,1,0,1,1980
Dzintars Krišjānis,Latvia,0,1,0,1,1980
Gennady Kryuchkin,Russian Federation,0,1,0,1,1980
Aleksandr Kulagin,Russian Federation,0,1,0,1,1980
Viktor Pereverzev,Russian Federation,0,1,0,1,1980
Yury Pimenov,Russian Federation,0,1,0,1,1980
Nikolay Pimenov,Russian Federation,0,1,0,1,1980
Yury Shapochka,Soviet Union,0,1,0,1,1980
Žoržs Tikmers,Latvia,0,1,0,1,1980
Zoran Pančić,Serbia,0,1,0,1,1980
Milorad Stanulov,Serbia,0,1,0,1,1980
Bernd Hartstein,East Germany,0,1,0,1,1980
Hellfried Heilfort,East Germany,0,1,0,1,1980
Thomas Pfeffer,East Germany,0,1,0,1,1980
Harald Vollmar,East Germany,0,1,0,1,1980
Jürgen Wiefel,East Germany,0,1,0,1,1980
Lars-Göran Carlsson,Sweden,0,1,0,1,1980
Rustam Yambulatov,Soviet Union,0,1,0,1,1980
June Croft,Great Britain,0,1,0,1,1980
Sharron Davies,Great Britain,0,1,0,1,1980
Helen Jameson,Great Britain,0,1,0,1,1980
Maggie Kelly-Hohmann,Great Britain,0,1,0,1,1980
Ann Osgerby,Great Britain,0,1,0,1,1980
Philip Hubble,Great Britain,0,1,0,1,1980
Ina Kleber,East Germany,0,1,0,1,1980
Cornelia Polit,East Germany,0,1,0,1,1980
Martina Proeber,East Germany,0,1,0,1,1980
Sybille Schönrock,East Germany,0,1,0,1,1980
Detlev Grabs,East Germany,0,1,0,1,1980
Frank Pfütze,East Germany,0,1,0,1,1980
Rainer Strohbach,East Germany,0,1,0,1,1980
Albán Vermes,Hungary,0,1,0,1,1980
Carlos Girón,Mexico,0,1,0,1,1980
Agneta Eriksson,Sweden,0,1,0,1,1980
Tina Gustafsson,Sweden,0,1,0,1,1980
Carina Ljungdahl,Sweden,0,1,0,1,1980
Agneta Mårtensson,Sweden,0,1,0,1,1980
Per Holmertz,Sweden,0,1,0,1,1980
Silva Emirzyan,Armenia,0,1,0,1,1980
Svetlana Varganova,Russian Federation,0,1,0,1,1980
Vladimir Aleynik,Belarus,0,1,0,1,1980
Yevgeny Seredin,Russian Federation,0,1,0,1,1980
Aleksandr Chayev,Russian Federation,0,1,0,1,1980
Yordan Angelov,Bulgaria,0,1,0,1,1980
Dimitar Dimitrov,Bulgaria,0,1,0,1,1980
Stefan Dimitrov,Bulgaria,0,1,0,1,1980
Stoyan Gunchev,Bulgaria,0,1,0,1,1980
Khristo Iliev,Bulgaria,0,1,0,1,1980
Petko Petkov,Bulgaria,0,1,0,1,1980
Kaspar Simeonov,Bulgaria,0,1,0,1,1980
Khristo Stoyanov,Bulgaria,0,1,0,1,1980
Mitko Todorov,Bulgaria,0,1,0,1,1980
Tsano Tsanov,Bulgaria,0,1,0,1,1980
Emil Valchev,Bulgaria,0,1,0,1,1980
Dimitar Zlatanov,Bulgaria,0,1,0,1,1980
Katharina Bullin,East Germany,0,1,0,1,1980
Barbara Czekalla,East Germany,0,1,0,1,1980
Brigitte Fetzer,East Germany,0,1,0,1,1980
Andrea Heim,East Germany,0,1,0,1,1980
Ute Kostrzewa,East Germany,0,1,0,1,1980
Heike Lehmann,East Germany,0,1,0,1,1980
Christine Walther-Mummhardt,East Germany,0,1,0,1,1980
Karin Püschel,East Germany,0,1,0,1,1980
Karla Roffeis,East Germany,0,1,0,1,1980
Martina Schmidt,East Germany,0,1,0,1,1980
Annette Schultz,East Germany,0,1,0,1,1980
Anke Westendorf,East Germany,0,1,0,1,1980
Milivoj Bebić,Croatia,0,1,0,1,1980
Zoran Gopčević,Montenegro,0,1,0,1,1980
Milorad Krivokapić,Montenegro,0,1,0,1,1980
Boško Lozica,Croatia,0,1,0,1,1980
Predrag Manojlović,Yugoslavia,0,1,0,1,1980
Zoran Mustur,Montenegro,0,1,0,1,1980
Damir Polić,Croatia,0,1,0,1,1980
Zoran Roje,Croatia,0,1,0,1,1980
Ratko Rudić,Brazil,0,1,0,1,1980
Slobodan Trifunović,Serbia,0,1,0,1,1980
Luka Vezilić,Croatia,0,1,0,1,1980
Rumen Aleksandrov,Bulgaria,0,1,0,1,1980
Blagoy Blagoev,Bulgaria,0,1,0,1,1980
Valentin Khristov,Bulgaria,0,1,0,1,1980
Stefan Dimitrov,Bulgaria,0,1,0,1,1980
Jürgen Heuser,East Germany,0,1,0,1,1980
Joachim Kunz,East Germany,0,1,0,1,1980
Ho Bong-Chol,Democratic People's Republic of Korea,0,1,0,1,1980
Igor Nikitin,Russian Federation,0,1,0,1,1980
Aleksandr Pervy,Soviet Union,0,1,0,1,1980
Yurik Sarkisyan,Armenia,0,1,0,1,1980
Mikho Dukov,Bulgaria,0,1,0,1,1980
Ivan Yankov,Bulgaria,0,1,0,1,1980
Slavcho Chervenkov,Bulgaria,0,1,0,1,1980
Aleksandar Tomov,Bulgaria,0,1,0,1,1980
Uwe Neupert,East Germany,0,1,0,1,1980
József Balla,Hungary,0,1,0,1,1980
Lajos Rácz,Hungary,0,1,0,1,1980
István Tóth,Hungary,0,1,0,1,1980
Jamtsyn Davaajav,Mongolia,0,1,0,1,1980
Roman Bierła,Poland,0,1,0,1,1980
Jan Dołgowicz,Poland,0,1,0,1,1980
Józef Lipień,Poland,0,1,0,1,1980
Władysław Stecyk,Poland,0,1,0,1,1980
Andrzej Supron,Poland,0,1,0,1,1980
Jang Se-Hong,Democratic People's Republic of Korea,0,1,0,1,1980
Li Ho-Pyong,Democratic People's Republic of Korea,0,1,0,1,1980
Constantin Alexandru,Romania,0,1,0,1,1980
Magomedkhan Aratsilov,Russian Federation,0,1,0,1,1980
Anatoly Bykov,Kazakhstan,0,1,0,1,1980
Igor Kanygin,Belarus,0,1,0,1,1980
Jörn Borowski,East Germany,0,1,0,1,1980
Aleksandr Budnikov,Russian Federation,0,1,0,1,1980
Boris Budnikov,Russian Federation,0,1,0,1,1980
Peter Due,Denmark,0,1,0,1,1980
Karl Ferstl,Austria,0,1,0,1,1980
Wolfgang Mayrhofer,Austria,0,1,0,1,1980
Per Kjærgaard Nielsen,Denmark,0,1,0,1,1980
Nikolai Poljakov,Estonia,0,1,0,1,1980
Hubert Raudaschl,Austria,0,1,0,1,1980
Egbert Swensson,East Germany,0,1,0,1,1980
David Wilkins,Ireland,0,1,0,1,1980
Jamie Wilkinson,Ireland,0,1,0,1,1980
Rick Mitchell,Australia,0,1,0,1,1980
Mariya Vergova-Petkova,Bulgaria,0,1,0,1,1980
Alejandro Casañas,Cuba,0,1,0,1,1980
Silvio Leonard,Cuba,0,1,0,1,1980
Jorge Llopart,Spain,0,1,0,1,1980
Barbara Krug,East Germany,0,1,0,1,1980
Brigitte Wujak,East Germany,0,1,0,1,1980
Gabriele Löwe,East Germany,0,1,0,1,1980
Johanna Schaller-Klier,East Germany,0,1,0,1,1980
Christiane Stoll-Wartenberg,East Germany,0,1,0,1,1980
Andreas Knebel,East Germany,0,1,0,1,1980
Frank Paschek,East Germany,0,1,0,1,1980
Jürgen Straub,East Germany,0,1,0,1,1980
Klaus Thiele,East Germany,0,1,0,1,1980
Gerard Nijboer,Netherlands,0,1,0,1,1980
Urszula Kielan,Poland,0,1,0,1,1980
Lech Dunecki,Poland,0,1,0,1,1980
Zenon Licznerski,Poland,0,1,0,1,1980
Tadeusz Ślusarski,Poland,0,1,0,1,1980
Marian Woronin,Poland,0,1,0,1,1980
Jacek Wszoła,Poland,0,1,0,1,1980
Krzysztof Zwoliński,Poland,0,1,0,1,1980
Filbert Bayi,United Republic of Tanzania,0,1,0,1,1980
Suleiman Nyambui,United Republic of Tanzania,0,1,0,1,1980
Jarmila Kratochvílová,Czech Republic,0,1,0,1,1980
Imrich Bugár,Czechoslovakia,0,1,0,1,1980
Vera Anisimova,Russian Federation,0,1,0,1,1980
Esfir Dolzhenko-Krachevskaya,Russian Federation,0,1,0,1,1980
Saida Gunba,Georgia,0,1,0,1,1980
Olga Rukavishnikova,Russian Federation,0,1,0,1,1980
Lyudmila Zharkova-Maslakova,Russian Federation,0,1,0,1,1980
Olga Syrovatskaya-Mineyeva,Russian Federation,0,1,0,1,1980
Vasily Arkhipenko,Soviet Union,0,1,0,1,1980
Aleksandr Baryshnikov,Russian Federation,0,1,0,1,1980
Yury Kutsenko,Russian Federation,0,1,0,1,1980
Sergey Litvinov,Russian Federation,0,1,0,1,1980
Aleksandr Makarov,Russian Federation,0,1,0,1,1980
Pyotr Pochenchuk,Belarus,0,1,0,1,1980
Viktor Saneyev,Georgia,0,1,0,1,1980
Konstantin Volkov,Russian Federation,0,1,0,1,1980
Joaquín Pérez,Mexico,0,0,2,2,1980
Imre Gedővári,Hungary,0,0,2,2,1980
Carmela Schmidt,East Germany,0,0,2,2,1980
Päivi Meriluoto-Aaltonen,Finland,0,0,1,1,1980
José Aguilar,Cuba,0,0,1,1,1980
Ricardo Rojas,Cuba,0,0,1,1,1980
Giancarlo Ferrari,Italy,0,0,1,1,1980
Nik'oloz Deriugini,Georgia,0,0,1,1,1980
Tony Willis,Great Britain,0,0,1,1,1980
Herbert Bauch,East Germany,0,0,1,1,1980
Jürgen Fanghänel,East Germany,0,0,1,1,1980
Karl-Heinz Krüger,East Germany,0,0,1,1,1980
Detlef Kästner,East Germany,0,0,1,1,1980
Richard Nowakowski,East Germany,0,0,1,1,1980
Michael Anthony,Guyana,0,0,1,1,1980
István Lévai,Hungary,0,0,1,1,1980
János Váradi,Hungary,0,0,1,1,1980
Hugh Russell,Ireland,0,0,1,1,1980
Mersada Bećirspahić,Bosnia and Herzegovina,0,0,1,1,1980
Mira Bjedov,Croatia,0,0,1,1,1980
Vesna Despotović,Serbia,0,0,1,1,1980
Vera Đurašković,Yugoslavia,0,0,1,1,1980
Zorica Đurković,Yugoslavia,0,0,1,1,1980
Jelica Komnenović,Serbia,0,0,1,1,1980
Biljana Majstorović,Serbia,0,0,1,1,1980
Vukica Mitić,Serbia,0,0,1,1,1980
Sanja Ožegović,Croatia,0,0,1,1,1980
Sofija Pekić,Serbia,0,0,1,1,1980
Jasmina Perazić,Serbia,0,0,1,1,1980
Marija Tonković,Serbia,0,0,1,1,1980
Aleksandr Belostenny,Soviet Union,0,0,1,1,1980
Sergey Belov,Russian Federation,0,0,1,1,1980
Stanislav Yeryomin,Russian Federation,0,0,1,1,1980
Sergėjus Jovaiša,Lithuania,0,0,1,1,1980
Andrey Lopatov,Russian Federation,0,0,1,1,1980
Valery Miloserdov,Russian Federation,0,0,1,1,1980
Anatoly Myshkin,Russian Federation,0,0,1,1,1980
Aleksandr Salnikov,Soviet Union,0,0,1,1,1980
Sergey Tarakanov,Russian Federation,0,0,1,1,1980
Vladimir Tkachenko,Soviet Union,0,0,1,1,1980
Vladimir Zhigily,Russian Federation,0,0,1,1,1980
Ivaylo Mustafov-Khristov,Bulgaria,0,0,1,1,1980
Kazimierz Adach,Poland,0,0,1,1,1980
Krzysztof Kosedowski,Poland,0,0,1,1,1980
Jerzy Rybicki,Poland,0,0,1,1,1980
Kazimierz Szczerba,Poland,0,0,1,1,1980
Li Byong-Uk,Democratic People's Republic of Korea,0,0,1,1,1980
Dumitru Cipere,Romania,0,0,1,1,1980
Valentin Silaghi,Romania,0,0,1,1,1980
Ján Franek,Czechoslovakia,0,0,1,1,1980
Viktor Rybakov,Russian Federation,0,0,1,1,1980
Borislav Ananiev,Bulgaria,0,0,1,1,1980
Borislav Borisov,Bulgaria,0,0,1,1,1980
Lazar Khristov,Bulgaria,0,0,1,1,1980
Nikolay Ilkov,Bulgaria,0,0,1,1,1980
Ivan Manev,Bulgaria,0,0,1,1,1980
Bozhidar Milenkov,Bulgaria,0,0,1,1,1980
Luis Ramos,Spain,0,0,1,1,1980
Eckhard Leue,East Germany,0,0,1,1,1980
Éva Rakusz,Hungary,0,0,1,1,1980
Mária Zakariás,Hungary,0,0,1,1,1980
Ion Bîrlădeanu,Romania,0,0,1,1,1980
Antonina Melnikova,Belarus,0,0,1,1,1980
Vasily Yurchenko,Soviet Union,0,0,1,1,1980
Yury Lobanov,Soviet Union,0,0,1,1,1980
Anghel Donescu,Romania,0,0,1,1,1980
David Bárcena,Mexico,0,0,1,1,1980
Jesús Gómez,Mexico,0,0,1,1,1980
Manuel Mendívil,Mexico,0,0,1,1,1980
José Luis Pérez Soto,Mexico,0,0,1,1,1980
Petre Roșca,Romania,0,0,1,1,1980
Gerardo Tazzer,Mexico,0,0,1,1,1980
Alberto Váldes Lacarra,Mexico,0,0,1,1,1980
Fabián Vázquez,Mexico,0,0,1,1,1980
Dumitru Velicu,Romania,0,0,1,1,1980
Yury Barinov,Russian Federation,0,0,1,1,1980
Teodor Černý,Czech Republic,0,0,1,1,1980
Michal Klasa,Czech Republic,0,0,1,1,1980
Vlastibor Konečný,Czech Republic,0,0,1,1,1980
Sergey Kopylov,Russian Federation,0,0,1,1,1980
Alipi Kostadinov,Czech Republic,0,0,1,1,1980
Martin Penc,Czech Republic,0,0,1,1,1980
Jiří Pokorný,Czech Republic,0,0,1,1,1980
Jiří Škoda,Czech Republic,0,0,1,1,1980
Igor Sláma,Czech Republic,0,0,1,1,1980
David Weller,Jamaica,0,0,1,1,1980
Hans-Henrik Ørsted,Denmark,0,0,1,1,1980
Leyla Akhmerova,Soviet Union,0,0,1,1,1980
Nataliya Buzunova,Russian Federation,0,0,1,1,1980
Nataliya Bykova,Russian Federation,0,0,1,1,1980
Alina Kham,Soviet Union,0,0,1,1,1980
Nadya Filippova,Russian Federation,0,0,1,1,1980
Lyudmila Frolova,Russian Federation,0,0,1,1,1980
Lidiya Glubokova,Russian Federation,0,0,1,1,1980
Nelli Gorbyatkova,Soviet Union,0,0,1,1,1980
Yelena Guryeva,Russian Federation,0,0,1,1,1980
Galina Inzhuvatova,Russian Federation,0,0,1,1,1980
Tatyana Yembakhtova,Soviet Union,0,0,1,1,1980
Natella Krasnikova,Russian Federation,0,0,1,1,1980
Nadezhda Ovechkina,Russian Federation,0,0,1,1,1980
Tatyana Shvyganova,Russian Federation,0,0,1,1,1980
Galina Vyuzhanina,Russian Federation,0,0,1,1,1980
Valentina Zazdravnykh,Soviet Union,0,0,1,1,1980
Sos Hayrapetyan,Armenia,0,0,1,1,1980
Minneula Azizov,Kazakhstan,0,0,1,1,1980
Valery Belyakov,Russian Federation,0,0,1,1,1980
Viktor Deputatov,Russian Federation,0,0,1,1,1980
Aleksandr Goncharov,Kazakhstan,0,0,1,1,1980
Aleksandr Gusev,Russian Federation,0,0,1,1,1980
Sergey Klevtsov,Russian Federation,0,0,1,1,1980
Vyacheslav Lampeyev,Russian Federation,0,0,1,1,1980
Aleksandr Myasnikov,Kazakhstan,0,0,1,1,1980
Mikhail Nichepurenko,Kazakhstan,0,0,1,1,1980
Leonid Pavlovsky,Russian Federation,0,0,1,1,1980
Sergey Pleshakov,Russian Federation,0,0,1,1,1980
Vladimir Pleshakov,Russian Federation,0,0,1,1,1980
Aleksandr Sychov,Russian Federation,0,0,1,1,1980
Oleg Zagorodnev,Kazakhstan,0,0,1,1,1980
Farit Zigangirov,Kazakhstan,0,0,1,1,1980
Edit Kovács,Hungary,0,0,1,1,1980
Ildikó Schwarczenberger-Tordasi,Hungary,0,0,1,1,1980
Gertrúd Stefanek,Hungary,0,0,1,1,1980
Zsuzsa Szőcs,Hungary,0,0,1,1,1980
Barbara Wysoczańska,Poland,0,0,1,1,1980
Pál Gerevich,Hungary,0,0,1,1,1980
Ferenc Hammang,Hungary,0,0,1,1,1980
György Nébald,Hungary,0,0,1,1,1980
Rudolf Nébald,Hungary,0,0,1,1,1980
Lech Koziejowski,Poland,0,0,1,1,1980
Adam Robak,Poland,0,0,1,1,1980
Marian Sypniewski,Poland,0,0,1,1,1980
Bogusław Zych,Poland,0,0,1,1,1980
Aleksandr Abushakhmetov,Russian Federation,0,0,1,1,1980
Boris Lukomsky,Russian Federation,0,0,1,1,1980
Aleksandr Mozhayev,Russian Federation,0,0,1,1,1980
Sergey Andreyev,Russian Federation,0,0,1,1,1980
Sergey Baltacha,Soviet Union,0,0,1,1,1980
Vladimir Bessonov,Soviet Union,0,0,1,1,1980
Rinat Dasayev,Russian Federation,0,0,1,1,1980
Valery Gazzayev,Russian Federation,0,0,1,1,1980
Yury Gavrilov,Russian Federation,0,0,1,1,1980
Sergey Nikulin,Russian Federation,0,0,1,1,1980
Khoren Hovhannisyan,Armenia,0,0,1,1,1980
Vladimir Pilguy,Russian Federation,0,0,1,1,1980
Aleksandr Prokopenko,Belarus,0,0,1,1,1980
Oleg Romantsev,Russian Federation,0,0,1,1,1980
Sergey Shavlo,Russian Federation,0,0,1,1,1980
Tengiz Sulakvelidze,Georgia,0,0,1,1,1980
Revaz Chelebadze,Georgia,0,0,1,1,1980
Fyodor Cherenkov,Russian Federation,0,0,1,1,1980
Vagiz Khidiyatullin,Russian Federation,0,0,1,1,1980
Aleksandre Chivadze,Georgia,0,0,1,1,1980
Silvia Hindorff,East Germany,0,0,1,1,1980
Katharina Rensch,East Germany,0,0,1,1,1980
Birgit Süß,East Germany,0,0,1,1,1980
Karola Sube,East Germany,0,0,1,1,1980
Ferenc Donáth,Hungary,0,0,1,1,1980
György Guczoghy,Hungary,0,0,1,1,1980
Zoltán Kelemen,Hungary,0,0,1,1,1980
Péter Kovács,Hungary,0,0,1,1,1980
István Vámos,Hungary,0,0,1,1,1980
Jiří Tabák,Czech Republic,0,0,1,1,1980
Birgit Heinecke,East Germany,0,0,1,1,1980
Waltraud Kretzschmar,East Germany,0,0,1,1,1980
Katrin Krüger,East Germany,0,0,1,1,1980
Kornelia Kunisch,East Germany,0,0,1,1,1980
Evelyn Matz,East Germany,0,0,1,1,1980
Kristina Richter,East Germany,0,0,1,1,1980
Christina Rost,East Germany,0,0,1,1,1980
Renate Rudolph,East Germany,0,0,1,1,1980
Sabine Röther,East Germany,0,0,1,1,1980
Marion Tietz,East Germany,0,0,1,1,1980
Petra Uhlig,East Germany,0,0,1,1,1980
Claudia Wunderlich,East Germany,0,0,1,1,1980
Hannelore Zober,East Germany,0,0,1,1,1980
Ștefan Birtalan,Romania,0,0,1,1,1980
Iosif Boroș,Romania,0,0,1,1,1980
Adrian Cosma,Romania,0,0,1,1,1980
Cezar Drăgăniță,Romania,0,0,1,1,1980
Marian Dumitru,Romania,0,0,1,1,1980
Cornel Durău,Romania,0,0,1,1,1980
Alexandru Fölker,Romania,0,0,1,1,1980
Claudiu Ionescu,Romania,0,0,1,1,1980
Nicolae Munteanu,Romania,0,0,1,1,1980
Vasile Stîngă,Romania,0,0,1,1,1980
Lucian Vasilache,Romania,0,0,1,1,1980
Neculai Vasilca,Romania,0,0,1,1,1980
Maricel Voinea,Romania,0,0,1,1,1980
Radu Voina,Romania,0,0,1,1,1980
Bernard Tchoullouyan,France,0,0,1,1,1980
Ravdangiin Davaadalai,Mongolia,0,0,1,1,1980
Harald Heinke,East Germany,0,0,1,1,1980
Aleksandrs Jackēvičs,Latvia,0,0,1,1,1980
Aramby Yemizh,Russian Federation,0,0,1,1,1980
Tibor Kincses,Hungary,0,0,1,1,1980
Vladimír Kocman,Czech Republic,0,0,1,1,1980
Radomir Kovačević,Yugoslavia,0,0,1,1,1980
Karl-Heinz Lehmann,East Germany,0,0,1,1,1980
Arthur Mapp,Great Britain,0,0,1,1,1980
Iliyan Nedkov,Bulgaria,0,0,1,1,1980
Henk Numan,Netherlands,0,0,1,1,1980
Janusz Pawłowski,Poland,0,0,1,1,1980
Detlef Ultsch,East Germany,0,0,1,1,1980
András Ozsvár,Hungary,0,0,1,1,1980
George Horvath,Sweden,0,0,1,1,1980
Lennart Pettersson,Sweden,0,0,1,1,1980
Svante Rasmuson,Sweden,0,0,1,1,1980
Anka Bakova,Bulgaria,0,0,1,1,1980
Rumelyana Boncheva,Bulgaria,0,0,1,1,1980
Stoyanka Gruycheva-Kurbatova,Bulgaria,0,0,1,1,1980
Siyka Kelbecheva-Barbulova,Bulgaria,0,0,1,1,1980
Dolores Nakova,Bulgaria,0,0,1,1,1980
Mariana Serbezova,Bulgaria,0,0,1,1,1980
Bogdan Dobrev,Bulgaria,0,0,1,1,1980
Mincho Nikolov,Bulgaria,0,0,1,1,1980
Lyubomir Petrov,Bulgaria,0,0,1,1,1980
Ivo Rusev,Bulgaria,0,0,1,1,1980
John Beattie,Great Britain,0,0,1,1,1980
Malcolm Carmichael,Great Britain,0,0,1,1,1980
Martin Cross,Great Britain,0,0,1,1,1980
Ian McNuff,Great Britain,0,0,1,1,1980
David Townsend,Great Britain,0,0,1,1,1980
Charles Wiggin,Great Britain,0,0,1,1,1980
Martina Schröter,East Germany,0,0,1,1,1980
Peter Kersten,East Germany,0,0,1,1,1980
Ryszard Kubiak,Poland,0,0,1,1,1980
Grzegorz Nowak,Poland,0,0,1,1,1980
Ryszard Stadniuk,Poland,0,0,1,1,1980
Grzegorz Stellak,Poland,0,0,1,1,1980
Adam Tomasiak,Poland,0,0,1,1,1980
Angelica Aposteanu,Romania,0,0,1,1,1980
Elena Bondar,Romania,0,0,1,1,1980
Florica Bucur,Romania,0,0,1,1,1980
Maria Constantinescu,Romania,0,0,1,1,1980
Elena Dobrițoiu,Romania,0,0,1,1,1980
Rodica Frîntu,Romania,0,0,1,1,1980
Olga Homeghi-Bularda,Romania,0,0,1,1,1980
Ana Iliuță,Romania,0,0,1,1,1980
Marlena Predescu-Zagoni,Romania,0,0,1,1,1980
Rodica Arba-Pușcatu,Romania,0,0,1,1,1980
Valeria Roșca-Răcilă,Romania,0,0,1,1,1980
Zdeněk Pecka,Czech Republic,0,0,1,1,1980
Václav Vochoska,Czech Republic,0,0,1,1,1980
Hryhoriy Dmytrenko,Soviet Union,0,0,1,1,1980
Mariya Fadeyeva,Russian Federation,0,0,1,1,1980
Svetlana Semyonova,Russian Federation,0,0,1,1,1980
Galina Sovetnikova,Russian Federation,0,0,1,1,1980
Marina Studneva,Russian Federation,0,0,1,1,1980
Viktor Kakoshin,Soviet Union,0,0,1,1,1980
Andrey Lugin,Belarus,0,0,1,1,1980
Igor Maystrenko,Belarus,0,0,1,1,1980
Aleksandr Mantsevich,Soviet Union,0,0,1,1,1980
Jonas Narmontas,Lithuania,0,0,1,1,1980
Jonas Pinskus,Lithuania,0,0,1,1,1980
Andrey Tishchenko,Soviet Union,0,0,1,1,1980
Aleksandr Tkachenko,Soviet Union,0,0,1,1,1980
Zlatko Celent,Croatia,0,0,1,1,1980
Duško Mrduljaš,Croatia,0,0,1,1,1980
Josip Reić,Croatia,0,0,1,1,1980
Gerhard Petritsch,Austria,0,0,1,1,1980
Lyubcho Dyakov,Bulgaria,0,0,1,1,1980
Petar Zapryanov,Bulgaria,0,0,1,1,1980
Roberto Castrillo,Cuba,0,0,1,1,1980
Jörg Damme,East Germany,0,0,1,1,1980
Sven Johansson,Sweden,0,0,1,1,1980
Aleksandr Gazov,Belarus,0,0,1,1,1980
Graeme Brewer,Australia,0,0,1,1,1980
Max Metzker,Australia,0,0,1,1,1980
Jorge Fernandes,Brazil,0,0,1,1,1980
Djan Madruga,Brazil,0,0,1,1,1980
Marcus Mattioli,Brazil,0,0,1,1,1980
Cyro Delgado,Brazil,0,0,1,1,1980
Susanne Nielsson,Denmark,0,0,1,1,1980
David López-Zubero,Spain,0,0,1,1,1980
Gary Abraham,Great Britain,0,0,1,1,1980
David Lowe,Great Britain,0,0,1,1,1980
Martin Smith,Great Britain,0,0,1,1,1980
Heike Dähne,East Germany,0,0,1,1,1980
Karin Guthke,East Germany,0,0,1,1,1980
Christiane Knacke,East Germany,0,0,1,1,1980
Roswitha Krause,East Germany,0,0,1,1,1980
Petra Riedel,East Germany,0,0,1,1,1980
Birgit Treiber,East Germany,0,0,1,1,1980
Franco Cagnotto,Italy,0,0,1,1,1980
Reggie de Jong,Netherlands,0,0,1,1,1980
Annelies Maas,Netherlands,0,0,1,1,1980
Conny van Bentum,Netherlands,0,0,1,1,1980
Wilma van Velsen,Netherlands,0,0,1,1,1980
Agnieszka Czopek,Poland,0,0,1,1,1980
Per Johansson,Sweden,0,0,1,1,1980
Yuliya Bogdanova,Russian Federation,0,0,1,1,1980
Alla Grishchenkova,Russian Federation,0,0,1,1,1980
Yelena Kruglova,Soviet Union,0,0,1,1,1980
Nataliya Strunnikova,Russian Federation,0,0,1,1,1980
Liana Tsot'adze,Georgia,0,0,1,1,1980
Davit Hambardzumyan,Armenia,0,0,1,1,1980
Vladimir Dolgov,Soviet Union,0,0,1,1,1980
Tanya Dimitrova,Bulgaria,0,0,1,1,1980
Tanya Gogova,Bulgaria,0,0,1,1,1980
Valentina Ilieva,Bulgaria,0,0,1,1,1980
Rumyana Kaisheva,Bulgaria,0,0,1,1,1980
Silviya Petrunova,Bulgaria,0,0,1,1,1980
Verka Borisova,Bulgaria,0,0,1,1,1980
Maya Georgieva,Bulgaria,0,0,1,1,1980
Anka Khristolova,Bulgaria,0,0,1,1,1980
Tsvetana Bozhurina,Bulgaria,0,0,1,1,1980
Rositsa Mikhaylova,Bulgaria,0,0,1,1,1980
Marius Chițiga,Romania,0,0,1,1,1980
Corneliu Chifu,Romania,0,0,1,1,1980
Laurențiu Dumănoiu,Romania,0,0,1,1,1980
Günther Enescu,Romania,0,0,1,1,1980
Dan Gîrleanu,Romania,0,0,1,1,1980
Sorin Macavei,Romania,0,0,1,1,1980
Cornel Oros,Romania,0,0,1,1,1980
Nicolae Pop,Romania,0,0,1,1,1980
Constantin Sterea,Romania,0,0,1,1,1980
Nicu Stoian,Romania,0,0,1,1,1980
Gábor Csapó,Hungary,0,0,1,1,1980
Tamás Faragó,Hungary,0,0,1,1,1980
György Gerendás,Hungary,0,0,1,1,1980
Károly Hauszler,Hungary,0,0,1,1,1980
György Horkai,Hungary,0,0,1,1,1980
István Kiss,Hungary,0,0,1,1,1980
László Kuncz,Hungary,0,0,1,1,1980
Endre Molnár,Hungary,0,0,1,1,1980
Attila Sudár,Hungary,0,0,1,1,1980
"István Szívós, Jr.",Hungary,0,0,1,1,1980
István Udvardi,Hungary,0,0,1,1,1980
Nedelcho Kolev,Bulgaria,0,0,1,1,1980
Mincho Pashov,Bulgaria,0,0,1,1,1980
Alberto Blanco,Cuba,0,0,1,1,1980
Frank Mantek,East Germany,0,0,1,1,1980
György Szalai,Hungary,0,0,1,1,1980
Tadeusz Dembończyk,Poland,0,0,1,1,1980
Tadeusz Rutkowski,Poland,0,0,1,1,1980
Marek Seweryn,Poland,0,0,1,1,1980
Han Gyong-Si,Democratic People's Republic of Korea,0,0,1,1,1980
Dušan Poliačik,Czechoslovakia,0,0,1,1,1980
Mladen Mladenov,Bulgaria,0,0,1,1,1980
Pavel Pavlov,Bulgaria,0,0,1,1,1980
Nermedin Selimov,Bulgaria,0,0,1,1,1980
Mikko Huhtala,Finland,0,0,1,1,1980
Georgios Khatziioannidis,Greece,0,0,1,1,1980
István Kovács,Hungary,0,0,1,1,1980
Ferenc Seres,Hungary,0,0,1,1,1980
Hassan Bechara,Lebanon,0,0,1,1,1980
Dugarsürengiin Oyuunbold,Mongolia,0,0,1,1,1980
Aleksander Cichoń,Poland,0,0,1,1,1980
Adam Sandurski,Poland,0,0,1,1,1980
Vasile Andrei,Romania,0,0,1,1,1980
Petre Dicu,Romania,0,0,1,1,1980
Benni Ljungbeck,Sweden,0,0,1,1,1980
Lars-Erik Skiöld,Sweden,0,0,1,1,1980
Dan Karabin,Czechoslovakia,0,0,1,1,1980
Július Strnisko,Czechoslovakia,0,0,1,1,1980
Sergey Kornilayev,Russian Federation,0,0,1,1,1980
Boris Kramarenko,Russian Federation,0,0,1,1,1980
Šaban Sejdi,North Macedonia,0,0,1,1,1980
Andrey Balashov,Russian Federation,0,0,1,1,1980
Tasos Bountouris,Greece,0,0,1,1,1980
Szabolcs Detre,Hungary,0,0,1,1,1980
Zsolt Detre,Hungary,0,0,1,1,1980
Anastasios Gavrilis,Greece,0,0,1,1,1980
Giorgio Gorla,Italy,0,0,1,1,1980
Jouko Lindgren,Finland,0,0,1,1,1980
Göran Marström,Sweden,0,0,1,1,1980
Alfio Peraboni,Italy,0,0,1,1,1980
Jörgen Ragnarsson,Sweden,0,0,1,1,1980
Aristidis Rapanakis,Greece,0,0,1,1,1980
Georg Tallberg,Finland,0,0,1,1,1980
João do Pulo,Brazil,0,0,1,1,1980
Petar Petrov,Bulgaria,0,0,1,1,1980
Luis Delís,Cuba,0,0,1,1,1980
Jüri Tamm,Estonia,0,0,1,1,1980
Mohamed Kedir,Ethiopia,0,0,1,1,1980
Eshetu Tura,Ethiopia,0,0,1,1,1980
Pascal Barré,France,0,0,1,1,1980
Patrick Barré,France,0,0,1,1,1980
Hermann Panzo,France,0,0,1,1,1980
Antoine Richard,France,0,0,1,1,1980
Bev Goddard-Callender,Great Britain,0,0,1,1,1980
Joslyn Hoyte-Smith,Great Britain,0,0,1,1,1980
Heather Hunte-Oakes,Great Britain,0,0,1,1,1980
Sonia Lannaman,Great Britain,0,0,1,1,1980
Linsey MacDonald,Great Britain,0,0,1,1,1980
Donna Murray-Hartley,Great Britain,0,0,1,1,1980
Michelle Probert-Scutt,Great Britain,0,0,1,1,1980
Kathy Smallwood-Cook,Great Britain,0,0,1,1,1980
Gary Oakes,Great Britain,0,0,1,1,1980
Margitta Droese-Pufe,East Germany,0,0,1,1,1980
Ute Hommola,East Germany,0,0,1,1,1980
Jutta Kirst,East Germany,0,0,1,1,1980
Jörg Freimuth,East Germany,0,0,1,1,1980
Wolfgang Hanisch,East Germany,0,0,1,1,1980
Roland Wieser,East Germany,0,0,1,1,1980
Udo Beyer,East Germany,0,0,1,1,1980
Stefano Malinverni,Italy,0,0,1,1,1980
Roberto Tozzi,Italy,0,0,1,1,1980
Mauro Zuliani,Italy,0,0,1,1,1980
Merlene Ottey-Page,Jamaica,0,0,1,1,1980
Don Quarrie,Jamaica,0,0,1,1,1980
Lucyna Langer,Poland,0,0,1,1,1980
Olga Kuragina,Russian Federation,0,0,1,1,1980
Tatyana Lesovaya,Kazakhstan,0,0,1,1,1980
Tatyana Providokhina,Russian Federation,0,0,1,1,1980
Tatyana Skachko,Soviet Union,0,0,1,1,1980
Satymkul Dzhumanazarov,Kyrgyzstan,0,0,1,1,1980
Yevgeny Ivchenko,Belarus,0,0,1,1,1980
Nikolay Kirov,Belarus,0,0,1,1,1980
Valery Podluzhny,Soviet Union,0,0,1,1,1980
Aleksandr Puchkov,Russian Federation,0,0,1,1,1980
Sergey Zhelanov,Russian Federation,0,0,1,1,1980
Anka Georgieva,Bulgaria,0,0,1,1,1980
Ecaterina Szabo,Romania,4,1,0,5,1984
Carl Lewis,United States,4,0,0,4,1984
Li Ning,People's Republic of China,3,2,1,6,1984
Nancy Hogshead,United States,3,1,0,4,1984
Mike Heath,United States,3,1,0,4,1984
Ian Ferguson,New Zealand,3,0,0,3,1984
Tracy Caulkins,United States,3,0,0,3,1984
Mary T. Meagher,United States,3,0,0,3,1984
Carrie Steinseifer,United States,3,0,0,3,1984
Rick Carey,United States,3,0,0,3,1984
Rowdy Gaines,United States,3,0,0,3,1984
Valerie Brisco-Hooks,United States,3,0,0,3,1984
Michael Groß,West Germany,2,2,0,4,1984
Koji Gushiken,Japan,2,1,2,5,1984
Agneta Andersson,Sweden,2,1,0,3,1984
Peter Vidmar,United States,2,1,0,3,1984
Jenna Johnson,United States,2,1,0,3,1984
Chandra Cheeseborough,United States,2,1,0,3,1984
Simona Păuca,Romania,2,0,1,3,1984
Paul MacDonald,New Zealand,2,0,0,2,1984
Alan Thompson,New Zealand,2,0,0,2,1984
Joe Fargis,United States,2,0,0,2,1984
Reiner Klimke,Germany,2,0,0,2,1984
Mauro Numa,Italy,2,0,0,2,1984
Bart Conner,United States,2,0,0,2,1984
Daniele Masala,Italy,2,0,0,2,1984
Alex Baumann,Canada,2,0,0,2,1984
Theresa Andrews,United States,2,0,0,2,1984
Tiffany Cohen,United States,2,0,0,2,1984
Tracie Ruiz-Conforto,United States,2,0,0,2,1984
Mary Wayte,United States,2,0,0,2,1984
Tom Jager,United States,2,0,0,2,1984
Greg Louganis,United States,2,0,0,2,1984
Steve Lundquist,United States,2,0,0,2,1984
Evelyn Ashford,United States,2,0,0,2,1984
Alonzo Babers,United States,2,0,0,2,1984
Mary Lou Retton,United States,1,2,2,5,1984
Julianne McNamara,United States,1,2,0,3,1984
Lou Yun,People's Republic of China,1,2,0,3,1984
Victor Davis,Canada,1,2,0,3,1984
Pablo Morales,United States,1,2,0,3,1984
Mitch Gaylord,United States,1,1,2,4,1984
Shinji Morisue,Japan,1,1,1,3,1984
Anne Ottenbrite,Canada,1,1,1,3,1984
Larry Cain,Canada,1,1,0,2,1984
Ivan Patzaichin,Romania,1,1,0,2,1984
Toma Simionov,Romania,1,1,0,2,1984
Anna Olsson,Sweden,1,1,0,2,1984
Matija Ljubek,Croatia,1,1,0,2,1984
Mirko Nišović,Croatia,1,1,0,2,1984
Karen Stives,United States,1,1,0,2,1984
Conrad Homfeld,United States,1,1,0,2,1984
Steve Hegg,United States,1,1,0,2,1984
Cornelia Hanisch,West Germany,1,1,0,2,1984
Philippe Boisse,France,1,1,0,2,1984
Jean-François Lamour,France,1,1,0,2,1984
Marco Marin,Italy,1,1,0,2,1984
Viorica Ioja,Romania,1,1,0,2,1984
Betsy Mitchell,United States,1,1,0,2,1984
Susan Rapp,United States,1,1,0,2,1984
George DiCarlo,United States,1,1,0,2,1984
Dave Wilson,United States,1,1,0,2,1984
Seb Coe,Great Britain,1,1,0,2,1984
Raúl González,Mexico,1,1,0,2,1984
Doina Beșliu-Melinte,Romania,1,1,0,2,1984
Alice Brown,United States,1,1,0,2,1984
Sam Graddy,United States,1,1,0,2,1984
Hugh Fisher,Canada,1,0,1,2,1984
Alwyn Morris,Canada,1,0,1,2,1984
Stefano Cerioni,Italy,1,0,1,2,1984
Ma Yanhong,People's Republic of China,1,0,1,2,1984
Lavinia Agache,Romania,1,0,1,2,1984
Tim Daggett,United States,1,0,1,2,1984
Carlo Massullo,Italy,1,0,1,2,1984
Wu Xiaoxuan,People's Republic of China,1,0,1,2,1984
Jon Sieben,Australia,1,0,1,2,1984
Jolanda de Rover,Netherlands,1,0,1,2,1984
Maricica Puică,Romania,1,0,1,2,1984
Antonio McKay,United States,1,0,1,2,1984
Seo Hyang-Sun,Republic of Korea,1,0,0,1,1984
Darrell Pace,United States,1,0,0,1,1984
Maurizio Stecca,Italy,1,0,0,1,1984
Sin Jun-Seop,Republic of Korea,1,0,0,1,1984
Cathy Boswell,United States,1,0,0,1,1984
Denise Curry,United States,1,0,0,1,1984
Anne Donovan,United States,1,0,0,1,1984
Teresa Edwards,United States,1,0,0,1,1984
Lea Henry,United States,1,0,0,1,1984
Janice Lawrence,United States,1,0,0,1,1984
Pamela McGee,United States,1,0,0,1,1984
Carol Menken-Schaudt,United States,1,0,0,1,1984
Cheryl Miller,United States,1,0,0,1,1984
Kim Mulkey,United States,1,0,0,1,1984
Cindy Noble,United States,1,0,0,1,1984
Lynette Woodard,United States,1,0,0,1,1984
Steve Alford,United States,1,0,0,1,1984
Patrick Ewing,United States,1,0,0,1,1984
Vern Fleming,United States,1,0,0,1,1984
Michael Jordan,United States,1,0,0,1,1984
Joe Kleine,United States,1,0,0,1,1984
Jon Koncak,United States,1,0,0,1,1984
Chris Mullin,United States,1,0,0,1,1984
Sam Perkins,United States,1,0,0,1,1984
Alvin Robertson,United States,1,0,0,1,1984
Wayman Tisdale,United States,1,0,0,1,1984
Jeff Turner,United States,1,0,0,1,1984
Leon Wood,United States,1,0,0,1,1984
Tyrell Biggs,United States,1,0,0,1,1984
Mark Breland,United States,1,0,0,1,1984
"Paul Gonzales, Jr.",United States,1,0,0,1,1984
Steve McCrory,United States,1,0,0,1,1984
Jerry Page,United States,1,0,0,1,1984
Frank Tate,United States,1,0,0,1,1984
Meldrick Taylor,United States,1,0,0,1,1984
Henry Tillman,United States,1,0,0,1,1984
Pernell Whitaker,United States,1,0,0,1,1984
Ante Josipović,Yugoslavia,1,0,0,1,1984
Ulli Eicke,West Germany,1,0,0,1,1984
Grant Bramwell,New Zealand,1,0,0,1,1984
Tecla Marinescu-Borcănea,Romania,1,0,0,1,1984
Nastasia Nichitov-Ionescu,Romania,1,0,0,1,1984
Agafia Orlov-Buhaev-Constantin,Romania,1,0,0,1,1984
Maria Ștefan-Mihoreanu,Romania,1,0,0,1,1984
Leslie Burr-Howard,United States,1,0,0,1,1984
Melanie Smith,United States,1,0,0,1,1984
Bruce Davidson,United States,1,0,0,1,1984
Torrance Watkins Fleischmann,United States,1,0,0,1,1984
Herbert Krug,West Germany,1,0,0,1,1984
J. Michael Plumb,United States,1,0,0,1,1984
Uwe Sauer,West Germany,1,0,0,1,1984
Mark Todd,New Zealand,1,0,0,1,1984
Marcello Bartalini,Italy,1,0,0,1,1984
Marco Giovannetti,Italy,1,0,0,1,1984
Mark Gorski,United States,1,0,0,1,1984
Michael Grenda,Australia,1,0,0,1,1984
Alexi Grewal,United States,1,0,0,1,1984
Roger Ilegems,Belgium,1,0,0,1,1984
Kevin Nichols,Australia,1,0,0,1,1984
Eros Poli,Italy,1,0,0,1,1984
Fredy Schmidtke,West Germany,1,0,0,1,1984
Michael Turtur,Australia,1,0,0,1,1984
Claudio Vandelli,Italy,1,0,0,1,1984
Dean Woods,Australia,1,0,0,1,1984
Carina Benninga,Netherlands,1,0,0,1,1984
Fieke Boekhorst,Netherlands,1,0,0,1,1984
Marjolein Bolhuis-Eijsvogel,Netherlands,1,0,0,1,1984
Det de Beus,Netherlands,1,0,0,1,1984
Irene Hendriks,Netherlands,1,0,0,1,1984
Elsemieke Hillen,Netherlands,1,0,0,1,1984
Sandra Le Poole,Netherlands,1,0,0,1,1984
Anneloes Nieuwenhuizen,Netherlands,1,0,0,1,1984
Martine Ohr,Netherlands,1,0,0,1,1984
Alette Pos,Netherlands,1,0,0,1,1984
Lisette Sevens,Netherlands,1,0,0,1,1984
Marieke van Doorn,Netherlands,1,0,0,1,1984
Aletta van Manen,Netherlands,1,0,0,1,1984
Sophie von Weiler,Netherlands,1,0,0,1,1984
Laurien Willemse,Netherlands,1,0,0,1,1984
Margriet Zegers,Netherlands,1,0,0,1,1984
Abdul Rashid Al-Hasan,Pakistan,1,0,0,1,1984
Ayaz Mahmood,Pakistan,1,0,0,1,1984
Tauqir Dar,Pakistan,1,0,0,1,1984
Syed Ghulam Moinuddin,Pakistan,1,0,0,1,1984
Hanif Khan,Pakistan,1,0,0,1,1984
Hassan Sardar,Pakistan,1,0,0,1,1984
Ishtiaq Ahmed,Pakistan,1,0,0,1,1984
Kalimullah,Pakistan,1,0,0,1,1984
Khalid Hamid,Pakistan,1,0,0,1,1984
Shahid Ali Khan,Pakistan,1,0,0,1,1984
Manzoor Hussain,Pakistan,1,0,0,1,1984
Mushtaq Ahmed,Pakistan,1,0,0,1,1984
Naeem Akhtar,Pakistan,1,0,0,1,1984
Nasir Ali,Pakistan,1,0,0,1,1984
Qasim Zia,Pakistan,1,0,0,1,1984
Salim Sherwani,Pakistan,1,0,0,1,1984
Jujie Luan,Canada,1,0,0,1,1984
Sabine Bischoff,West Germany,1,0,0,1,1984
Zita Funkenhauser,Germany,1,0,0,1,1984
Ute Kircheis-Wessel,West Germany,1,0,0,1,1984
Christiane Weber,West Germany,1,0,0,1,1984
Elmar Borrmann,Germany,1,0,0,1,1984
Volker Fischer,West Germany,1,0,0,1,1984
Gerhard Heer,West Germany,1,0,0,1,1984
Rafael Nickel,West Germany,1,0,0,1,1984
Alexander Pusch,West Germany,1,0,0,1,1984
Angelo Arcidiacono,Italy,1,0,0,1,1984
Andrea Borella,Italy,1,0,0,1,1984
Andrea Cipressa,Italy,1,0,0,1,1984
Gianfranco Dalla Barba,Italy,1,0,0,1,1984
Ferdinando Meglio,Italy,1,0,0,1,1984
Giovanni Scalzo,Italy,1,0,0,1,1984
Angelo Scuri,Italy,1,0,0,1,1984
William Ayache,France,1,0,0,1,1984
Michel Bibard,France,1,0,0,1,1984
Dominique Bijotat,France,1,0,0,1,1984
François Brisson,France,1,0,0,1,1984
Patrick Cubaynes,France,1,0,0,1,1984
Patrice Garande,France,1,0,0,1,1984
Philippe Jeannol,France,1,0,0,1,1984
Guy Lacombe,France,1,0,0,1,1984
Jean-Claude Lemoult,France,1,0,0,1,1984
Jean-Philippe Rohr,France,1,0,0,1,1984
Albert Rust,France,1,0,0,1,1984
Didier Sénac,France,1,0,0,1,1984
Jean-Christophe Thouvenel,France,1,0,0,1,1984
José Touré,France,1,0,0,1,1984
Daniel Xuereb,France,1,0,0,1,1984
Jean-Louis Zanon,France,1,0,0,1,1984
Lori Fung,Canada,1,0,0,1,1984
Laura Cutina,Romania,1,0,0,1,1984
Cristina Elena Grigoraș,Romania,1,0,0,1,1984
Mihaela Stănuleț,Romania,1,0,0,1,1984
Jim Hartung,United States,1,0,0,1,1984
Scott Johnson,United States,1,0,0,1,1984
Slavica Djukić,Austria,1,0,0,1,1984
Jasna Kolar-Merdan,Austria,1,0,0,1,1984
Svetlana Anastasovski-Obućina,Serbia,1,0,0,1,1984
Alenka Cuderman,Slovenia,1,0,0,1,1984
Dragica Đurić,Serbia,1,0,0,1,1984
Mirjana Đurica,Serbia,1,0,0,1,1984
Emilija Erčić,Serbia,1,0,0,1,1984
Ljubinka Janković,Serbia,1,0,0,1,1984
Svetlana Dašić-Kitić,Yugoslavia,1,0,0,1,1984
Ljiljana Mugoša,Montenegro,1,0,0,1,1984
Svetlana Mugoša-Antić,Austria,1,0,0,1,1984
Mirjana Ognjenović,Croatia,1,0,0,1,1984
Zorica Pavićević,Montenegro,1,0,0,1,1984
Jasna Ptujec,Croatia,1,0,0,1,1984
Biserka Višnjić,Croatia,1,0,0,1,1984
Zlatan Arnautović,Bosnia and Herzegovina,1,0,0,1,1984
Mirko Bašić,Croatia,1,0,0,1,1984
Jovan Elezović,Serbia,1,0,0,1,1984
Mile Isaković,Serbia,1,0,0,1,1984
Pavao Jurina,Croatia,1,0,0,1,1984
Milan Kalina,Serbia,1,0,0,1,1984
Slobodan Kuzmanovski,Serbia,1,0,0,1,1984
Dragan Mladenović,Serbia,1,0,0,1,1984
Zdravko Rađenović,Bosnia and Herzegovina,1,0,0,1,1984
Momir Rnić,Serbia,1,0,0,1,1984
Branko Štrbac,Serbia,1,0,0,1,1984
Veselin Vujović,Montenegro,1,0,0,1,1984
Veselin Vuković,Serbia,1,0,0,1,1984
Zdravko Zovko,Croatia,1,0,0,1,1984
An Byeong-Geun,Republic of Korea,1,0,0,1,1984
Ha Hyeong-Ju,Republic of Korea,1,0,0,1,1984
Shinji Hosokawa,Japan,1,0,0,1,1984
Yoshiyuki Matsuoka,Japan,1,0,0,1,1984
Hitoshi Saito,Japan,1,0,0,1,1984
Peter Seisenbacher,Austria,1,0,0,1,1984
Frank Wieneke,West Germany,1,0,0,1,1984
Yasuhiro Yamashita,Japan,1,0,0,1,1984
Pierpaolo Cristofori,Italy,1,0,0,1,1984
Dean Crawford,Canada,1,0,0,1,1984
Mark Evans,Canada,1,0,0,1,1984
Mike Evans,Canada,1,0,0,1,1984
Blair Horn,Canada,1,0,0,1,1984
Grant Main,Canada,1,0,0,1,1984
Brian McMahon,Canada,1,0,0,1,1984
Kevin Neufeld,Canada,1,0,0,1,1984
Paul Steele,Canada,1,0,0,1,1984
Pat Turner,Canada,1,0,0,1,1984
Pertti Karppinen,Finland,1,0,0,1,1984
Richard Budgett,Great Britain,1,0,0,1,1984
Martin Cross,Great Britain,1,0,0,1,1984
Adrian Ellison,Great Britain,1,0,0,1,1984
Andy Holmes,Great Britain,1,0,0,1,1984
Steven Redgrave,Great Britain,1,0,0,1,1984
Raimund Hörmann,West Germany,1,0,0,1,1984
Michael Dürsch,West Germany,1,0,0,1,1984
Albert Hedderich,West Germany,1,0,0,1,1984
Dieter Wiedenmann,West Germany,1,0,0,1,1984
Carmine Abbagnale,Italy,1,0,0,1,1984
Giuseppe Abbagnale,Italy,1,0,0,1,1984
Giuseppe Di Capua,Italy,1,0,0,1,1984
Shane O'Brien,New Zealand,1,0,0,1,1984
Les O'Connell,New Zealand,1,0,0,1,1984
Conrad Robertson,New Zealand,1,0,0,1,1984
Keith Trask,New Zealand,1,0,0,1,1984
Chira Apostol,Romania,1,0,0,1,1984
Ioana Badea,Romania,1,0,0,1,1984
Sofia Corban-Banovici,Romania,1,0,0,1,1984
Olga Homeghi-Bularda,Romania,1,0,0,1,1984
Ecaterina Oancia,Romania,1,0,0,1,1984
Elisabeta Oleniuc-Lipă,Romania,1,0,0,1,1984
Elena Horvat,Romania,1,0,0,1,1984
Marioara Popescu-Ciobanu,Romania,1,0,0,1,1984
Rodica Arba-Pușcatu,Romania,1,0,0,1,1984
Valeria Roșca-Răcilă,Romania,1,0,0,1,1984
Anișoara Sorohan-Minea,Romania,1,0,0,1,1984
Maria Tănasă-Fricioiu,Romania,1,0,0,1,1984
Petru Iosub,Romania,1,0,0,1,1984
Maricia Țăran,Romania,1,0,0,1,1984
Valer Toma,Romania,1,0,0,1,1984
Betsy Beard,United States,1,0,0,1,1984
Carol Bower,United States,1,0,0,1,1984
Jeanne Flanagan,United States,1,0,0,1,1984
Carie Graves,United States,1,0,0,1,1984
Kathy Keeler,United States,1,0,0,1,1984
Holly Metcalf,United States,1,0,0,1,1984
Kristine Norelius,United States,1,0,0,1,1984
Shyril O'Steen,United States,1,0,0,1,1984
Kristen Thorsness,United States,1,0,0,1,1984
Paul Enquist,United States,1,0,0,1,1984
Bradley Lewis,United States,1,0,0,1,1984
Linda Thom,Canada,1,0,0,1,1984
Li Yuwei,People's Republic of China,1,0,0,1,1984
Xu Haifeng,People's Republic of China,1,0,0,1,1984
Philippe Hébérle,France,1,0,0,1,1984
Malcolm Cooper,Great Britain,1,0,0,1,1984
Luciano Giovannetti,Italy,1,0,0,1,1984
Takeo Kamachi,Japan,1,0,0,1,1984
Pat Spurgin,United States,1,0,0,1,1984
Matt Dryke,United States,1,0,0,1,1984
Ed Etzel,United States,1,0,0,1,1984
Sylvie Bernier,Canada,1,0,0,1,1984
Zhou Jihong,People's Republic of China,1,0,0,1,1984
Petra van Staveren,Netherlands,1,0,0,1,1984
Candy Costie,United States,1,0,0,1,1984
Jill Sterkel,United States,1,0,0,1,1984
Dara Torres,United States,1,0,0,1,1984
Matt Biondi,United States,1,0,0,1,1984
Chris Cavanaugh,United States,1,0,0,1,1984
Jeff Float,United States,1,0,0,1,1984
Geoff Gaberino,United States,1,0,0,1,1984
Bruce Hayes,United States,1,0,0,1,1984
David Larson,United States,1,0,0,1,1984
Robin Leamy,United States,1,0,0,1,1984
Mike O'Brien,United States,1,0,0,1,1984
Rich Saeger,United States,1,0,0,1,1984
Rich Schroeder,United States,1,0,0,1,1984
Hou Yuzhu,People's Republic of China,1,0,0,1,1984
Jiang Ying,People's Republic of China,1,0,0,1,1984
Lang Ping,People's Republic of China,1,0,0,1,1984
Li Yanjun,People's Republic of China,1,0,0,1,1984
Liang Yan,People's Republic of China,1,0,0,1,1984
Yang Xiaojun,People's Republic of China,1,0,0,1,1984
Yang Xilan,People's Republic of China,1,0,0,1,1984
Zhang Rongfang,People's Republic of China,1,0,0,1,1984
Zheng Meizhu,People's Republic of China,1,0,0,1,1984
Zhu Ling,People's Republic of China,1,0,0,1,1984
Aldis Berzins,United States,1,0,0,1,1984
Craig Buck,United States,1,0,0,1,1984
Rich Duwelius,United States,1,0,0,1,1984
Dusty Dvorak,United States,1,0,0,1,1984
Karch Kiraly,United States,1,0,0,1,1984
Chris Marlowe,United States,1,0,0,1,1984
Pat Powers,United States,1,0,0,1,1984
Steve Salmons,United States,1,0,0,1,1984
Dave Saunders,United States,1,0,0,1,1984
Paul Sunderland,United States,1,0,0,1,1984
Steve Timmons,United States,1,0,0,1,1984
Marc Waldie,United States,1,0,0,1,1984
Perica Bukić,Croatia,1,0,0,1,1984
Dragan Andrić,Greece,1,0,0,1,1984
Milivoj Bebić,Croatia,1,0,0,1,1984
Veselin Đuho,Croatia,1,0,0,1,1984
Milorad Krivokapić,Montenegro,1,0,0,1,1984
Deni Lušić,Croatia,1,0,0,1,1984
Igor Milanović,Serbia,1,0,0,1,1984
Tomislav Paškvalin,Croatia,1,0,0,1,1984
Zoran Petrović,Serbia,1,0,0,1,1984
Zoran Roje,Croatia,1,0,0,1,1984
Goran Sukno,Croatia,1,0,0,1,1984
Božo Vuletić,Croatia,1,0,0,1,1984
Dean Lukin,Australia,1,0,0,1,1984
Chen Weiqiang,People's Republic of China,1,0,0,1,1984
Wu Shude,People's Republic of China,1,0,0,1,1984
Yao Jingyuan,People's Republic of China,1,0,0,1,1984
Zeng Guoqiang,People's Republic of China,1,0,0,1,1984
Rolf Milser,West Germany,1,0,0,1,1984
Karl-Heinz Radschinsky,West Germany,1,0,0,1,1984
Norberto Oberburger,Italy,1,0,0,1,1984
Petre Becheru,Romania,1,0,0,1,1984
Nicu Vlad,Romania,1,0,0,1,1984
Jouko Salomäki,Finland,1,0,0,1,1984
Pasquale Passarelli,West Germany,1,0,0,1,1984
Vincenzo Maenza,Italy,1,0,0,1,1984
Atsuji Miyahara,Japan,1,0,0,1,1984
Hideaki Tomiyama,Japan,1,0,0,1,1984
Kim Won-Gi,Republic of Korea,1,0,0,1,1984
Yu In-Tak,Republic of Korea,1,0,0,1,1984
Šaban Trstena,North Macedonia,1,0,0,1,1984
Vasile Andrei,Romania,1,0,0,1,1984
Ion Draica,Romania,1,0,0,1,1984
Ed Banach,United States,1,0,0,1,1984
Lou Banach,United States,1,0,0,1,1984
Bruce Baumgartner,United States,1,0,0,1,1984
Jeff Blatnick,United States,1,0,0,1,1984
Steve Fraser,United States,1,0,0,1,1984
Randy Lewis,United States,1,0,0,1,1984
Dave Schultz,United States,1,0,0,1,1984
Mark Schultz,United States,1,0,0,1,1984
Bobby Weaver,United States,1,0,0,1,1984
Vlado Lisjak,Croatia,1,0,0,1,1984
William Carl Buchan,United States,1,0,0,1,1984
William Earl Buchan,United States,1,0,0,1,1984
Russell Coutts,New Zealand,1,0,0,1,1984
Rod Davis,New Zealand,1,0,0,1,1984
Luis Doreste,Spain,1,0,0,1,1984
Steve Erickson,United States,1,0,0,1,1984
Robbie Haines,United States,1,0,0,1,1984
Jonathan McKee,United States,1,0,0,1,1984
Roberto Molina,Spain,1,0,0,1,1984
Rex Sellers,New Zealand,1,0,0,1,1984
Chris Timms,New Zealand,1,0,0,1,1984
Ed Trevelyan,United States,1,0,0,1,1984
Stephan van den Berg,Netherlands,1,0,0,1,1984
Glynis Nunn,Australia,1,0,0,1,1984
Joaquim Cruz,Brazil,1,0,0,1,1984
Arto Härkönen,Finland,1,0,0,1,1984
Juha Tiainen,Finland,1,0,0,1,1984
Pierre Quinon,France,1,0,0,1,1984
Tessa Sanderson,Great Britain,1,0,0,1,1984
Daley Thompson,Great Britain,1,0,0,1,1984
Claudia Losch,West Germany,1,0,0,1,1984
Ulrike Meyfarth,West Germany,1,0,0,1,1984
Rolf Danneberg,West Germany,1,0,0,1,1984
Dietmar Mögenburg,Germany,1,0,0,1,1984
Gabriella Dorio,Italy,1,0,0,1,1984
Alessandro Andrei,Italy,1,0,0,1,1984
Alberto Cova,Italy,1,0,0,1,1984
Julius Korir,Kenya,1,0,0,1,1984
Nawal El-Moutawakel,Morocco,1,0,0,1,1984
Saïd Aouita,Morocco,1,0,0,1,1984
Ernesto Canto,Mexico,1,0,0,1,1984
Ria Stalman,Netherlands,1,0,0,1,1984
Carlos Lopes,Portugal,1,0,0,1,1984
Anișoara Stanciu-Cușmir,Romania,1,0,0,1,1984
Joan Benoit,United States,1,0,0,1,1984
Jeanette Bolden,United States,1,0,0,1,1984
Diane Dixon,United States,1,0,0,1,1984
Benita Fitzgerald-Brown,United States,1,0,0,1,1984
Sherri Howard,United States,1,0,0,1,1984
Denean Howard-Hill,United States,1,0,0,1,1984
Lillie Leatherwood,United States,1,0,0,1,1984
Ray Armstead,United States,1,0,0,1,1984
Ron Brown,United States,1,0,0,1,1984
Al Joyner,United States,1,0,0,1,1984
Roger Kingdom,United States,1,0,0,1,1984
Walter McCoy,United States,1,0,0,1,1984
Edwin Moses,United States,1,0,0,1,1984
Sunder Nix,United States,1,0,0,1,1984
Calvin Smith,United States,1,0,0,1,1984
Willie Smith,United States,1,0,0,1,1984
Connie Carpenter-Phinney,United States,1,0,0,1,1984
Florica Lavric,Romania,1,0,0,1,1984
Andrija Popović,Montenegro,1,0,0,1,1984
Lars-Erik Moberg,Sweden,0,3,0,3,1984
Mark Stockwell,Australia,0,2,1,3,1984
Per-Inge Bengtsson,Sweden,0,2,0,2,1984
Matthias Behr,West Germany,0,2,0,2,1984
Tong Fei,People's Republic of China,0,2,0,2,1984
Marita Payne Wiggins,Canada,0,2,0,2,1984
Karin Seick,West Germany,0,1,2,3,1984
Annemarie Verstappen,Netherlands,0,1,2,3,1984
Alexandra Barré,Canada,0,1,1,2,1984
Henning Lynge Jakobsen,Denmark,0,1,1,2,1984
Bernard Brégeon,France,0,1,1,2,1984
Barbara Lewe-Pohlmann-Schüttpelz,West Germany,0,1,1,2,1984
Virginia Holgate-Leng,Great Britain,0,1,1,2,1984
Otto Hofer,Switzerland,0,1,1,2,1984
Rolf Gölz,West Germany,0,1,1,2,1984
Leonard Harvey Nitz,United States,0,1,1,2,1984
Philippe Riboud,France,0,1,1,2,1984
Kathy Johnson,United States,0,1,1,2,1984
Nobuyuki Kajitani,Japan,0,1,1,2,1984
Greet Hellemans,Netherlands,0,1,1,2,1984
Nicolette Hellemans,Netherlands,0,1,1,2,1984
Neil Brooks,Australia,0,1,1,2,1984
Mike West,Canada,0,1,1,2,1984
Sarah Hardcastle,Great Britain,0,1,1,2,1984
Ina Beyermann,West Germany,0,1,1,2,1984
Thomas Fahrner,West Germany,0,1,1,2,1984
Sue Holloway,Canada,0,1,1,2,1984
Li Lingjuan,People's Republic of China,0,1,0,1,1984
Willie deWit,Canada,0,1,0,1,1984
Shawn O'Sullivan,Canada,0,1,0,1,1984
Rick McKinney,United States,0,1,0,1,1984
Francesco Damiani,Italy,0,1,0,1,1984
Salvatore Todisco,Italy,0,1,0,1,1984
An Yeong-Su,Republic of Korea,0,1,0,1,1984
Héctor López,Mexico,0,1,0,1,1984
Peter Konyegwachie,Nigeria,0,1,0,1,1984
Kevin Barry,New Zealand,0,1,0,1,1984
Choi Ae-Yeong,Republic of Korea,0,1,0,1,1984
Choi Gyeong-Hui,Republic of Korea,0,1,0,1,1984
Jeong Myeong-Hui,Republic of Korea,0,1,0,1,1984
Kim Eun-Suk,Republic of Korea,0,1,0,1,1984
Kim Hwa-Sun,Republic of Korea,0,1,0,1,1984
Kim Yeong-Hui,Republic of Korea,0,1,0,1,1984
Lee Hyeong-Suk,Republic of Korea,0,1,0,1,1984
Lee Mi-Ja,Republic of Korea,0,1,0,1,1984
Mun Gyeong-Ja,Republic of Korea,0,1,0,1,1984
Park Chan-Suk,Republic of Korea,0,1,0,1,1984
Seong Jeong-A,Republic of Korea,0,1,0,1,1984
Fernando Arcega,Spain,0,1,0,1,1984
José Manuel Beirán,Spain,0,1,0,1,1984
Juan Antonio Corbalán,Spain,0,1,0,1,1984
Juan de la Cruz,Spain,0,1,0,1,1984
Andrés Jiménez,Spain,0,1,0,1,1984
José Luis Llorente,Spain,0,1,0,1,1984
Juan Manuel López,Spain,0,1,0,1,1984
José María Margall,Spain,0,1,0,1,1984
Fernando Martín,Spain,0,1,0,1,1984
Fernando Romay,Spain,0,1,0,1,1984
Epi,Spain,0,1,0,1,1984
Ignacio Solozábal,Spain,0,1,0,1,1984
Luis Ortiz,Puerto Rico,0,1,0,1,1984
Thawee Umponmaha,Thailand,0,1,0,1,1984
Virgil Hill,United States,0,1,0,1,1984
Redžep Redžepovski,North Macedonia,0,1,0,1,1984
Patrick Lefoulon,France,0,1,0,1,1984
Susanne Wiberg-Gunnarsson,Sweden,0,1,0,1,1984
Eva Karlsson,Sweden,0,1,0,1,1984
Tommy Karls,Sweden,0,1,0,1,1984
Thomas Ohlsson,Sweden,0,1,0,1,1984
Milan Janić,Croatia,0,1,0,1,1984
Diana Clapham,Great Britain,0,1,0,1,1984
Amy-Cathérine de Bary,Switzerland,0,1,0,1,1984
Anne Grethe Jensen-Törnblad,Denmark,0,1,0,1,1984
Lucinda Prior-Palmer-Green,Great Britain,0,1,0,1,1984
Christine Stückelberger,Switzerland,0,1,0,1,1984
Tim Grubb,Great Britain,0,1,0,1,1984
Steven Smith,Great Britain,0,1,0,1,1984
Ian Stark,Great Britain,0,1,0,1,1984
John Whitaker,Great Britain,0,1,0,1,1984
Michael Whitaker,Great Britain,0,1,0,1,1984
Rebecca Twigg,United States,0,1,0,1,1984
Alfred Achermann,Switzerland,0,1,0,1,1984
Steve Bauer,Canada,0,1,0,1,1984
Brent Emery,United States,0,1,0,1,1984
Dave Grylls,United States,0,1,0,1,1984
Curt Harnett,Canada,0,1,0,1,1984
Pat McDonough,United States,0,1,0,1,1984
Uwe Messerschmidt,West Germany,0,1,0,1,1984
Richard Trinkler,Switzerland,0,1,0,1,1984
Nelson Vails,United States,0,1,0,1,1984
Laurent Vial,Switzerland,0,1,0,1,1984
Benno Wiss,Switzerland,0,1,0,1,1984
Gaby Appel,West Germany,0,1,0,1,1984
Dagmar Breiken-Bremer,West Germany,0,1,0,1,1984
Beate Deininger,West Germany,0,1,0,1,1984
Elke Drüll,West Germany,0,1,0,1,1984
Birgit Hagen,West Germany,0,1,0,1,1984
Birgit Hahn,West Germany,0,1,0,1,1984
Martina Koch-Hallmen,West Germany,0,1,0,1,1984
Sigrid Landgraf,West Germany,0,1,0,1,1984
Corinna Lingnau,West Germany,0,1,0,1,1984
Christina Moser,West Germany,0,1,0,1,1984
Patricia Ott,West Germany,0,1,0,1,1984
Hella Roth,West Germany,0,1,0,1,1984
Gaby Schley-Schöwe,West Germany,0,1,0,1,1984
Susi Schmid,West Germany,0,1,0,1,1984
Ulla Thielemann,West Germany,0,1,0,1,1984
Andrea Weiermann-Lietz,West Germany,0,1,0,1,1984
Christian Bassemir,West Germany,0,1,0,1,1984
Stefan Blöcher,West Germany,0,1,0,1,1984
Dirk Brinkmann,West Germany,0,1,0,1,1984
Heiner Dopp,West Germany,0,1,0,1,1984
Carsten Fischer,Germany,0,1,0,1,1984
Tobias Frank,West Germany,0,1,0,1,1984
Volker Fried,Germany,0,1,0,1,1984
Thomas Gunst,West Germany,0,1,0,1,1984
Karl-Joachim Hürter,West Germany,0,1,0,1,1984
Uli Hänel,West Germany,0,1,0,1,1984
Andreas Keller,Germany,0,1,0,1,1984
Felix Krull,West Germany,0,1,0,1,1984
Michael Peter,West Germany,0,1,0,1,1984
Thomas Reck,West Germany,0,1,0,1,1984
Ekkhard Schmidt-Opper,West Germany,0,1,0,1,1984
Markku Slawyk,West Germany,0,1,0,1,1984
Monika Weber-Koszto,Germany,0,1,0,1,1984
Aurora Dan,Romania,0,1,0,1,1984
Elisabeta Guzganu-Tufan,Romania,0,1,0,1,1984
Marcela Moldovan-Zsak,Romania,0,1,0,1,1984
Rozalia Oros,Romania,0,1,0,1,1984
Philippe Delrieu,France,0,1,0,1,1984
Franck Ducheix,France,0,1,0,1,1984
Hervé Granger-Veyron,France,0,1,0,1,1984
Pierre Guichot,France,0,1,0,1,1984
Jean-Michel Henry,France,0,1,0,1,1984
Olivier Lenglet,France,0,1,0,1,1984
Michel Salesse,France,0,1,0,1,1984
Frank Beck,West Germany,0,1,0,1,1984
Matthias Gey,West Germany,0,1,0,1,1984
Harald Hein,West Germany,0,1,0,1,1984
Klaus Reichert,West Germany,0,1,0,1,1984
Björne Väggö,Sweden,0,1,0,1,1984
Pinga,Brazil,0,1,0,1,1984
Davi,Brazil,0,1,0,1,1984
Mílton da Cruz,Brazil,0,1,0,1,1984
André Luís,Brazil,0,1,0,1,1984
Mauro Galvão,Brazil,0,1,0,1,1984
Tonho Gil,Brazil,0,1,0,1,1984
Kita,Brazil,0,1,0,1,1984
Silvinho,Brazil,0,1,0,1,1984
Gilmar,Brazil,0,1,0,1,1984
Ademir,Brazil,0,1,0,1,1984
Paulo Santos,Brazil,0,1,0,1,1984
Ronaldo,Brazil,0,1,0,1,1984
Dunga,Brazil,0,1,0,1,1984
Chicão,Brazil,0,1,0,1,1984
Luís Carlos Winck,Brazil,0,1,0,1,1984
Doina Stăiculescu,Romania,0,1,0,1,1984
Pam Bileck,United States,0,1,0,1,1984
Michelle Dusserre,United States,0,1,0,1,1984
Tracee Talavera,United States,0,1,0,1,1984
Li Xiaoping,People's Republic of China,0,1,0,1,1984
Li Yuejiu,People's Republic of China,0,1,0,1,1984
Xu Zhiqiang,People's Republic of China,0,1,0,1,1984
Jochen Fraatz,Germany,0,1,0,1,1984
Thomas Happe,West Germany,0,1,0,1,1984
Arnulf Meffle,West Germany,0,1,0,1,1984
Rüdiger Neitzel,West Germany,0,1,0,1,1984
Michael Paul,West Germany,0,1,0,1,1984
Dirk Rauin,West Germany,0,1,0,1,1984
Siegfried Roch,West Germany,0,1,0,1,1984
Michael Roth,West Germany,0,1,0,1,1984
Ulrich Roth,West Germany,0,1,0,1,1984
Martin Schwalb,Germany,0,1,0,1,1984
Uwe Schwenker,West Germany,0,1,0,1,1984
Thomas Springel,West Germany,0,1,0,1,1984
Andreas Thiel,Germany,0,1,0,1,1984
Sepp Wunderlich,West Germany,0,1,0,1,1984
Klaus Wöller,West Germany,0,1,0,1,1984
Han Hwa-Su,Republic of Korea,0,1,0,1,1984
Jeong Hoe-Sun,Republic of Korea,0,1,0,1,1984
Jeong Sun-Bok,Republic of Korea,0,1,0,1,1984
Kim Chun-Rye,Republic of Korea,0,1,0,1,1984
Kim Gyeong-Sun,Republic of Korea,0,1,0,1,1984
Kim Mi-Suk,Republic of Korea,0,1,0,1,1984
Kim Ok-Hwa,Republic of Korea,0,1,0,1,1984
Lee Sun-I,Republic of Korea,0,1,0,1,1984
Lee Yeong-Ja,Republic of Korea,0,1,0,1,1984
Son Mi-Na,Republic of Korea,0,1,0,1,1984
Seong Gyeong-Hwa,Republic of Korea,0,1,0,1,1984
Yun Byeong-Sun,Republic of Korea,0,1,0,1,1984
Yun Su-Gyeong,Republic of Korea,0,1,0,1,1984
Neil Adams,Great Britain,0,1,0,1,1984
Bob Berland,United States,0,1,0,1,1984
Ezio Gamba,Italy,0,1,0,1,1984
Hwang Jeong-Oh,Republic of Korea,0,1,0,1,1984
Kim Jae-Yeop,Republic of Korea,0,1,0,1,1984
Angelo Parisi,France,0,1,0,1,1984
Mohamed Ali Rashwan,Egypt,0,1,0,1,1984
Douglas Vieira,Brazil,0,1,0,1,1984
Svante Rasmuson,Sweden,0,1,0,1,1984
Dean Glenesk,United States,0,1,0,1,1984
Greg Losey,United States,0,1,0,1,1984
Mike Storm,United States,0,1,0,1,1984
Gary Gullock,Australia,0,1,0,1,1984
Tony Lovrich,Australia,0,1,0,1,1984
Tim McLaren,Australia,0,1,0,1,1984
Paul Reedy,Australia,0,1,0,1,1984
Dirk Crois,Belgium,0,1,0,1,1984
Pierre-Marie Deloof,Belgium,0,1,0,1,1984
Barbara Armbrust,Canada,0,1,0,1,1984
Marilyn Brain,Canada,0,1,0,1,1984
Betty Craig,Canada,0,1,0,1,1984
Angela Schneider,Canada,0,1,0,1,1984
Tricia Smith,Canada,0,1,0,1,1984
Lesley Thompson-Willie,Canada,0,1,0,1,1984
Jane Tregunno,Canada,0,1,0,1,1984
Fernando Climent,Spain,0,1,0,1,1984
Luis Lasúrtegui,Spain,0,1,0,1,1984
Peter-Michael Kolbe,West Germany,0,1,0,1,1984
Mihaela Armășescu,Romania,0,1,0,1,1984
Doina Liliana Snep-Bălan,Romania,0,1,0,1,1984
Adriana Chelariu-Bazon,Romania,0,1,0,1,1984
Camelia Diaconescu,Romania,0,1,0,1,1984
Aneta Mihaly,Romania,0,1,0,1,1984
Aurora Pleșca,Romania,0,1,0,1,1984
Lucia Sauca,Romania,0,1,0,1,1984
Mărioara Trașcă,Romania,0,1,0,1,1984
Dimitrie Popescu,Romania,0,1,0,1,1984
Dumitru Răducanu,Romania,0,1,0,1,1984
Vasile Tomoiagă,Romania,0,1,0,1,1984
Carlie Geer,United States,0,1,0,1,1984
Ginny Gilder,United States,0,1,0,1,1984
Joan Lind,United States,0,1,0,1,1984
Anne Marden,United States,0,1,0,1,1984
Kelly Rickon,United States,0,1,0,1,1984
Lisa Rohde,United States,0,1,0,1,1984
Michael Bach,United States,0,1,0,1,1984
Fred Borchelt,United States,0,1,0,1,1984
"Charlie Clapp, III",United States,0,1,0,1,1984
David Clark,United States,0,1,0,1,1984
Tom Darling,United States,0,1,0,1,1984
Alan Forney,United States,0,1,0,1,1984
Bruce Ibbetson,United States,0,1,0,1,1984
Edward Ives,United States,0,1,0,1,1984
Bob Jaugstetter,United States,0,1,0,1,1984
Tom Kiefer,United States,0,1,0,1,1984
Chip Lubsen,United States,0,1,0,1,1984
Chris Penny,United States,0,1,0,1,1984
Jon Smith,United States,0,1,0,1,1984
Gregory Springer,United States,0,1,0,1,1984
Otto Stekl,United States,0,1,0,1,1984
John Stillings,United States,0,1,0,1,1984
Andrew Sudduth,United States,0,1,0,1,1984
John Terwilliger,United States,0,1,0,1,1984
Andreas Kronthaler,Austria,0,1,0,1,1984
Helmut Bellingrodt,Colombia,0,1,0,1,1984
Ole Riber Rasmussen,Denmark,0,1,0,1,1984
Michel Bury,France,0,1,0,1,1984
Ulrike Holmer,West Germany,0,1,0,1,1984
Edith Gufler,Italy,0,1,0,1,1984
Francisco Boza,Peru,0,1,0,1,1984
Corneliu Ion,Romania,0,1,0,1,1984
Daniel Nipkow,Switzerland,0,1,0,1,1984
Ragnar Skanåker,Sweden,0,1,0,1,1984
Ruby Fox,United States,0,1,0,1,1984
Suzie Landells,Australia,0,1,0,1,1984
Karen Phillips,Australia,0,1,0,1,1984
Glenn Beringen,Australia,0,1,0,1,1984
Michael Delany,Australia,0,1,0,1,1984
Greg Fasala,Australia,0,1,0,1,1984
Ricardo Prado,Brazil,0,1,0,1,1984
Sharon Hambrook,Canada,0,1,0,1,1984
Kelly Kryczka,Canada,0,1,0,1,1984
Carolyn Waldo,Canada,0,1,0,1,1984
Sandy Goss,Canada,0,1,0,1,1984
Tom Ponting,Canada,0,1,0,1,1984
Tan Liangde,People's Republic of China,0,1,0,1,1984
Frédéric Delcourt,France,0,1,0,1,1984
Ute Hasse,West Germany,0,1,0,1,1984
Svenja Schlicht,West Germany,0,1,0,1,1984
Rainer Henkel,West Germany,0,1,0,1,1984
Dirk Korthals,West Germany,0,1,0,1,1984
Alexander Schowtka,West Germany,0,1,0,1,1984
Desi Reijers,Netherlands,0,1,0,1,1984
Conny van Bentum,Netherlands,0,1,0,1,1984
Wilma van Velsen,Netherlands,0,1,0,1,1984
Elles Voskes,Netherlands,0,1,0,1,1984
Kelly McCormick,United States,0,1,0,1,1984
Michele Mitchell,United States,0,1,0,1,1984
Michelle Richardson,United States,0,1,0,1,1984
Amy White,United States,0,1,0,1,1984
Sippy Woodhead,United States,0,1,0,1,1984
Bruce Kimball,United States,0,1,0,1,1984
John Mykkanen,United States,0,1,0,1,1984
Tim Shaw,United States,0,1,0,1,1984
Rui,Brazil,0,1,0,1,1984
William,Brazil,0,1,0,1,1984
Renan,Brazil,0,1,0,1,1984
Fernandão,Brazil,0,1,0,1,1984
Marcus Vinícius,Brazil,0,1,0,1,1984
Domingos Maracanã,Brazil,0,1,0,1,1984
Montanaro,Brazil,0,1,0,1,1984
Bernard,Brazil,0,1,0,1,1984
Amauri,Brazil,0,1,0,1,1984
Badalhoca,Brazil,0,1,0,1,1984
Bernardinho,Brazil,0,1,0,1,1984
Jeanne Beauprey,United States,0,1,0,1,1984
Carolyn Becker,United States,0,1,0,1,1984
Linda Chisholm,United States,0,1,0,1,1984
Rita Crockett,United States,0,1,0,1,1984
Laurie Flachmeier,United States,0,1,0,1,1984
Debbie Green,United States,0,1,0,1,1984
Flo Hyman,United States,0,1,0,1,1984
Rose Magers,United States,0,1,0,1,1984
Kim Ruddins,United States,0,1,0,1,1984
Julie Vollertsen,United States,0,1,0,1,1984
Paula Weishoff,United States,0,1,0,1,1984
Sue Woodstra,United States,0,1,0,1,1984
Doug Burke,United States,0,1,0,1,1984
Peter Campbell,United States,0,1,0,1,1984
Jody Campbell,United States,0,1,0,1,1984
Gary Figueroa,United States,0,1,0,1,1984
Drew McDonald,United States,0,1,0,1,1984
Kevin Robertson,United States,0,1,0,1,1984
Terry Schroeder,United States,0,1,0,1,1984
John Siman,United States,0,1,0,1,1984
Jon Svendsen,United States,0,1,0,1,1984
Joe Vargas,United States,0,1,0,1,1984
Craig Wilson,United States,0,1,0,1,1984
Robert Kabbas,Australia,0,1,0,1,1984
Jacques Demers,Canada,0,1,0,1,1984
Lai Runming,People's Republic of China,0,1,0,1,1984
Zhou Peishun,People's Republic of China,0,1,0,1,1984
Petre Dumitru,Romania,0,1,0,1,1984
Vasile Groapă,Romania,0,1,0,1,1984
Gelu Radu,Romania,0,1,0,1,1984
Andrei Socaci,Romania,0,1,0,1,1984
Ștefan Tașnadi,Romania,0,1,0,1,1984
Mario Martinez,United States,0,1,0,1,1984
Bob Molle,Canada,0,1,0,1,1984
Tapio Sipilä,Finland,0,1,0,1,1984
Martin Knosp,West Germany,0,1,0,1,1984
Markus Scherer,West Germany,0,1,0,1,1984
Dimitrios Thanopoulos,Greece,0,1,0,1,1984
Kosei Akaishi,Japan,0,1,0,1,1984
Masaki Eto,Japan,0,1,0,1,1984
Takashi Irie,Japan,0,1,0,1,1984
Hideyuki Nagashima,Japan,0,1,0,1,1984
Akira Ota,Japan,0,1,0,1,1984
Kim Jong-Gyu,Republic of Korea,0,1,0,1,1984
Daniel Aceves,Mexico,0,1,0,1,1984
Ilie Matei,Romania,0,1,0,1,1984
Kent-Olle Johansson,Sweden,0,1,0,1,1984
Roger Tallroth,Sweden,0,1,0,1,1984
Joseph Atiyeh,Syrian Arab Republic,0,1,0,1,1984
Barry Davis,United States,0,1,0,1,1984
Greg Gibson,United States,0,1,0,1,1984
Andrew Rein,United States,0,1,0,1,1984
Refik Memišević,Serbia,0,1,0,1,1984
Daniel Adler,Brazil,0,1,0,1,1984
Evert Bastet,Canada,0,1,0,1,1984
Steve Benjamin,United States,0,1,0,1,1984
John Bertrand,United States,0,1,0,1,1984
Jay Glaser,United States,0,1,0,1,1984
Torben Grael,Brazil,0,1,0,1,1984
Joachim Griese,West Germany,0,1,0,1,1984
Michael Marcour,West Germany,0,1,0,1,1984
Terry McLaughlin,Canada,0,1,0,1,1984
Ronaldo Senfft,Brazil,0,1,0,1,1984
Randy Smyth,United States,0,1,0,1,1984
Scott Steele,United States,0,1,0,1,1984
Chris Steinfeld,United States,0,1,0,1,1984
Gary Honey,Australia,0,1,0,1,1984
Angela Bailey,Canada,0,1,0,1,1984
Charmaine Crooks,Canada,0,1,0,1,1984
France Gareau,Canada,0,1,0,1,1984
Molly Killingbeck,Canada,0,1,0,1,1984
Jill Richardson-Briscoe,Canada,0,1,0,1,1984
Angella Taylor-Issajenko,Canada,0,1,0,1,1984
Dana Wright,Canada,0,1,0,1,1984
Gabriel Tiacoh,Côte d'Ivoire,0,1,0,1,1984
Tiina Lillak,Finland,0,1,0,1,1984
Joseph Mahmoud,France,0,1,0,1,1984
Wendy Sly,Great Britain,0,1,0,1,1984
Shirley Strong,Great Britain,0,1,0,1,1984
Kriss Akabusi,Great Britain,0,1,0,1,1984
Todd Bennett,Great Britain,0,1,0,1,1984
Phil Brown,Great Britain,0,1,0,1,1984
Garry Cook,Great Britain,0,1,0,1,1984
Steve Cram,Great Britain,0,1,0,1,1984
Mike McLeod,Great Britain,0,1,0,1,1984
Dave Ottley,Great Britain,0,1,0,1,1984
Jürgen Hingsen,West Germany,0,1,0,1,1984
Karl-Hans Riehm,West Germany,0,1,0,1,1984
John Treacy,Ireland,0,1,0,1,1984
Sara Simeoni,Italy,0,1,0,1,1984
Norman Edwards,Jamaica,0,1,0,1,1984
Albert Lawrence,Jamaica,0,1,0,1,1984
Greg Meghoo,Jamaica,0,1,0,1,1984
Don Quarrie,Jamaica,0,1,0,1,1984
Ray Stewart,Jamaica,0,1,0,1,1984
Grete Andersen-Waitz,Norway,0,1,0,1,1984
Valy Ionescu,Romania,0,1,0,1,1984
Mihaela Loghin,Romania,0,1,0,1,1984
Markus Ryffel,Switzerland,0,1,0,1,1984
Bo Gustafsson,Sweden,0,1,0,1,1984
Patrik Sjöberg,Sweden,0,1,0,1,1984
Judi Brown,United States,0,1,0,1,1984
Leslie Deniz,United States,0,1,0,1,1984
Kim Gallagher,United States,0,1,0,1,1984
Florence Griffith Joyner,United States,0,1,0,1,1984
Jackie Joyner-Kersee,United States,0,1,0,1,1984
Kirk Baptiste,United States,0,1,0,1,1984
Mike Carter,United States,0,1,0,1,1984
Mike Conley,United States,0,1,0,1,1984
Greg Foster,United States,0,1,0,1,1984
Danny Harris,United States,0,1,0,1,1984
Mike Tully,United States,0,1,0,1,1984
Mac Wilkins,United States,0,1,0,1,1984
Xandó,Brazil,0,1,0,1,1984
Gilmar Popoca,Brazil,0,1,0,1,1984
Chris Dorst,United States,0,1,0,1,1984
Koji Sotomura,Japan,0,0,2,2,1984
Glenn Buchanan,Australia,0,0,2,2,1984
Peter Evans,Australia,0,0,2,2,1984
Neil Cochran,Great Britain,0,0,2,2,1984
Miwako Motoyoshi,Japan,0,0,2,2,1984
Per Johansson,Sweden,0,0,2,2,1984
Ben Johnson,Canada,0,0,2,2,1984
Kathy Smallwood-Cook,Great Britain,0,0,2,2,1984
Merlene Ottey-Page,Jamaica,0,0,2,2,1984
Dale Walters,Canada,0,0,1,1,1984
Martin N'Dongo Ebanga,Cameroon,0,0,1,1,1984
Pedro Nolasco,Dominican Republic,0,0,1,1,1984
Hiroshi Yamamoto,Japan,0,0,1,1,1984
Kim Jin-Ho,Republic of Korea,0,0,1,1,1984
Joni Nyman,Finland,0,0,1,1,1984
Christophe Tiozzo,France,0,0,1,1,1984
Mustapha Moussa,Algeria,0,0,1,1,1984
Mohamed Zaoui,Algeria,0,0,1,1,1984
Bobby Wells,Great Britain,0,0,1,1,1984
Manfred Zielonka,West Germany,0,0,1,1,1984
Luciano Bruno,Italy,0,0,1,1,1984
Angelo Musone,Italy,0,0,1,1,1984
Ibrahim Bilali,Kenya,0,0,1,1,1984
Jeon Chil-Seong,Republic of Korea,0,0,1,1,1984
Arnold Vanderlijde,Netherlands,0,0,1,1,1984
Emir Mutapčić,Bosnia and Herzegovina,0,0,1,1,1984
Mihovil Nakić-Vojnović,Croatia,0,0,1,1,1984
Ba Yan,People's Republic of China,0,0,1,1,1984
Chen Yuefang,People's Republic of China,0,0,1,1,1984
Cong Xuedi,People's Republic of China,0,0,1,1,1984
Li Xiaoqin,People's Republic of China,0,0,1,1,1984
Liu Qing,People's Republic of China,0,0,1,1,1984
Qiu Chen,People's Republic of China,0,0,1,1,1984
Song Xiaobo,People's Republic of China,0,0,1,1,1984
Wang Jun,People's Republic of China,0,0,1,1,1984
Xiu Lijuan,People's Republic of China,0,0,1,1,1984
Zhang Hui,People's Republic of China,0,0,1,1,1984
Zhang Yueqin,People's Republic of China,0,0,1,1,1984
Zheng Haixia,People's Republic of China,0,0,1,1,1984
Dražen Dalipagić,Serbia,0,0,1,1,1984
Sabit Hadžić,Bosnia and Herzegovina,0,0,1,1,1984
Andro Knego,Croatia,0,0,1,1,1984
Aleksandar Petrović,Croatia,0,0,1,1,1984
Dražen Petrović,Croatia,0,0,1,1,1984
Ratko Radovanović,Serbia,0,0,1,1,1984
Ivan Sunara,Croatia,0,0,1,1,1984
Branko Vukičević,Croatia,0,0,1,1,1984
Rajko Žižić,Montenegro,0,0,1,1,1984
Nebojša Zorkić,Serbia,0,0,1,1,1984
Arístides González,Puerto Rico,0,0,1,1,1984
Mircea Fulger,Romania,0,0,1,1,1984
Turgut Aykaç,Turkey,0,0,1,1,1984
Eyüp Can,Turkey,0,0,1,1,1984
Evander Holyfield,United States,0,0,1,1,1984
Marcelino Bolívar,Venezuela,0,0,1,1,1984
Omar Catarí,Venezuela,0,0,1,1,1984
Mirko Puzović,Yugoslavia,0,0,1,1,1984
Aziz Salihu,Kosovo,0,0,1,1,1984
Keith Mwila,Zambia,0,0,1,1,1984
Barry Kelly,Australia,0,0,1,1,1984
Grant Kenny,Australia,0,0,1,1,1984
Lucie Guay,Canada,0,0,1,1,1984
Barb Olmsted,Canada,0,0,1,1,1984
Enrique Míguez,Spain,0,0,1,1,1984
Narciso Suárez,Spain,0,0,1,1,1984
François Barouh,France,0,0,1,1,1984
Pascal Boucherit,France,0,0,1,1,1984
Didier Hoyer,France,0,0,1,1,1984
Éric Renaud,France,0,0,1,1,1984
Didier Vavasseur,France,0,0,1,1,1984
Josefa Idem-Guerrini,Italy,0,0,1,1,1984
Annemiek Derckx,Netherlands,0,0,1,1,1984
Costică Olaru,Romania,0,0,1,1,1984
Greg Barton,United States,0,0,1,1,1984
Philippe Boccara,France,0,0,1,1,1984
Ingamay Bylund,Sweden,0,0,1,1,1984
Ulla Håkansson,Sweden,0,0,1,1,1984
Louise Nathhorst,Sweden,0,0,1,1,1984
Bettina Overesch-Böker-Hoy,Germany,0,0,1,1,1984
Heidi Robbiani,Switzerland,0,0,1,1,1984
Claus Erhorn,West Germany,0,0,1,1,1984
Dietmar Hogrefe,West Germany,0,0,1,1,1984
Fritz Ligges,Germany,0,0,1,1,1984
Peter Luther,West Germany,0,0,1,1,1984
Paul Schockemöhle,West Germany,0,0,1,1,1984
Franke Sloothaak,Germany,0,0,1,1,1984
Burkhard Tesdorpf,West Germany,0,0,1,1,1984
Sandra Schumacher,West Germany,0,0,1,1,1984
Reinhard Alber,West Germany,0,0,1,1,1984
Fabrice Colas,France,0,0,1,1,1984
Roland Günther,West Germany,0,0,1,1,1984
Ron Kiefel,United States,0,0,1,1,1984
Roy Knickman,United States,0,0,1,1,1984
Dag Otto Lauritzen,Norway,0,0,1,1,1984
Michael Marx,West Germany,0,0,1,1,1984
Davis Phinney,United States,0,0,1,1,1984
Tsutomu Sakamoto,Japan,0,0,1,1,1984
Andrew Weaver,United States,0,0,1,1,1984
Manuel Youshimatz,Mexico,0,0,1,1,1984
Paul Barber,Great Britain,0,0,1,1,1984
Steve Batchelor,Great Britain,0,0,1,1,1984
Kulbir Bhaura,Great Britain,0,0,1,1,1984
Bob Cattrall,Great Britain,0,0,1,1,1984
Richard Dodds,Great Britain,0,0,1,1,1984
James Duthie,Great Britain,0,0,1,1,1984
Norman Hughes,Great Britain,0,0,1,1,1984
Sean Kerly,Great Britain,0,0,1,1,1984
Richard Leman,Great Britain,0,0,1,1,1984
Sam Martin,Great Britain,0,0,1,1,1984
Billy McConnell,Great Britain,0,0,1,1,1984
Veryan Pappin,Great Britain,0,0,1,1,1984
Jon Potter,Great Britain,0,0,1,1,1984
Mark Precious,Great Britain,0,0,1,1,1984
Ian Taylor,Great Britain,0,0,1,1,1984
David Westcott,Great Britain,0,0,1,1,1984
Beth Anders,United States,0,0,1,1,1984
Beth Beglin,United States,0,0,1,1,1984
Gina Buggy,United States,0,0,1,1,1984
Gwen Cheeseman,United States,0,0,1,1,1984
Sheryl Johnson,United States,0,0,1,1,1984
Chris Larson Mason,United States,0,0,1,1,1984
Kathy McGahey,United States,0,0,1,1,1984
Anita Miller,United States,0,0,1,1,1984
Leslie Milne,United States,0,0,1,1,1984
Char Morett,United States,0,0,1,1,1984
Diane Moyer,United States,0,0,1,1,1984
Marcy Place-von Schottenstein,United States,0,0,1,1,1984
Karen Shelton,United States,0,0,1,1,1984
Brenda Stauffer,United States,0,0,1,1,1984
Julie Staver,United States,0,0,1,1,1984
Judy Strong,United States,0,0,1,1,1984
Véronique Brouquier,France,0,0,1,1,1984
Brigitte Latrille-Gaudin,France,0,0,1,1,1984
Anne Meygret,France,0,0,1,1,1984
Laurence Modaine-Cessac,France,0,0,1,1,1984
Pascale Trinquet-Hachin,France,0,0,1,1,1984
Dorina Vaccaroni,Italy,0,0,1,1,1984
Marc Cerboni,France,0,0,1,1,1984
Patrick Groc,France,0,0,1,1,1984
Pascal Jolyot,France,0,0,1,1,1984
Philippe Omnès,France,0,0,1,1,1984
Frédéric Pietruszka,France,0,0,1,1,1984
Stefano Bellone,Italy,0,0,1,1,1984
Sandro Cuomo,Italy,0,0,1,1,1984
Cosimo Ferro,Italy,0,0,1,1,1984
Roberto Manzi,Italy,0,0,1,1,1984
Angelo Mazzoni,Italy,0,0,1,1,1984
Alexandru Chiculiță,Romania,0,0,1,1,1984
Cornel Marin,Romania,0,0,1,1,1984
Marin Mustață,Romania,0,0,1,1,1984
Ioan Pop,Romania,0,0,1,1,1984
Vilmoș Szabo,Romania,0,0,1,1,1984
Peter Westbrook,United States,0,0,1,1,1984
Mirsad Baljić,Bosnia and Herzegovina,0,0,1,1,1984
Mehmed Baždarević,Bosnia and Herzegovina,0,0,1,1,1984
Vlado Čapljić,Yugoslavia,0,0,1,1,1984
Borislav Cvetković,Croatia,0,0,1,1,1984
Stjepan Deverić,Croatia,0,0,1,1,1984
Milko Ǵurovski,North Macedonia,0,0,1,1,1984
Marko Elsner,Slovenia,0,0,1,1,1984
Nenad Gračan,Croatia,0,0,1,1,1984
Tomislav Ivković,Croatia,0,0,1,1,1984
Srečko Katanec,Slovenia,0,0,1,1,1984
Branko Miljuš,Croatia,0,0,1,1,1984
Mitar Mrkela,Serbia,0,0,1,1,1984
Jovica Nikolić,Serbia,0,0,1,1,1984
Ivan Pudar,Croatia,0,0,1,1,1984
Ljubomir Radanović,Montenegro,0,0,1,1,1984
Admir Smajić,Bosnia and Herzegovina,0,0,1,1,1984
Dragan Stojković,Serbia,0,0,1,1,1984
Chen Yongyan,People's Republic of China,0,0,1,1,1984
Huang Qun,People's Republic of China,0,0,1,1,1984
Wu Jiani,People's Republic of China,0,0,1,1,1984
Zhou Ping,People's Republic of China,0,0,1,1,1984
Zhou Qiurui,People's Republic of China,0,0,1,1,1984
Regina Weber,West Germany,0,0,1,1,1984
Philippe Vatuone,France,0,0,1,1,1984
Noritoshi Hirata,Japan,0,0,1,1,1984
Kyoji Yamawaki,Japan,0,0,1,1,1984
Chen Zhen,People's Republic of China,0,0,1,1,1984
Gao Xiumin,People's Republic of China,0,0,1,1,1984
He Jianping,People's Republic of China,0,0,1,1,1984
Li Lan,People's Republic of China,0,0,1,1,1984
Liu Liping,People's Republic of China,0,0,1,1,1984
Liu Yumei,People's Republic of China,0,0,1,1,1984
Sun Xiulan,People's Republic of China,0,0,1,1,1984
Wang Linwei,People's Republic of China,0,0,1,1,1984
Wang Mingxing,People's Republic of China,0,0,1,1,1984
Wu Xingjiang,People's Republic of China,0,0,1,1,1984
Zhang Peijun,People's Republic of China,0,0,1,1,1984
Zhang Weihong,People's Republic of China,0,0,1,1,1984
Zhu Juefeng,People's Republic of China,0,0,1,1,1984
Mircea Bedivan,Romania,0,0,1,1,1984
Dumitru Berbece,Romania,0,0,1,1,1984
Iosif Boroș,Romania,0,0,1,1,1984
Alexandru Buligan,Romania,0,0,1,1,1984
Gheorghe Covaciu,Romania,0,0,1,1,1984
George Dogărescu,Romania,0,0,1,1,1984
Marian Dumitru,Romania,0,0,1,1,1984
Cornel Durău,Romania,0,0,1,1,1984
Alexandru Fölker,Romania,0,0,1,1,1984
Nicolae Munteanu,Romania,0,0,1,1,1984
Vasile Oprea,Romania,0,0,1,1,1984
Adrian Simion,Romania,0,0,1,1,1984
Vasile Stîngă,Romania,0,0,1,1,1984
Neculai Vasilca,Romania,0,0,1,1,1984
Maricel Voinea,Romania,0,0,1,1,1984
Marc Alexandre,France,0,0,1,1,1984
Mark Berger,Canada,0,0,1,1,1984
Kerrith Brown,Great Britain,0,0,1,1,1984
Wálter Carmona,Brazil,0,0,1,1,1984
Jo Yong-Cheol,Republic of Korea,0,0,1,1,1984
Mihai Cioc,Romania,0,0,1,1,1984
Neil Eckersley,Great Britain,0,0,1,1,1984
Mircea Frățică,Romania,0,0,1,1,1984
Bjarni Friðriksson,Iceland,0,0,1,1,1984
Ed Liddie,United States,0,0,1,1,1984
Günther Neureuther,West Germany,0,0,1,1,1984
Seiki Nose,Japan,0,0,1,1,1984
Michel Nowak,France,0,0,1,1,1984
Pepi Reiter,Austria,0,0,1,1,1984
Arthur Schnabel,West Germany,0,0,1,1,1984
Luiz Onmura,Brazil,0,0,1,1,1984
Didier Boubé,France,0,0,1,1,1984
Joël Bouzou,France,0,0,1,1,1984
Paul Four,France,0,0,1,1,1984
Karen Brancourt,Australia,0,0,1,1,1984
Sue Chapman,Australia,0,0,1,1,1984
Margot Foster,Australia,0,0,1,1,1984
Robyn Grey-Gardner,Australia,0,0,1,1,1984
Susan Lee,Australia,0,0,1,1,1984
Jim Battersby,Australia,0,0,1,1,1984
Ian Edmunds,Australia,0,0,1,1,1984
Steve Evans,Australia,0,0,1,1,1984
Clyde Hefer,Australia,0,0,1,1,1984
Craig Muller,Australia,0,0,1,1,1984
Sam Patten,Australia,0,0,1,1,1984
Ion Popa,Australia,0,0,1,1,1984
Gavin Thredgold,Australia,0,0,1,1,1984
Tim Willoughby,Australia,0,0,1,1,1984
Ann Haesebrouck,Belgium,0,0,1,1,1984
Danièle Laumann,Canada,0,0,1,1,1984
Silken Laumann,Canada,0,0,1,1,1984
Bruce Ford,Canada,0,0,1,1,1984
Doug Hamilton,Canada,0,0,1,1,1984
Mike Hughes,Canada,0,0,1,1,1984
Robert Mills,Canada,0,0,1,1,1984
Phil Monckton,Canada,0,0,1,1,1984
Hanne Eriksen,Denmark,0,0,1,1,1984
Birgitte Hanel,Denmark,0,0,1,1,1984
Lotte Koefoed,Denmark,0,0,1,1,1984
Bodil Steen Rasmussen,Denmark,0,0,1,1,1984
Jette Hejli Sørensen,Denmark,0,0,1,1,1984
Erik Christiansen,Denmark,0,0,1,1,1984
Michael Jessen,Denmark,0,0,1,1,1984
Lars Nielsen,Denmark,0,0,1,1,1984
Per Rasmussen,Denmark,0,0,1,1,1984
Ellen Becker,West Germany,0,0,1,1,1984
Iris Völkner,West Germany,0,0,1,1,1984
Lynda Cornet,Netherlands,0,0,1,1,1984
Marty Laurijsen,Netherlands,0,0,1,1,1984
Catalien Neelissen,Netherlands,0,0,1,1,1984
Anne-Marie Quist,Netherlands,0,0,1,1,1984
Marieke van Drogenbroek,Netherlands,0,0,1,1,1984
Harriet van Ettekoven,Netherlands,0,0,1,1,1984
Wiljon Vaandrager,Netherlands,0,0,1,1,1984
Hans Magnus Grepperud,Norway,0,0,1,1,1984
Sverre Løken,Norway,0,0,1,1,1984
Brett Hollister,New Zealand,0,0,1,1,1984
Kevin Lawton,New Zealand,0,0,1,1,1984
Barrie Mabbott,New Zealand,0,0,1,1,1984
Don Symon,New Zealand,0,0,1,1,1984
Ross Tong,New Zealand,0,0,1,1,1984
"Bob Espeseth, Jr.",United States,0,0,1,1,1984
Doug Herland,United States,0,0,1,1,1984
Kevin Still,United States,0,0,1,1,1984
Zoran Pančić,Serbia,0,0,1,1,1984
Milorad Stanulov,Serbia,0,0,1,1,1984
Patricia Dench,Australia,0,0,1,1,1984
Huang Shiping,People's Republic of China,0,0,1,1,1984
Wang Yifu,People's Republic of China,0,0,1,1,1984
Rauno Bies,Finland,0,0,1,1,1984
Alister Allan,Great Britain,0,0,1,1,1984
Barry Dagger,Great Britain,0,0,1,1,1984
Michael Sullivan,Great Britain,0,0,1,1,1984
Luca Scribani Rossi,Italy,0,0,1,1,1984
Wanda Jewell,United States,0,0,1,1,1984
Dan Carlisle,United States,0,0,1,1,1984
Michele Pearson,Australia,0,0,1,1,1984
Mark Kerry,Australia,0,0,1,1,1984
Justin Lemberg,Australia,0,0,1,1,1984
Rob Woodhouse,Australia,0,0,1,1,1984
Ingrid Lempereur,Belgium,0,0,1,1,1984
Reema Abdo,Canada,0,0,1,1,1984
Michelle MacPherson,Canada,0,0,1,1,1984
Pam Rai,Canada,0,0,1,1,1984
Cam Henning,Canada,0,0,1,1,1984
Li Kongzheng,People's Republic of China,0,0,1,1,1984
Catherine Poirot,France,0,0,1,1,1984
June Croft,Great Britain,0,0,1,1,1984
Andy Astbury,Great Britain,0,0,1,1,1984
Paul Easter,Great Britain,0,0,1,1,1984
Paul Howe,Great Britain,0,0,1,1,1984
Christiane Pielke,West Germany,0,0,1,1,1984
Susanne Schuster,West Germany,0,0,1,1,1984
Petra Zindler,West Germany,0,0,1,1,1984
Iris Zscherpe,West Germany,0,0,1,1,1984
Stefan Pfeiffer,Germany,0,0,1,1,1984
Saeko Kimura,Japan,0,0,1,1,1984
Anca Pătrășcoiu,Romania,0,0,1,1,1984
Étienne Dagon,Switzerland,0,0,1,1,1984
Bengt Baron,Sweden,0,0,1,1,1984
Thomas Lejdström,Sweden,0,0,1,1,1984
Rikard Milton,Sweden,0,0,1,1,1984
Michael Söderlund,Sweden,0,0,1,1,1984
Mikael Örn,Sweden,0,0,1,1,1984
Christina Seufert,United States,0,0,1,1,1984
Wendy Wyland,United States,0,0,1,1,1984
Ron Merriott,United States,0,0,1,1,1984
Rafael Vidal,Venezuela,0,0,1,1,1984
Franco Bertoli,Italy,0,0,1,1,1984
Francesco Dall'Olio,Italy,0,0,1,1,1984
Giancarlo Dametto,Italy,0,0,1,1,1984
Guido De Luigi,Italy,0,0,1,1,1984
Giovanni Errichiello,Italy,0,0,1,1,1984
Giovanni Lanfranco,Italy,0,0,1,1,1984
Pier Paolo Lucchetta,Italy,0,0,1,1,1984
Andrea Lucchetta,Italy,0,0,1,1,1984
Marco Negri,Italy,0,0,1,1,1984
Piero Rebaudengo,Italy,0,0,1,1,1984
Paolo Vecchi,Italy,0,0,1,1,1984
Fabio Vullo,Italy,0,0,1,1,1984
Yumi Egami-Maruyama,Japan,0,0,1,1,1984
Norie Hiro,Japan,0,0,1,1,1984
Miyoko Hirose,Japan,0,0,1,1,1984
Kyoko Ishida,Japan,0,0,1,1,1984
Yoko Kagabu,Japan,0,0,1,1,1984
Yuko Mitsuya,Japan,0,0,1,1,1984
Keiko Miyajima,Japan,0,0,1,1,1984
Kimie Morita,Japan,0,0,1,1,1984
Kumi Nakada,Japan,0,0,1,1,1984
Emiko Odaka,Japan,0,0,1,1,1984
Sachiko Otani,Japan,0,0,1,1,1984
Kayoko Sugiyama,Japan,0,0,1,1,1984
Armando Fernández,Mexico,0,0,1,1,1984
Roland Freund,West Germany,0,0,1,1,1984
Rainer Hoppe,West Germany,0,0,1,1,1984
Thomas Huber,West Germany,0,0,1,1,1984
Thomas Loebb,West Germany,0,0,1,1,1984
Werner Obschernikat,West Germany,0,0,1,1,1984
Rainer Osselmann,West Germany,0,0,1,1,1984
Frank Otto,Germany,0,0,1,1,1984
Peter Röhle,West Germany,0,0,1,1,1984
Jürgen Schröder,West Germany,0,0,1,1,1984
Hagen Stamm,Germany,0,0,1,1,1984
Dirk Theismann,Germany,0,0,1,1,1984
Jouni Grönman,Finland,0,0,1,1,1984
Pekka Niemi,Finland,0,0,1,1,1984
David Mercer,Great Britain,0,0,1,1,1984
Manfred Nerlinger,Germany,0,0,1,1,1984
Ryoji Isaoka,Japan,0,0,1,1,1984
Masahiro Kotaka,Japan,0,0,1,1,1984
Kazushito Manabe,Japan,0,0,1,1,1984
Dragomir Cioroslan,Romania,0,0,1,1,1984
Tsai Wen-Yee,Chinese Taipei,0,0,1,1,1984
Guy Carlton,United States,0,0,1,1,1984
Chris Rinke,Canada,0,0,1,1,1984
Jukka Rauhala,Finland,0,0,1,1,1984
Noel Loban,Great Britain,0,0,1,1,1984
Babis Kholidis,Greece,0,0,1,1,1984
Ikuzo Saito,Japan,0,0,1,1,1984
Yuji Takada,Japan,0,0,1,1,1984
Bang Dae-Du,Republic of Korea,0,0,1,1,1984
Kim Ui-Gon,Republic of Korea,0,0,1,1,1984
Lee Jeong-Geun,Republic of Korea,0,0,1,1,1984
Son Gap-Do,Republic of Korea,0,0,1,1,1984
Victor Dolipschi,Romania,0,0,1,1,1984
Vasile Pușcașu,Romania,0,0,1,1,1984
Ștefan Rusu,Romania,0,0,1,1,1984
Hugo Dietsche,Switzerland,0,0,1,1,1984
Frank Andersson,Sweden,0,0,1,1,1984
Sören Claeson,Sweden,0,0,1,1,1984
Ayhan Taşkın,Turkey,0,0,1,1,1984
Jim Martinez,United States,0,0,1,1,1984
Šaban Sejdi,North Macedonia,0,0,1,1,1984
Jožef Tertei,Serbia,0,0,1,1,1984
Peter Allam,Great Britain,0,0,1,1,1984
Scott Anderson,Australia,0,0,1,1,1984
Christopher Cairns,Australia,0,0,1,1,1984
Steve Calder,Canada,0,0,1,1,1984
Hans Fogh,Canada,0,0,1,1,1984
Giorgio Gorla,Italy,0,0,1,1,1984
Bruce Kendall,New Zealand,0,0,1,1,1984
John Kerr,Canada,0,0,1,1,1984
Terry Neilson,Canada,0,0,1,1,1984
Thierry Péponnet,France,0,0,1,1,1984
Alfio Peraboni,Italy,0,0,1,1,1984
Luc Pillot,France,0,0,1,1,1984
Jo Richards,Great Britain,0,0,1,1,1984
Gael Mulhall-Martin,Australia,0,0,1,1,1984
Lynn Williams,Canada,0,0,1,1,1984
Sterling Hinds,Canada,0,0,1,1,1984
Tony Sharpe,Canada,0,0,1,1,1984
Desai Williams,Canada,0,0,1,1,1984
Zhu Jianhua,People's Republic of China,0,0,1,1,1984
José Manuel Abascal,Spain,0,0,1,1,1984
Arto Bryggare,Finland,0,0,1,1,1984
Michèle Chardonnet,France,0,0,1,1,1984
Thierry Vigneron,France,0,0,1,1,1984
Bev Goddard-Callender,Great Britain,0,0,1,1,1984
Sue Hearnshaw,Great Britain,0,0,1,1,1984
Heather Hunte-Oakes,Great Britain,0,0,1,1,1984
Simone Jacobs,Great Britain,0,0,1,1,1984
Fatima Whitbread,Great Britain,0,0,1,1,1984
Keith Connor,Great Britain,0,0,1,1,1984
Charlie Spedding,Great Britain,0,0,1,1,1984
Gaby Bußmann,West Germany,0,0,1,1,1984
Sabine Everts,West Germany,0,0,1,1,1984
Ute Thimm,West Germany,0,0,1,1,1984
Heide-Elke Gaugel,West Germany,0,0,1,1,1984
Nicole Leistenschneider,West Germany,0,0,1,1,1984
Heike Schulte-Mattler,West Germany,0,0,1,1,1984
Christina Sussiek,West Germany,0,0,1,1,1984
Klaus Ploghaus,West Germany,0,0,1,1,1984
Harald Schmid,West Germany,0,0,1,1,1984
Siggi Wentz,West Germany,0,0,1,1,1984
Sandro Bellucci,Italy,0,0,1,1,1984
Maurizio Damilano,Italy,0,0,1,1,1984
Giovanni Evangelisti,Italy,0,0,1,1,1984
Mike Musyoki,Kenya,0,0,1,1,1984
Innocent Egbunike,Nigeria,0,0,1,1,1984
Rotimi Peters,Nigeria,0,0,1,1,1984
Moses Ugbisien,Nigeria,0,0,1,1,1984
Sunday Uti,Nigeria,0,0,1,1,1984
Rosa Mota,Portugal,0,0,1,1,1984
António Leitão,Portugal,0,0,1,1,1984
Cristieana Cojocaru,Romania,0,0,1,1,1984
Florența Țacu-Crăciunescu,Romania,0,0,1,1,1984
Fița Lovin,Romania,0,0,1,1,1984
Kenth Eldebrink,Sweden,0,0,1,1,1984
Joni Huntley,United States,0,0,1,1,1984
Kim Turner,United States,0,0,1,1,1984
Earl Bell,United States,0,0,1,1,1984
Brian Diemer,United States,0,0,1,1,1984
Thomas Jefferson,United States,0,0,1,1,1984
Earl Jones,United States,0,0,1,1,1984
Dave Laut,United States,0,0,1,1,1984
John Powell,United States,0,0,1,1,1984
Kristin Otto,East Germany,6,0,0,6,1988
Matt Biondi,United States,5,1,1,7,1988
Vladimir Artyomov,Russian Federation,4,1,0,5,1988
Daniela Silivaș,Romania,3,2,1,6,1988
Florence Griffith Joyner,United States,3,1,0,4,1988
Dmitry Bilozerchev,Russian Federation,3,0,1,4,1988
Janet Evans,United States,3,0,0,3,1988
Valery Lyukin,Kazakhstan,2,2,0,4,1988
Sviatlana Bahinskaya,Belarus,2,1,1,4,1988
Yelena Shushunova,Russian Federation,2,1,1,4,1988
Birgit Fischer-Schmidt,East Germany,2,1,0,3,1988
Heike Friedrich,East Germany,2,1,0,3,1988
Chris Jacobs,United States,2,1,0,3,1988
Tom Jager,United States,2,1,0,3,1988
Carl Lewis,United States,2,1,0,3,1988
Silke Hörner,East Germany,2,0,1,3,1988
Katrin Meißner,East Germany,2,0,1,3,1988
Daniela Hunger,East Germany,2,0,1,3,1988
Manuela Stellmach,East Germany,2,0,1,3,1988
Kim Su-Nyeong,Republic of Korea,2,0,0,2,1988
Anke Nothnagel-von Seck,East Germany,2,0,0,2,1988
Zsolt Gyulay,Hungary,2,0,0,2,1988
Victor Reneischi,Republic of Moldova,2,0,0,2,1988
Nicolae Juravschi,Republic of Moldova,2,0,0,2,1988
Greg Barton,United States,2,0,0,2,1988
Nicole Uphoff-Becker,Germany,2,0,0,2,1988
Gintautas Umaras,Lithuania,2,0,0,2,1988
Anja Fichtel-Mauritz,Germany,2,0,0,2,1988
Sergey Kharkov,Russian Federation,2,0,0,2,1988
János Martinek,Hungary,2,0,0,2,1988
Carolyn Waldo,Canada,2,0,0,2,1988
Tamás Darnyi,Hungary,2,0,0,2,1988
Troy Dalbey,United States,2,0,0,2,1988
Doug Gjertsen,United States,2,0,0,2,1988
Greg Louganis,United States,2,0,0,2,1988
Olga Bryzgina,Soviet Union,2,0,0,2,1988
Jackie Joyner-Kersee,United States,2,0,0,2,1988
Steve Lewis,United States,2,0,0,2,1988
Birte Weigang,East Germany,1,2,0,3,1988
Vanya Gesheva,Bulgaria,1,1,1,3,1988
Paul MacDonald,New Zealand,1,1,1,3,1988
Holger Behrendt,East Germany,1,1,1,3,1988
Uwe Daßler,East Germany,1,1,1,3,1988
Chen Jing,Chinese Taipei,1,1,0,2,1988
Wang Hui-Gyeong,Republic of Korea,1,1,0,2,1988
Park Seong-Su,Republic of Korea,1,1,0,2,1988
Jay Barrs,United States,1,1,0,2,1988
Olaf Heukrodt,East Germany,1,1,0,2,1988
Ian Ferguson,New Zealand,1,1,0,2,1988
Philippe Riboud,France,1,1,0,2,1988
Arnd Schmitt,Germany,1,1,0,2,1988
Olga Homeghi-Bularda,Romania,1,1,0,2,1988
Rodica Arba-Pușcatu,Romania,1,1,0,2,1988
Nino Salukvadze,Georgia,1,1,0,2,1988
Silvia Sperber,Germany,1,1,0,2,1988
Duncan Armstrong,Australia,1,1,0,2,1988
Krisztina Egerszegi,Hungary,1,1,0,2,1988
Dave Berkoff,United States,1,1,0,2,1988
Tatsiana Ledauskaya,Belarus,1,1,0,2,1988
Paula Ivan,Romania,1,1,0,2,1988
Evelyn Ashford,United States,1,1,0,2,1988
Butch Reynolds,United States,1,1,0,2,1988
Sabine Bau,Germany,1,1,0,2,1988
Cornelia Sirch,East Germany,1,0,2,3,1988
Igor Polyansky,Russian Federation,1,0,2,3,1988
Steffi Graf,Germany,1,0,1,2,1988
Yu Nam-Gyu,Republic of Korea,1,0,1,2,1988
Yun Yeong-Suk,Republic of Korea,1,0,1,2,1988
Miloslav Mečíř,Czechoslovakia,1,0,1,2,1988
Zina Garrison,United States,1,0,1,2,1988
Attila Ábrahám,Hungary,1,0,1,2,1988
Ferenc Csipes,Hungary,1,0,1,2,1988
"Pierre Durand, Jr.",France,1,0,1,2,1988
Mark Todd,New Zealand,1,0,1,2,1988
Zita Funkenhauser,Germany,1,0,1,2,1988
Aleksandr Romankov,Belarus,1,0,1,2,1988
Lou Yun,People's Republic of China,1,0,1,2,1988
Andy Holmes,Great Britain,1,0,1,2,1988
Steven Redgrave,Great Britain,1,0,1,2,1988
Jasna Šekarić,Individual Olympic Athletes,1,0,1,2,1988
Michael Groß,West Germany,1,0,1,2,1988
Olga Nazarova,Russian Federation,1,0,1,2,1988
Tatyana Samolenko-Dorovskikh,Soviet Union,1,0,1,2,1988
Danny Everett,United States,1,0,1,2,1988
Hyeon Jeong-Hwa,Republic of Korea,1,0,0,1,1988
Yang Yeong-Ja,Republic of Korea,1,0,0,1,1988
Lennox Lewis,Canada,1,0,0,1,1988
Jeon In-Su,Republic of Korea,1,0,0,1,1988
Lee Han-Seop,Republic of Korea,1,0,0,1,1988
Chen Longcan,People's Republic of China,1,0,0,1,1988
Seiko Iseki,Japan,1,0,0,1,1988
Pam Shriver,United States,1,0,0,1,1988
Ken Flach,United States,1,0,0,1,1988
Robert Seguso,United States,1,0,0,1,1988
Valdemaras Chomičius,Lithuania,1,0,0,1,1988
Henry Maske,East Germany,1,0,0,1,1988
Andreas Zülow,East Germany,1,0,0,1,1988
Giovanni Parisi,Italy,1,0,0,1,1988
Robert Wangila,Kenya,1,0,0,1,1988
Kim Gwang-Seon,Republic of Korea,1,0,0,1,1988
Park Si-Heon,Republic of Korea,1,0,0,1,1988
Viktor Pankrashkin,Russian Federation,1,0,0,1,1988
Cindy Brown,United States,1,0,0,1,1988
Vicky Bullett,United States,1,0,0,1,1988
Cynthia Cooper,United States,1,0,0,1,1988
Anne Donovan,United States,1,0,0,1,1988
Teresa Edwards,United States,1,0,0,1,1988
Kamie Ethridge,United States,1,0,0,1,1988
Jennifer Gillom,United States,1,0,0,1,1988
Bridgette Gordon,United States,1,0,0,1,1988
Andrea Lloyd,United States,1,0,0,1,1988
Katrina McClain,United States,1,0,0,1,1988
Suzie McConnell,United States,1,0,0,1,1988
Teresa Weatherspoon,United States,1,0,0,1,1988
Aleksandr Belostenny,Soviet Union,1,0,0,1,1988
Valery Goborov,Soviet Union,1,0,0,1,1988
Rimas Kurtinaitis,Lithuania,1,0,0,1,1988
Šarūnas Marčiulionis,Lithuania,1,0,0,1,1988
Igors Miglinieks,Latvia,1,0,0,1,1988
Arvydas Sabonis,Lithuania,1,0,0,1,1988
Tiit Sokk,Estonia,1,0,0,1,1988
Sergey Tarakanov,Russian Federation,1,0,0,1,1988
Valery Tikhonenko,Kazakhstan,1,0,0,1,1988
Aleksandr Volkov,Soviet Union,1,0,0,1,1988
Ivaylo Mustafov-Khristov,Bulgaria,1,0,0,1,1988
Vyacheslav Yanovsky,Belarus,1,0,0,1,1988
Andrew Maynard,United States,1,0,0,1,1988
Kennedy McKinney,United States,1,0,0,1,1988
Ray Mercer,United States,1,0,0,1,1988
Heike Singer,East Germany,1,0,0,1,1988
Ramona Portwich,East Germany,1,0,0,1,1988
Sándor Hódosi,Hungary,1,0,0,1,1988
Ivans Klementjevs,Latvia,1,0,0,1,1988
Norm Bellingham,United States,1,0,0,1,1988
Ann-Kathrin Linsenhoff,West Germany,1,0,0,1,1988
Monica Theodorescu,Germany,1,0,0,1,1988
Matthias Baumann,Germany,1,0,0,1,1988
Ludger Beerbaum,Germany,1,0,0,1,1988
Wolfgang Brinkmann,West Germany,1,0,0,1,1988
Ralf Ehrenbrink,Germany,1,0,0,1,1988
Claus Erhorn,West Germany,1,0,0,1,1988
Dirk Hafemeister,West Germany,1,0,0,1,1988
Thies Kaspareit,West Germany,1,0,0,1,1988
Reiner Klimke,Germany,1,0,0,1,1988
Franke Sloothaak,Germany,1,0,0,1,1988
Monique Knol,Netherlands,1,0,0,1,1988
Erika Salumäe,Estonia,1,0,0,1,1988
Uwe Ampler,East Germany,1,0,0,1,1988
Dan Frost,Denmark,1,0,0,1,1988
Lutz Heßlich,East Germany,1,0,0,1,1988
Vyacheslav Yekimov,Russian Federation,1,0,0,1,1988
Artūras Kasputis,Lithuania,1,0,0,1,1988
Aleksandr Kirichenko,Russian Federation,1,0,0,1,1988
Mario Kummer,East Germany,1,0,0,1,1988
Maik Landsmann,East Germany,1,0,0,1,1988
Olaf Ludwig,East Germany,1,0,0,1,1988
Dmitry Nelyubin,Russian Federation,1,0,0,1,1988
Jan Schur,East Germany,1,0,0,1,1988
Mindaugas Umaras,Lithuania,1,0,0,1,1988
Tracey Belbin,Australia,1,0,0,1,1988
Sharon Buchanan-Patmore,Australia,1,0,0,1,1988
Lee Capes,Australia,1,0,0,1,1988
Michelle Capes-Hager,Australia,1,0,0,1,1988
Sally Carbon,Australia,1,0,0,1,1988
Elspeth Clement,Australia,1,0,0,1,1988
Loretta Dorman,Australia,1,0,0,1,1988
Maree Fish,Australia,1,0,0,1,1988
Rechelle Hawkes,Australia,1,0,0,1,1988
Lorraine Hillas,Australia,1,0,0,1,1988
Kathleen Partridge,Australia,1,0,0,1,1988
Jackie Pereira,Australia,1,0,0,1,1988
Sandra Pisani,Australia,1,0,0,1,1988
Kim Small,Australia,1,0,0,1,1988
Debbie Bowman-Sullivan,Australia,1,0,0,1,1988
Liane Tooth,Australia,1,0,0,1,1988
Paul Barber,Great Britain,1,0,0,1,1988
Steve Batchelor,Great Britain,1,0,0,1,1988
Kulbir Bhaura,Great Britain,1,0,0,1,1988
Robert Clift,Great Britain,1,0,0,1,1988
Richard Dodds,Great Britain,1,0,0,1,1988
David Faulkner,Great Britain,1,0,0,1,1988
Russell Garcia,Great Britain,1,0,0,1,1988
Martyn Grimley,Great Britain,1,0,0,1,1988
Sean Kerly,Great Britain,1,0,0,1,1988
Jimmy Kirkwood,Great Britain,1,0,0,1,1988
Richard Leman,Great Britain,1,0,0,1,1988
Sam Martin,Great Britain,1,0,0,1,1988
Veryan Pappin,Great Britain,1,0,0,1,1988
Jon Potter,Great Britain,1,0,0,1,1988
Imran Sherwani,Great Britain,1,0,0,1,1988
Ian Taylor,Great Britain,1,0,0,1,1988
Annette Klug,West Germany,1,0,0,1,1988
Christiane Weber,West Germany,1,0,0,1,1988
Frédéric Delpla,France,1,0,0,1,1988
Jean-Michel Henry,France,1,0,0,1,1988
Jean-François Lamour,France,1,0,0,1,1988
Olivier Lenglet,France,1,0,0,1,1988
Éric Srecki,France,1,0,0,1,1988
Imre Bujdosó,Hungary,1,0,0,1,1988
László Csongrádi,Hungary,1,0,0,1,1988
László Fábián,Hungary,1,0,0,1,1988
Imre Gedővári,Hungary,1,0,0,1,1988
György Nébald,Hungary,1,0,0,1,1988
Bence Szabó,Hungary,1,0,0,1,1988
Stefano Cerioni,Italy,1,0,0,1,1988
Ilgar Mamedov,Russian Federation,1,0,0,1,1988
Vladimer Aptsiauri,Georgia,1,0,0,1,1988
Anvar Ibragimov,Russian Federation,1,0,0,1,1988
Boris Koretsky,Azerbaijan,1,0,0,1,1988
Aleksandr Borodyuk,Russian Federation,1,0,0,1,1988
Igor Doborovolsky,Russian Federation,1,0,0,1,1988
Sergey Fokin,Russian Federation,1,0,0,1,1988
Sergey Gorlukovich,Russian Federation,1,0,0,1,1988
Arvydas Janonis,Lithuania,1,0,0,1,1988
Yevgeny Yarovenko,Kazakhstan,1,0,0,1,1988
Dmitry Kharin,Russian Federation,1,0,0,1,1988
Gela K'et'ashvili,Georgia,1,0,0,1,1988
Yevgeny Kuznetsov,Russian Federation,1,0,0,1,1988
Vladimir Lyuty,Soviet Union,1,0,0,1,1988
Viktor Losev,Russian Federation,1,0,0,1,1988
Aleksey Mikhaylichenko,Soviet Union,1,0,0,1,1988
Arminas Narbekovas,Lithuania,1,0,0,1,1988
Igor Ponomaryov,Azerbaijan,1,0,0,1,1988
Yury Savichev,Russian Federation,1,0,0,1,1988
Igor Sklyarov,Russian Federation,1,0,0,1,1988
Vladimir Tatarchuk,Russian Federation,1,0,0,1,1988
Aleksey Cherednik,Soviet Union,1,0,0,1,1988
Svetlana Baitova,Belarus,1,0,0,1,1988
Natālija Laščonova,Latvia,1,0,0,1,1988
Marina Lobach,Belarus,1,0,0,1,1988
Yelena Shevchenko,Russian Federation,1,0,0,1,1988
Olga Strazheva,Soviet Union,1,0,0,1,1988
Lyubomir Geraskov,Bulgaria,1,0,0,1,1988
Zsolt Borkai,Hungary,1,0,0,1,1988
Lado Gogoladze,Georgia,1,0,0,1,1988
Vladimir Novikov,Kazakhstan,1,0,0,1,1988
Han Hyeon-Suk,Republic of Korea,1,0,0,1,1988
Kim Chun-Rye,Republic of Korea,1,0,0,1,1988
Kim Hyeon-Mi,Republic of Korea,1,0,0,1,1988
Kim Gyeong-Sun,Republic of Korea,1,0,0,1,1988
Kim Mi-Suk,Republic of Korea,1,0,0,1,1988
Kim Myeong-Sun,Republic of Korea,1,0,0,1,1988
Lee Gi-Sun,Republic of Korea,1,0,0,1,1988
Im Mi-Gyeong,Republic of Korea,1,0,0,1,1988
Son Mi-Na,Republic of Korea,1,0,0,1,1988
Song Ji-Hyeon,Republic of Korea,1,0,0,1,1988
Seok Min-Hui,Republic of Korea,1,0,0,1,1988
Seong Gyeong-Hwa,Republic of Korea,1,0,0,1,1988
Valery Gopin,Russian Federation,1,0,0,1,1988
Andrey Lavrov,Russian Federation,1,0,0,1,1988
Vyacheslav Atavin,Russian Federation,1,0,0,1,1988
Aleksandr Karshakevich,Belarus,1,0,0,1,1988
Yury Nesterov,Russian Federation,1,0,0,1,1988
Voldemaras Novickis,Lithuania,1,0,0,1,1988
Aleksandr Rymanov,Russian Federation,1,0,0,1,1988
Konstantin Sharovarov,Belarus,1,0,0,1,1988
Yury Shevtsov,Belarus,1,0,0,1,1988
Georgy Sviridenko,Belarus,1,0,0,1,1988
Igor Chumak,Russian Federation,1,0,0,1,1988
Andrey Tyumentsev,Russian Federation,1,0,0,1,1988
Aleksandr Tuchkin,Russian Federation,1,0,0,1,1988
Mikhail Vasilyev,Russian Federation,1,0,0,1,1988
Marc Alexandre,France,1,0,0,1,1988
Kim Jae-Yeop,Republic of Korea,1,0,0,1,1988
Lee Gyeong-Geun,Republic of Korea,1,0,0,1,1988
Waldemar Legień,Poland,1,0,0,1,1988
Aurélio Miguel,Brazil,1,0,0,1,1988
Hitoshi Saito,Japan,1,0,0,1,1988
Peter Seisenbacher,Austria,1,0,0,1,1988
Attila Mizsér,Hungary,1,0,0,1,1988
Ramona Balthasar,East Germany,1,0,0,1,1988
Jutta Behrendt,East Germany,1,0,0,1,1988
Gerlinde Doberschütz,East Germany,1,0,0,1,1988
Kerstin Förster,East Germany,1,0,0,1,1988
Carola Hornig,East Germany,1,0,0,1,1988
Anja Kluge,East Germany,1,0,0,1,1988
Sylvia Rose,East Germany,1,0,0,1,1988
Beatrix Schröer,East Germany,1,0,0,1,1988
Martina Schröter,East Germany,1,0,0,1,1988
Jana Sorgers,East Germany,1,0,0,1,1988
Martina Walther,East Germany,1,0,0,1,1988
Bernd Eichwurzel,East Germany,1,0,0,1,1988
Olaf Förster,East Germany,1,0,0,1,1988
Thomas Greiner,East Germany,1,0,0,1,1988
Frank Klawonn,East Germany,1,0,0,1,1988
Bernd Niesecke,East Germany,1,0,0,1,1988
Karsten Schmeling,East Germany,1,0,0,1,1988
Roland Schröder,East Germany,1,0,0,1,1988
Kathrin Haacker,East Germany,1,0,0,1,1988
Kristina Mundt,East Germany,1,0,0,1,1988
Daniela Neunast,East Germany,1,0,0,1,1988
Birgit Peter,East Germany,1,0,0,1,1988
Beate Schramm,East Germany,1,0,0,1,1988
Birte Siech,East Germany,1,0,0,1,1988
Annegret Strauch,East Germany,1,0,0,1,1988
Ute Schell-Wagner-Stange,East Germany,1,0,0,1,1988
Judith Zeidler,East Germany,1,0,0,1,1988
Ralf Brudel,East Germany,1,0,0,1,1988
Thomas Domian,West Germany,1,0,0,1,1988
Armin Eichholz,Germany,1,0,0,1,1988
Manfred Klein,Germany,1,0,0,1,1988
Thomas Lange,East Germany,1,0,0,1,1988
Matthias Mellinghaus,West Germany,1,0,0,1,1988
Wolfgang Maennig,Germany,1,0,0,1,1988
Thomas Möllenkamp,West Germany,1,0,0,1,1988
Bahne Rabe,Germany,1,0,0,1,1988
Hendrik Reiher,East Germany,1,0,0,1,1988
Eckhardt Schultz,West Germany,1,0,0,1,1988
Ansgar Wessling,Germany,1,0,0,1,1988
Agostino Abbagnale,Italy,1,0,0,1,1988
Carmine Abbagnale,Italy,1,0,0,1,1988
Giuseppe Abbagnale,Italy,1,0,0,1,1988
Giuseppe Di Capua,Italy,1,0,0,1,1988
Gianluca Farina,Italy,1,0,0,1,1988
Piero Poli,Italy,1,0,0,1,1988
Davide Tizzano,Italy,1,0,0,1,1988
Ronald Florijn,Netherlands,1,0,0,1,1988
Nico Rienks,Netherlands,1,0,0,1,1988
Iryna Shylava,Belarus,1,0,0,1,1988
Tanyu Kiryakov,Bulgaria,1,0,0,1,1988
Malcolm Cooper,Great Britain,1,0,0,1,1988
Axel Wegner,East Germany,1,0,0,1,1988
Afanasijs Kuzmins,Latvia,1,0,0,1,1988
Tor Heiestad,Norway,1,0,0,1,1988
Sorin Babii,Romania,1,0,0,1,1988
Miroslav Varga,Czech Republic,1,0,0,1,1988
Dmytro Monakov,Soviet Union,1,0,0,1,1988
Goran Maksimović,Individual Olympic Athletes,1,0,0,1,1988
Tanya Bogomilova-Dangalakova,Bulgaria,1,0,0,1,1988
Michelle Cameron,Canada,1,0,0,1,1988
Gao Min,People's Republic of China,1,0,0,1,1988
Xu Yanmei,People's Republic of China,1,0,0,1,1988
Adrian Moorhouse,Great Britain,1,0,0,1,1988
Kathleen Nord,East Germany,1,0,0,1,1988
Sabina Schulze,East Germany,1,0,0,1,1988
József Szabó,Hungary,1,0,0,1,1988
Daichi Suzuki,Japan,1,0,0,1,1988
Anthony Nesty,Suriname,1,0,0,1,1988
Vladimir Salnikov,Russian Federation,1,0,0,1,1988
Matt Cetlinski,United States,1,0,0,1,1988
Shaun Jordan,United States,1,0,0,1,1988
Dan Jorgensen,United States,1,0,0,1,1988
Brent Lang,United States,1,0,0,1,1988
Jay Mortenson,United States,1,0,0,1,1988
Craig Oppel,United States,1,0,0,1,1988
Rich Schroeder,United States,1,0,0,1,1988
Marina Nikulina-Pankova,Russian Federation,1,0,0,1,1988
Valentina Ogiyenko,Russian Federation,1,0,0,1,1988
Svetlana Korytova,Russian Federation,1,0,0,1,1988
Tatyana Kraynova,Russian Federation,1,0,0,1,1988
Olga Krivosheyeva,Kazakhstan,1,0,0,1,1988
Marina Kumysh,Russian Federation,1,0,0,1,1988
Jelena Ovchinnikova-Čebukina,Croatia,1,0,0,1,1988
Irina Parkhomchuk,Russian Federation,1,0,0,1,1988
Tatyana Sidorenko,Russian Federation,1,0,0,1,1988
Olga Shkurnova,Soviet Union,1,0,0,1,1988
Irina Smirnova-Ilchenko,Russian Federation,1,0,0,1,1988
Yelena Volkova,Russian Federation,1,0,0,1,1988
Craig Buck,United States,1,0,0,1,1988
Bob Ctvrtlik,United States,1,0,0,1,1988
Scott Fortune,United States,1,0,0,1,1988
Karch Kiraly,United States,1,0,0,1,1988
Ricci Luyties,United States,1,0,0,1,1988
Doug Partie,United States,1,0,0,1,1988
Jon Root,United States,1,0,0,1,1988
Eric Sato,United States,1,0,0,1,1988
Dave Saunders,United States,1,0,0,1,1988
Jeff Stork,United States,1,0,0,1,1988
Troy Tanner,United States,1,0,0,1,1988
Steve Timmons,United States,1,0,0,1,1988
Perica Bukić,Croatia,1,0,0,1,1988
Dubravko Šimenc,Croatia,1,0,0,1,1988
Dragan Andrić,Greece,1,0,0,1,1988
Mislav Bezmalinović,Croatia,1,0,0,1,1988
Veselin Đuho,Croatia,1,0,0,1,1988
Igor Gočanin,Serbia,1,0,0,1,1988
Deni Lušić,Croatia,1,0,0,1,1988
Igor Milanović,Serbia,1,0,0,1,1988
Tomislav Paškvalin,Croatia,1,0,0,1,1988
Renco Posinković,Croatia,1,0,0,1,1988
Goran Rađenović,Montenegro,1,0,0,1,1988
Aleksandar Šoštar,Serbia,1,0,0,1,1988
Mirko Vičević,Montenegro,1,0,0,1,1988
Borislav Gidikov,Bulgaria,1,0,0,1,1988
Sevdalin Marinov,Bulgaria,1,0,0,1,1988
Joachim Kunz,East Germany,1,0,0,1,1988
Anatoly Khrapaty,Kazakhstan,1,0,0,1,1988
Naim Süleymanoğlu,Turkey,1,0,0,1,1988
Israil Arsamakov,Russian Federation,1,0,0,1,1988
Aliaksandr Kurlovich,Belarus,1,0,0,1,1988
Pavel Kuznetsov,Russian Federation,1,0,0,1,1988
Oksen Mirzoyan,Armenia,1,0,0,1,1988
Yury Zakharevich,Russian Federation,1,0,0,1,1988
Kamandar Madzhydau,Belarus,1,0,0,1,1988
Atanas Komshev,Bulgaria,1,0,0,1,1988
András Sike,Hungary,1,0,0,1,1988
Vincenzo Maenza,Italy,1,0,0,1,1988
Takashi Kobayashi,Japan,1,0,0,1,1988
Mitsuru Sato,Japan,1,0,0,1,1988
Han Myeong-U,Republic of Korea,1,0,0,1,1988
Kim Yeong-Nam,Republic of Korea,1,0,0,1,1988
Jon Rønningen,Norway,1,0,0,1,1988
Andrzej Wroński,Poland,1,0,0,1,1988
Vasile Pușcașu,Romania,1,0,0,1,1988
Makharbek Khadartsev,Russian Federation,1,0,0,1,1988
Aleksandr Karelin,Russian Federation,1,0,0,1,1988
Sergey Beloglazov,Russian Federation,1,0,0,1,1988
Levon Julfalakyan,Armenia,1,0,0,1,1988
Davit Gobejishvili,Georgia,1,0,0,1,1988
Mikhail Mamiashvili,Russian Federation,1,0,0,1,1988
Kenny Monday,United States,1,0,0,1,1988
John Smith,United States,1,0,0,1,1988
Arsen Fadzayev,Russian Federation,1,0,0,1,1988
Lynne Jewell,United States,1,0,0,1,1988
Allison Jolly,United States,1,0,0,1,1988
José Luis Doreste,Spain,1,0,0,1,1988
Thomas Flach,East Germany,1,0,0,1,1988
Christian Grønborg,Denmark,1,0,0,1,1988
Nicolas Hénard,France,1,0,0,1,1988
Bernd Jäkel,East Germany,1,0,0,1,1988
Bruce Kendall,New Zealand,1,0,0,1,1988
Jean-Yves le Déroff,France,1,0,0,1,1988
Mike McIntyre,Great Britain,1,0,0,1,1988
Jørgen Bojsen-Møller,Denmark,1,0,0,1,1988
Thierry Péponnet,France,1,0,0,1,1988
Luc Pillot,France,1,0,0,1,1988
Jochen Schümann,East Germany,1,0,0,1,1988
Bryn Vaile,Great Britain,1,0,0,1,1988
Debbie Flintoff-King,Australia,1,0,0,1,1988
Yordanka Donkova,Bulgaria,1,0,0,1,1988
Khristo Markov,Bulgaria,1,0,0,1,1988
Tapio Korjus,Finland,1,0,0,1,1988
Christian Schenk,East Germany,1,0,0,1,1988
Petra Meier-Felke,East Germany,1,0,0,1,1988
Sigrun Wodars-Grau,East Germany,1,0,0,1,1988
Martina Hellmann,East Germany,1,0,0,1,1988
Jürgen Schult,East Germany,1,0,0,1,1988
Ulf Timmermann,East Germany,1,0,0,1,1988
Gelindo Bordin,Italy,1,0,0,1,1988
Vitaly Savin,Kazakhstan,1,0,0,1,1988
Paul Ereng,Kenya,1,0,0,1,1988
Julius Kariuki,Kenya,1,0,0,1,1988
John Ngugi,Kenya,1,0,0,1,1988
Peter Rono,Kenya,1,0,0,1,1988
Brahim Boutayeb,Morocco,1,0,0,1,1988
Rosa Mota,Portugal,1,0,0,1,1988
Jozef Pribilinec,Czechoslovakia,1,0,0,1,1988
Olga Bondarenko,Russian Federation,1,0,0,1,1988
Lyudmila Dzhigalova,Soviet Union,1,0,0,1,1988
Mariya Pinigina,Russian Federation,1,0,0,1,1988
Nataliya Lisovskaya,Russian Federation,1,0,0,1,1988
Gennady Avdeyenko,Soviet Union,1,0,0,1,1988
Viktor Bryzgin,Soviet Union,1,0,0,1,1988
Sergey Bubka,Soviet Union,1,0,0,1,1988
Vyacheslav Ivanenko,Russian Federation,1,0,0,1,1988
Vladimir Krylov,Russian Federation,1,0,0,1,1988
Sergey Litvinov,Russian Federation,1,0,0,1,1988
Vladimir Muravyov,Kazakhstan,1,0,0,1,1988
Alice Brown,United States,1,0,0,1,1988
Sheila Echols,United States,1,0,0,1,1988
Louise Ritter,United States,1,0,0,1,1988
Dannette Young,United States,1,0,0,1,1988
Joe DeLoach,United States,1,0,0,1,1988
Roger Kingdom,United States,1,0,0,1,1988
Antonio McKay,United States,1,0,0,1,1988
André Phillips,United States,1,0,0,1,1988
Kevin Robinzine,United States,1,0,0,1,1988
Andrew Valmon,United States,1,0,0,1,1988
Ute Wild,East Germany,1,0,0,1,1988
Gabriela Potorac,Romania,0,2,1,3,1988
Viktor Denisov,Russian Federation,0,2,0,2,1988
Igor Nagayev,Soviet Union,0,2,0,2,1988
Greg Best,United States,0,2,0,2,1988
Ian Stark,Great Britain,0,2,0,2,1988
Sylvio Kroll,East Germany,0,2,0,2,1988
Carlo Massullo,Italy,0,2,0,2,1988
Linford Christie,Great Britain,0,2,0,2,1988
Ronald Weigel,East Germany,0,2,0,2,1988
Sven Tippelt,East Germany,0,1,2,3,1988
Gennady Prigoda,Russian Federation,0,1,2,3,1988
Heike Drechsler,East Germany,0,1,2,3,1988
Jiao Zhimin,People's Republic of China,0,1,1,2,1988
Diana Paliyska,Bulgaria,0,1,1,2,1988
Andreas Stähle,East Germany,0,1,1,2,1988
Marek Dopierała,Poland,0,1,1,2,1988
Marek Łbik,Poland,0,1,1,2,1988
Virginia Holgate-Leng,Great Britain,0,1,1,2,1988
Christine Stückelberger,Switzerland,0,1,1,2,1988
Dean Woods,Australia,0,1,1,2,1988
Dagmar Kersten,East Germany,0,1,1,2,1988
Hu Yadong,People's Republic of China,0,1,1,2,1988
Li Ronghua,People's Republic of China,0,1,1,2,1988
Yang Xiao,People's Republic of China,0,1,1,2,1988
Zhang Xianghua,People's Republic of China,0,1,1,2,1988
Zhou Shouying,People's Republic of China,0,1,1,2,1988
Herta Anitaș,Romania,0,1,1,2,1988
Mihaela Armășescu,Romania,0,1,1,2,1988
Doina Liliana Snep-Bălan,Romania,0,1,1,2,1988
Adriana Chelariu-Bazon,Romania,0,1,1,2,1988
Veronica Cogeanu-Cochela,Romania,0,1,1,2,1988
Veronica Necula,Romania,0,1,1,2,1988
Ecaterina Oancia,Romania,0,1,1,2,1988
Elisabeta Oleniuc-Lipă,Romania,0,1,1,2,1988
Mărioara Trașcă,Romania,0,1,1,2,1988
Antoaneta Frenkeva,Bulgaria,0,1,1,2,1988
Thomas Flemming,East Germany,0,1,1,2,1988
Lars Hinneburg,East Germany,0,1,1,2,1988
Stefan Pfeiffer,Germany,0,1,1,2,1988
Steffen Zesner,East Germany,0,1,1,2,1988
Noëmi Lung,Romania,0,1,1,2,1988
Nikolay Yevseyev,Russian Federation,0,1,1,2,1988
Mary T. Meagher,United States,0,1,1,2,1988
Dara Torres,United States,0,1,1,2,1988
Mary Wayte,United States,0,1,1,2,1988
Petra Müller,East Germany,0,1,1,2,1988
Kim Gi-Taek,Republic of Korea,0,1,0,1,1988
Egerton Marcus,Canada,0,1,0,1,1988
Lilies Handayani,Indonesia,0,1,0,1,1988
Nurfitriyana Saiman-Lantang,Indonesia,0,1,0,1,1988
Kusuma Wardhani,Indonesia,0,1,0,1,1988
Rick McKinney,United States,0,1,0,1,1988
Darrell Pace,United States,0,1,0,1,1988
Gabriela Sabatini,Argentina,0,1,0,1,1988
Li Huifen,People's Republic of China,0,1,0,1,1988
Zoran Primorac,Croatia,0,1,0,1,1988
Jana Novotná,Czech Republic,0,1,0,1,1988
Helena Suková,Czech Republic,0,1,0,1,1988
Sergio Casal,Spain,0,1,0,1,1988
Emilio Sánchez Vicario,Spain,0,1,0,1,1988
Tim Mayotte,United States,0,1,0,1,1988
Ilija Lupulesku,Individual Olympic Athletes,0,1,0,1,1988
Laurent Boudouani,France,0,1,0,1,1988
Andreas Tews,East Germany,0,1,0,1,1988
Baek Hyeon-Man,Republic of Korea,0,1,0,1,1988
Grahame Cheney,Australia,0,1,0,1,1988
Anđelija Arbutina,Serbia,0,1,0,1,1988
Vesna Bajkuša,Bosnia and Herzegovina,0,1,0,1,1988
Polona Dornik,Slovenia,0,1,0,1,1988
Slađana Golić,Bosnia and Herzegovina,0,1,0,1,1988
Kornelija Kvesić,Croatia,0,1,0,1,1988
Mara Lakić,Bosnia and Herzegovina,0,1,0,1,1988
Žana Lelas,Croatia,0,1,0,1,1988
Bojana Milošević,Serbia,0,1,0,1,1988
Razija Mujanović,Bosnia and Herzegovina,0,1,0,1,1988
Danira Nakić,Croatia,0,1,0,1,1988
Stojna Vangelovska,North Macedonia,0,1,0,1,1988
Eleonora Vild,Serbia,0,1,0,1,1988
Franjo Arapović,Croatia,0,1,0,1,1988
Zoran Čutura,Croatia,0,1,0,1,1988
Danko Cvjetićanin,Croatia,0,1,0,1,1988
Vlade Divac,Serbia,0,1,0,1,1988
Toni Kukoč,Croatia,0,1,0,1,1988
Željko Obradović,Serbia,0,1,0,1,1988
Žarko Paspalj,Montenegro,0,1,0,1,1988
Dražen Petrović,Croatia,0,1,0,1,1988
Dino Rađa,Croatia,0,1,0,1,1988
Zdravko Radulović,Montenegro,0,1,0,1,1988
Stojko Vranković,Croatia,0,1,0,1,1988
Jure Zdovc,Slovenia,0,1,0,1,1988
Aleksandar Khristov,Bulgaria,0,1,0,1,1988
Daniel Dumitrescu,Romania,0,1,0,1,1988
George Cramne,Sweden,0,1,0,1,1988
Nurmagomed Shanavazov,Russian Federation,0,1,0,1,1988
Riddick Bowe,United States,0,1,0,1,1988
Michael Carbajal,United States,0,1,0,1,1988
"Roy Jones, Jr.",United States,0,1,0,1,1988
Grant Davies,Australia,0,1,0,1,1988
Jörg Schmidt,East Germany,0,1,0,1,1988
Ingo Spelly,East Germany,0,1,0,1,1988
Erika Géczi,Hungary,0,1,0,1,1988
Rita Kőbán,Hungary,0,1,0,1,1988
Erika Mészáros,Hungary,0,1,0,1,1988
Éva Rakusz,Hungary,0,1,0,1,1988
Michał Śliwiński,Poland,0,1,0,1,1988
Sergey Kirsanov,Soviet Union,0,1,0,1,1988
Aleksandr Motuzenko,Soviet Union,0,1,0,1,1988
Karen Straker-Dixon,Great Britain,0,1,0,1,1988
Lisa Jacquin,United States,0,1,0,1,1988
Anne Kursinski,United States,0,1,0,1,1988
Margit Otto-Crépin,France,0,1,0,1,1988
Joe Fargis,United States,0,1,0,1,1988
Otto Hofer,Switzerland,0,1,0,1,1988
Mark Phillips,Great Britain,0,1,0,1,1988
Daniel Ramseier,Switzerland,0,1,0,1,1988
Samuel Schatzmann,Switzerland,0,1,0,1,1988
Jutta Niehaus,Germany,0,1,0,1,1988
Steffen Blochwitz,East Germany,0,1,0,1,1988
Bernd Gröne,West Germany,0,1,0,1,1988
Joachim Halupczok,Poland,0,1,0,1,1988
Roland Hennig,East Germany,0,1,0,1,1988
Zenon Jaskuła,Poland,0,1,0,1,1988
Nikolay Kovsh,Russian Federation,0,1,0,1,1988
Marek Leśniewski,Poland,0,1,0,1,1988
Dirk Meier,East Germany,0,1,0,1,1988
Leo Peelen,Netherlands,0,1,0,1,1988
Andrzej Sypytkowski,Poland,0,1,0,1,1988
Martin Vinnicombe,Australia,0,1,0,1,1988
Carsten Wolf,East Germany,0,1,0,1,1988
Stefan Blöcher,West Germany,0,1,0,1,1988
Dirk Brinkmann,West Germany,0,1,0,1,1988
Thomas Brinkmann,West Germany,0,1,0,1,1988
Heiner Dopp,West Germany,0,1,0,1,1988
Hanns-Henning Fastrich,West Germany,0,1,0,1,1988
Carsten Fischer,Germany,0,1,0,1,1988
Tobias Frank,West Germany,0,1,0,1,1988
Volker Fried,Germany,0,1,0,1,1988
Michael Hilgers,Germany,0,1,0,1,1988
Uli Hänel,West Germany,0,1,0,1,1988
Andreas Keller,Germany,0,1,0,1,1988
Michael Metz,Germany,0,1,0,1,1988
Andreas Mollandin,West Germany,0,1,0,1,1988
Thomas Reck,West Germany,0,1,0,1,1988
Christian Schliemann,West Germany,0,1,0,1,1988
Ekkhard Schmidt-Opper,West Germany,0,1,0,1,1988
Jang Eun-Jeong,Republic of Korea,0,1,0,1,1988
Jo Gi-Hyang,Republic of Korea,0,1,0,1,1988
Choi Chun-Ok,Republic of Korea,0,1,0,1,1988
Jeong Eun-Gyeong,Republic of Korea,0,1,0,1,1988
Jeong Sang-Hyeon,Republic of Korea,0,1,0,1,1988
Han Geum-Sil,Republic of Korea,0,1,0,1,1988
Han Ok-Gyeong,Republic of Korea,0,1,0,1,1988
Hwang Geum-Suk,Republic of Korea,0,1,0,1,1988
Jin Won-Sim,Republic of Korea,0,1,0,1,1988
Kim Mi-Seon,Republic of Korea,0,1,0,1,1988
Kim Sun-Deok,Republic of Korea,0,1,0,1,1988
Kim Yeong-Suk,Republic of Korea,0,1,0,1,1988
Im Gye-Suk,Republic of Korea,0,1,0,1,1988
Park Sun-Ja,Republic of Korea,0,1,0,1,1988
Seo Hyo-Seon,Republic of Korea,0,1,0,1,1988
Seo Gwang-Mi,Republic of Korea,0,1,0,1,1988
Francesca Bortolozzi-Borella,Italy,0,1,0,1,1988
Annapia Gandolfi,Italy,0,1,0,1,1988
Lucia Traversa,Italy,0,1,0,1,1988
Dorina Vaccaroni,Italy,0,1,0,1,1988
Margherita Zalaffi,Italy,0,1,0,1,1988
Matthias Behr,West Germany,0,1,0,1,1988
Elmar Borrmann,Germany,0,1,0,1,1988
Thomas Endres,West Germany,0,1,0,1,1988
Volker Fischer,West Germany,0,1,0,1,1988
Thomas Gerull,West Germany,0,1,0,1,1988
Matthias Gey,West Germany,0,1,0,1,1988
Alexander Pusch,West Germany,0,1,0,1,1988
Ulrich Schreck,Germany,0,1,0,1,1988
Udo Wagner,East Germany,0,1,0,1,1988
Thorsten Weidner,Germany,0,1,0,1,1988
Janusz Olech,Poland,0,1,0,1,1988
Andrey Alshan,Russian Federation,0,1,0,1,1988
Mikhail Burtsev,Russian Federation,0,1,0,1,1988
Sergey Koryazhkin,Russian Federation,0,1,0,1,1988
Sergey Mindirgasov,Russian Federation,0,1,0,1,1988
Georgy Pogosov,Soviet Union,0,1,0,1,1988
Aloísio,Brazil,0,1,0,1,1988
Andrade,Brazil,0,1,0,1,1988
Edmar,Brazil,0,1,0,1,1988
André Cruz,Brazil,0,1,0,1,1988
Jorginho,Brazil,0,1,0,1,1988
Careca,Brazil,0,1,0,1,1988
Romário,Brazil,0,1,0,1,1988
Milton,Brazil,0,1,0,1,1988
João Paulo,Brazil,0,1,0,1,1988
Neto,Brazil,0,1,0,1,1988
Bebeto,Brazil,0,1,0,1,1988
Taffarel,Brazil,0,1,0,1,1988
Ademir,Brazil,0,1,0,1,1988
Batista,Brazil,0,1,0,1,1988
Geovani,Brazil,0,1,0,1,1988
Luís Carlos Winck,Brazil,0,1,0,1,1988
Adriana Dunavska,Bulgaria,0,1,0,1,1988
Aurelia Dobre,Romania,0,1,0,1,1988
Eugenia Golea,Romania,0,1,0,1,1988
Celestina Popa,Romania,0,1,0,1,1988
Camelia Voinea,Romania,0,1,0,1,1988
Ulf Hoffmann,East Germany,0,1,0,1,1988
Ralf Büchner,East Germany,0,1,0,1,1988
Andreas Wecker,East Germany,0,1,0,1,1988
Choi Seok-Jae,Republic of Korea,0,1,0,1,1988
Gang Jae-Won,Republic of Korea,0,1,0,1,1988
Kim Jae-Hwan,Republic of Korea,0,1,0,1,1988
Go Seok-Chang,Republic of Korea,0,1,0,1,1988
Lee Sang-Hyo,Republic of Korea,0,1,0,1,1988
Im Jin-Seok,Republic of Korea,0,1,0,1,1988
Oh Yong-Gi,Republic of Korea,0,1,0,1,1988
Park Do-Heon,Republic of Korea,0,1,0,1,1988
Park Yeong-Dae,Republic of Korea,0,1,0,1,1988
No Hyeon-Seok,Republic of Korea,0,1,0,1,1988
Sim Jae-Hong,Republic of Korea,0,1,0,1,1988
Sin Yeong-Seok,Republic of Korea,0,1,0,1,1988
Yun Tae-Il,Republic of Korea,0,1,0,1,1988
Kjerstin Andersen,Norway,0,1,0,1,1988
Berit Digre,Norway,0,1,0,1,1988
Marte Eliasson,Norway,0,1,0,1,1988
Trine Haltvik,Norway,0,1,0,1,1988
Hanne Hegh,Norway,0,1,0,1,1988
Hanne Hogness,Norway,0,1,0,1,1988
Vibeke Johnsen,Norway,0,1,0,1,1988
Kristin Midthun,Norway,0,1,0,1,1988
Karin Pettersen,Norway,0,1,0,1,1988
Karin Singstad,Norway,0,1,0,1,1988
Annette Skotvoll,Norway,0,1,0,1,1988
Ingrid Steen,Norway,0,1,0,1,1988
Heidi Sundal,Norway,0,1,0,1,1988
Cathrine Svendsen,Norway,0,1,0,1,1988
Kevin Asano,United States,0,1,0,1,1988
Sven Loll,East Germany,0,1,0,1,1988
Marc Meiling,West Germany,0,1,0,1,1988
Janusz Pawłowski,Poland,0,1,0,1,1988
Vladimir Shestakov,Russian Federation,0,1,0,1,1988
Henry Stöhr,East Germany,0,1,0,1,1988
Frank Wieneke,West Germany,0,1,0,1,1988
Daniele Masala,Italy,0,1,0,1,1988
Gianluca Tiberti,Italy,0,1,0,1,1988
Lalka Berberova,Bulgaria,0,1,0,1,1988
Radka Stoyanova,Bulgaria,0,1,0,1,1988
René Rensch,East Germany,0,1,0,1,1988
Mario Streit,East Germany,0,1,0,1,1988
Detlef Kirchhoff,East Germany,0,1,0,1,1988
Peter-Michael Kolbe,West Germany,0,1,0,1,1988
Lars Bjønnes,Norway,0,1,0,1,1988
Alf Hansen,Norway,0,1,0,1,1988
Rolf Thorsen,Norway,0,1,0,1,1988
Vetle Vinje,Norway,0,1,0,1,1988
Liliana Geneș,Romania,0,1,0,1,1988
Viorica Ilica,Romania,0,1,0,1,1988
Livia Țicanu,Romania,0,1,0,1,1988
Dănuț Dobre,Romania,0,1,0,1,1988
Marin Gheorghe,Romania,0,1,0,1,1988
Ladislau Lovrenschi,Romania,0,1,0,1,1988
Dragoș Neagu,Romania,0,1,0,1,1988
Dimitrie Popescu,Romania,0,1,0,1,1988
Valentin Robu,Romania,0,1,0,1,1988
Ioan Snep,Romania,0,1,0,1,1988
Vasile Tomoiagă,Romania,0,1,0,1,1988
Aleksandr Lukyanov,Russian Federation,0,1,0,1,1988
Ueli Bodenmann,Switzerland,0,1,0,1,1988
Beat Schwerzmann,Switzerland,0,1,0,1,1988
Inna Frolova,Soviet Union,0,1,0,1,1988
Svitlana Maziy,Soviet Union,0,1,0,1,1988
Irina Kalimbet,Soviet Union,0,1,0,1,1988
Antonina Makhina-Dumcheva-Zelikovich,Russian Federation,0,1,0,1,1988
Veniamin But,Russian Federation,0,1,0,1,1988
Viktor Diduk,Russian Federation,0,1,0,1,1988
Aleksandr Dumchev,Russian Federation,0,1,0,1,1988
Pavel Gurkovsky,Soviet Union,0,1,0,1,1988
Nikolay Komarov,Soviet Union,0,1,0,1,1988
Viktor Omelyanovich,Soviet Union,0,1,0,1,1988
Vasily Tikhonov,Russian Federation,0,1,0,1,1988
Andrey Vasilyev,Russian Federation,0,1,0,1,1988
Anne Marden,United States,0,1,0,1,1988
Tom Bohrer,United States,0,1,0,1,1988
"Richard Kennelly, Jr.",United States,0,1,0,1,1988
Dave Krmpotich,United States,0,1,0,1,1988
"Raoul Rodriguez, Jr.",United States,0,1,0,1,1988
Vesela Lecheva,Bulgaria,0,1,0,1,1988
Alfonso de Iruarrízaga,Chile,0,1,0,1,1988
Huang Shiping,People's Republic of China,0,1,0,1,1988
Nicolas Berthelot,France,0,1,0,1,1988
Alister Allan,Great Britain,0,1,0,1,1988
Ralf Schumann,East Germany,0,1,0,1,1988
Michiko Hasegawa-Fukushima,Japan,0,1,0,1,1988
Cha Yeong-Cheol,Republic of Korea,0,1,0,1,1988
Ragnar Skanåker,Sweden,0,1,0,1,1988
Miloslav Bednařík,Czech Republic,0,1,0,1,1988
Erich Buljung,United States,0,1,0,1,1988
Victor Davis,Canada,0,1,0,1,1988
Sandy Goss,Canada,0,1,0,1,1988
Tom Ponting,Canada,0,1,0,1,1988
Mark Tewksbury,Canada,0,1,0,1,1988
Huang Xiaomin,People's Republic of China,0,1,0,1,1988
Li Qing,People's Republic of China,0,1,0,1,1988
Yang Wenyi,People's Republic of China,0,1,0,1,1988
Zhuang Yong,People's Republic of China,0,1,0,1,1988
Tan Liangde,People's Republic of China,0,1,0,1,1988
Xiong Ni,People's Republic of China,0,1,0,1,1988
Sylvia Poll,Costa Rica,0,1,0,1,1988
Benny Nielsen,Denmark,0,1,0,1,1988
Nick Gillingham,Great Britain,0,1,0,1,1988
Astrid Strauß,East Germany,0,1,0,1,1988
Kathrin Zimmermann,East Germany,0,1,0,1,1988
Frank Baltrusch,East Germany,0,1,0,1,1988
Sven Lodziewski,East Germany,0,1,0,1,1988
Patrick Kühl,East Germany,0,1,0,1,1988
Károly Güttler,Hungary,0,1,0,1,1988
Raimundas Mažuolis,Lithuania,0,1,0,1,1988
Karin Brienesse,Netherlands,0,1,0,1,1988
Marianne Muis,Netherlands,0,1,0,1,1988
Mildred Muis,Netherlands,0,1,0,1,1988
Conny van Bentum,Netherlands,0,1,0,1,1988
Diane van der Plaats,Netherlands,0,1,0,1,1988
Anders Holmertz,Sweden,0,1,0,1,1988
Yelena Dendeberova,Russian Federation,0,1,0,1,1988
Iurie Başcatov,Republic of Moldova,0,1,0,1,1988
Aleksey Borislavsky,Soviet Union,0,1,0,1,1988
Vladimir Tkachenko,Soviet Union,0,1,0,1,1988
Beth Barr,United States,0,1,0,1,1988
Janel Jorgensen,United States,0,1,0,1,1988
Karen Josephson,United States,0,1,0,1,1988
Sarah Josephson,United States,0,1,0,1,1988
Tracey McFarlane,United States,0,1,0,1,1988
Betsy Mitchell,United States,0,1,0,1,1988
Michele Mitchell,United States,0,1,0,1,1988
Tracie Ruiz-Conforto,United States,0,1,0,1,1988
Dave Wharton,United States,0,1,0,1,1988
Luisa Cervera,Peru,0,1,0,1,1988
Alejandra de la Guerra,Peru,0,1,0,1,1988
Denisse Fajardo,Peru,0,1,0,1,1988
Miriam Gallardo,Peru,0,1,0,1,1988
Rosa García,Peru,0,1,0,1,1988
Sonia Heredia,Peru,0,1,0,1,1988
Natalia Málaga,Peru,0,1,0,1,1988
Gaby Pérez,Peru,0,1,0,1,1988
Cecilia Tait,Peru,0,1,0,1,1988
Gina Torrealva,Peru,0,1,0,1,1988
Cenaida Uribe,Peru,0,1,0,1,1988
Yaroslav Antonov,Russian Federation,0,1,0,1,1988
Yevgeny Krasilnikov,Russian Federation,0,1,0,1,1988
Andrey Kuznetsov,Russian Federation,0,1,0,1,1988
Valery Losev,Russian Federation,0,1,0,1,1988
Yury Panchenko,Soviet Union,0,1,0,1,1988
Igor Runov,Russian Federation,0,1,0,1,1988
Yury Sapega,Russian Federation,0,1,0,1,1988
Vladimir Shkurikhin,Russian Federation,0,1,0,1,1988
Aleksandr Sorokolet,Soviet Union,0,1,0,1,1988
Yury Cherednik,Russian Federation,0,1,0,1,1988
Raimonds Vilde,Latvia,0,1,0,1,1988
Vyacheslav Zaytsev,Russian Federation,0,1,0,1,1988
James Bergeson,United States,0,1,0,1,1988
Greg Boyer,United States,0,1,0,1,1988
Peter Campbell,United States,0,1,0,1,1988
Jeff Campbell,United States,0,1,0,1,1988
Jody Campbell,United States,0,1,0,1,1988
Chris Duplanty,United States,0,1,0,1,1988
Mike Evans,United States,0,1,0,1,1988
Doug Kimbell,United States,0,1,0,1,1988
Craig Klass,United States,0,1,0,1,1988
Alan Mouchawar,United States,0,1,0,1,1988
Kevin Robertson,United States,0,1,0,1,1988
Terry Schroeder,United States,0,1,0,1,1988
Craig Wilson,United States,0,1,0,1,1988
Israel Militosyan,Armenia,0,1,0,1,1988
Stefan Topurov,Bulgaria,0,1,0,1,1988
He Yingqiang,People's Republic of China,0,1,0,1,1988
Manfred Nerlinger,Germany,0,1,0,1,1988
Ingo Steinhöfel,East Germany,0,1,0,1,1988
József Jacsó,Hungary,0,1,0,1,1988
István Messzi,Hungary,0,1,0,1,1988
Jeon Byeong-Gwan,Republic of Korea,0,1,0,1,1988
Nicu Vlad,Romania,0,1,0,1,1988
Nail Mukhamedyarov,Soviet Union,0,1,0,1,1988
Stoyan Balov,Bulgaria,0,1,0,1,1988
Rangel Gerovski,Bulgaria,0,1,0,1,1988
Ivan Tsonov,Bulgaria,0,1,0,1,1988
Zhivko Vangelov,Bulgaria,0,1,0,1,1988
Harri Koskela,Finland,0,1,0,1,1988
Gerhard Himmel,West Germany,0,1,0,1,1988
Tibor Komáromi,Hungary,0,1,0,1,1988
Asgari Mohammadian,Islamic Republic of Iran,0,1,0,1,1988
Atsuji Miyahara,Japan,0,1,0,1,1988
Akira Ota,Japan,0,1,0,1,1988
Daulet Turlykhanov,Kazakhstan,0,1,0,1,1988
Kim Seong-Mun,Republic of Korea,0,1,0,1,1988
Park Jang-Sun,Republic of Korea,0,1,0,1,1988
Šaban Trstena,North Macedonia,0,1,0,1,1988
Andrzej Głąb,Poland,0,1,0,1,1988
Leri Khabelovi,Georgia,0,1,0,1,1988
Necmi Gençalp,Turkey,0,1,0,1,1988
Stepan Sargsyan,Armenia,0,1,0,1,1988
Adlan Varayev,Russian Federation,0,1,0,1,1988
Bruce Baumgartner,United States,0,1,0,1,1988
Birgitta Bengtsson,Sweden,0,1,0,1,1988
Marit Söderström,Sweden,0,1,0,1,1988
Will Baylis,United States,0,1,0,1,1988
Bob Billingham,United States,0,1,0,1,1988
Erik Bjørkum,Norway,0,1,0,1,1988
Jan Boersma,Netherlands Antilles,0,1,0,1,1988
Hal Haenel,United States,0,1,0,1,1988
Peter Holmberg,United States Virgin Islands,0,1,0,1,1988
John Kostecki,United States,0,1,0,1,1988
Ole Petter Pollen,Norway,0,1,0,1,1988
Mark Reynolds,United States,0,1,0,1,1988
Rex Sellers,New Zealand,0,1,0,1,1988
Chris Timms,New Zealand,0,1,0,1,1988
Toomas Tõniste,Estonia,0,1,0,1,1988
Tõnu Tõniste,Estonia,0,1,0,1,1988
Lisa Martin-Ondieki,Australia,0,1,0,1,1988
Joaquim Cruz,Brazil,0,1,0,1,1988
Stefka Kostadinova,Bulgaria,0,1,0,1,1988
Jan Železný,Czech Republic,0,1,0,1,1988
Liz McColgan,Great Britain,0,1,0,1,1988
Fatima Whitbread,Great Britain,0,1,0,1,1988
Elliot Bunney,Great Britain,0,1,0,1,1988
Peter Elliott,Great Britain,0,1,0,1,1988
Colin Jackson,Great Britain,0,1,0,1,1988
Mike McFarlane,Great Britain,0,1,0,1,1988
John Regis,Great Britain,0,1,0,1,1988
Ingrid Auerswald-Lange,East Germany,0,1,0,1,1988
Kerstin Behrendt,East Germany,0,1,0,1,1988
Diana Gansky,East Germany,0,1,0,1,1988
Silke Möller,East Germany,0,1,0,1,1988
Sabine John,East Germany,0,1,0,1,1988
Gloria Siebert,East Germany,0,1,0,1,1988
Marlies Oelsner-Göhr,East Germany,0,1,0,1,1988
Torsten Voss,East Germany,0,1,0,1,1988
Kathrin Neimke,East Germany,0,1,0,1,1988
Christine Wachtel,East Germany,0,1,0,1,1988
Dieter Baumann,Germany,0,1,0,1,1988
Salvatore Antibo,Italy,0,1,0,1,1988
Grace Jackson-Small,Jamaica,0,1,0,1,1988
Bert Cameron,Jamaica,0,1,0,1,1988
Howard Davis,Jamaica,0,1,0,1,1988
Winthrop Graham,Jamaica,0,1,0,1,1988
Devon Morris,Jamaica,0,1,0,1,1988
Peter Koech,Kenya,0,1,0,1,1988
Douglas Wakiihuri,Kenya,0,1,0,1,1988
Romas Ubartas,Lithuania,0,1,0,1,1988
Amadou Dia Bâ,Senegal,0,1,0,1,1988
Laimutė Baikauskaitė,Lithuania,0,1,0,1,1988
Rodion Gataullin,Russian Federation,0,1,0,1,1988
Igor Lapshin,Belarus,0,1,0,1,1988
Yury Sedykh,Soviet Union,0,1,0,1,1988
Valerie Brisco-Hooks,United States,0,1,0,1,1988
Diane Dixon,United States,0,1,0,1,1988
Sherri Howard,United States,0,1,0,1,1988
Denean Howard-Hill,United States,0,1,0,1,1988
Lillie Leatherwood,United States,0,1,0,1,1988
Randy Barnes,United States,0,1,0,1,1988
Hollis Conway,United States,0,1,0,1,1988
Mike Powell,United States,0,1,0,1,1988
Christa Rothenburger-Luding,East Germany,0,1,0,1,1988
Uwe Preißler,East Germany,0,1,0,1,1988
Kathy Horny,Peru,0,1,0,1,1988
Stefan Edberg,Sweden,0,0,2,2,1988
André Wohllebe,East Germany,0,0,2,2,1988
Giovanni Scalzo,Italy,0,0,2,2,1988
Andrey Shuvalov,Russian Federation,0,0,2,2,1988
Yukio Iketani,Japan,0,0,2,2,1988
Mikako Kotani,Japan,0,0,2,2,1988
Vadim Yaroshchuk,Soviet Union,0,0,2,2,1988
Dmitry Volkov,Russian Federation,0,0,2,2,1988
Jill Sterkel,United States,0,0,2,2,1988
Claudia Kohde-Kilsch,West Germany,0,0,1,1,1988
Steven Hallard,Great Britain,0,0,1,1,1988
Richard Priestman,Great Britain,0,0,1,1,1988
Leroy Watson,Great Britain,0,0,1,1,1988
Liz Smylie,Australia,0,0,1,1,1988
Wendy Turnbull,Australia,0,0,1,1,1988
An Jae-Hyeong,Republic of Korea,0,0,1,1,1988
Ray Downey,Canada,0,0,1,1,1988
Jorge Julio,Colombia,0,0,1,1,1988
Vladimir Yesheyev,Russian Federation,0,0,1,1,1988
Debra Ochs,United States,0,0,1,1,1988
Denise Parker,United States,0,0,1,1,1988
Melanie Skillman,United States,0,0,1,1,1988
Manuela Maleeva-Fragnière,Bulgaria,0,0,1,1,1988
Anders Järryd,Sweden,0,0,1,1,1988
Erik Lindh,Sweden,0,0,1,1,1988
Milan Šrejber,Czech Republic,0,0,1,1,1988
Brad Gilbert,United States,0,0,1,1,1988
Jasna Fazlić-Reed,Individual Olympic Athletes,0,0,1,1,1988
Gordana Perkučin,Individual Olympic Athletes,0,0,1,1,1988
Richie Woodhall,Great Britain,0,0,1,1,1988
Reiner Gies,West Germany,0,0,1,1,1988
Róbert Isaszegi,Hungary,0,0,1,1,1988
Chris Sande,Kenya,0,0,1,1,1988
Lee Jae-Hyeok,Republic of Korea,0,0,1,1,1988
Abdel Hak Achik,Morocco,0,0,1,1,1988
Mario González,Mexico,0,0,1,1,1988
Nergüin Enkhbat,Mongolia,0,0,1,1,1988
Arnold Vanderlijde,Netherlands,0,0,1,1,1988
Syed Hussain Shah,Pakistan,0,0,1,1,1988
Olesya Barel,Russian Federation,0,0,1,1,1988
Olga Buryakina,Russian Federation,0,0,1,1,1988
Irina Gerlits,Kazakhstan,0,0,1,1,1988
Olga Yakovleva,Russian Federation,0,0,1,1,1988
Olga Yevkova,Russian Federation,0,0,1,1,1988
Yelena Khudashova,Russian Federation,0,0,1,1,1988
Aleksandra Leonova,Russian Federation,0,0,1,1,1988
Irina Minkh,Russian Federation,0,0,1,1,1988
Galina Savitskaya,Belarus,0,0,1,1,1988
Irina Sumnikova,Russian Federation,0,0,1,1,1988
Vitalija Tuomaitė,Lithuania,0,0,1,1,1988
Nataliya Zasulskaya,Russian Federation,0,0,1,1,1988
Willie Anderson,United States,0,0,1,1,1988
Stacey Augmon,United States,0,0,1,1,1988
Bimbo Coles,United States,0,0,1,1,1988
Jeff Grayer,United States,0,0,1,1,1988
Hersey Hawkins,United States,0,0,1,1,1988
Dan Majerle,United States,0,0,1,1,1988
Danny Manning,United States,0,0,1,1,1988
J. R. Reid,United States,0,0,1,1,1988
Mitch Richmond,United States,0,0,1,1,1988
David Robinson,United States,0,0,1,1,1988
Charles D. Smith,United States,0,0,1,1,1988
"Charles E. Smith, IV",United States,0,0,1,1,1988
Leopoldo Serantes,Philippines,0,0,1,1,1988
Jan Dydak,Poland,0,0,1,1,1988
Andrzej Gołota,Poland,0,0,1,1,1988
Henryk Petrich,Poland,0,0,1,1,1988
Janusz Zarenkiewicz,Poland,0,0,1,1,1988
Lars Myrberg,Sweden,0,0,1,1,1988
Phajol Moolsan,Thailand,0,0,1,1,1988
Alex Miroshnichenko,Kazakhstan,0,0,1,1,1988
Timofei Scriabin,Republic of Moldova,0,0,1,1,1988
Romallis Ellis,United States,0,0,1,1,1988
Kenny Gould,United States,0,0,1,1,1988
Damir Škaro,Croatia,0,0,1,1,1988
Peter Foster,Australia,0,0,1,1,1988
Kelvin Graham,Australia,0,0,1,1,1988
Borislava Ivanova,Bulgaria,0,0,1,1,1988
Ognyana Petrova,Bulgaria,0,0,1,1,1988
Nikolay Bukhalov,Bulgaria,0,0,1,1,1988
Martin Marinov,Australia,0,0,1,1,1988
Joël Bettin,France,0,0,1,1,1988
Philippe Renaud,France,0,0,1,1,1988
Hans-Jörg Bliesener,East Germany,0,0,1,1,1988
Kay Bluhm,East Germany,0,0,1,1,1988
Anna Cox-Wood,Australia,0,0,1,1,1988
Annemiek Derckx,Netherlands,0,0,1,1,1988
Izabela Dylewska-Światowiak,Poland,0,0,1,1,1988
Marges Knighton,New Zealand,0,0,1,1,1988
Cindy Neale-Ishoy,Canada,0,0,1,1,1988
Ashley Nicoll-Holzer,Canada,0,0,1,1,1988
Tinks Pottinger,New Zealand,0,0,1,1,1988
Eva-Maria Pracht,Canada,0,0,1,1,1988
Gina Smith,Canada,0,0,1,1,1988
Andrew Bennie,New Zealand,0,0,1,1,1988
Hubert Bourdy,France,0,0,1,1,1988
Frédéric Cottier,France,0,0,1,1,1988
Karsten Huck,West Germany,0,0,1,1,1988
Michel Robert,France,0,0,1,1,1988
Laima Zilporytė,Lithuania,0,0,1,1,1988
Bernd Dittert,East Germany,0,0,1,1,1988
Brett Dutton,Australia,0,0,1,1,1988
Marat Ganeyev,Russian Federation,0,0,1,1,1988
Christian Henn,West Germany,0,0,1,1,1988
Anders Jarl,Sweden,0,0,1,1,1988
Björn Johansson,Sweden,0,0,1,1,1988
Jan Karlsson,Sweden,0,0,1,1,1988
Michel Lafis,Sweden,0,0,1,1,1988
Robert Lechner,West Germany,0,0,1,1,1988
Wayne McCarney,Australia,0,0,1,1,1988
Stephen McGlede,Australia,0,0,1,1,1988
Scott McGrory,Australia,0,0,1,1,1988
Gary Neiwand,Australia,0,0,1,1,1988
Carina Benninga,Netherlands,0,0,1,1,1988
Marjolein Bolhuis-Eijsvogel,Netherlands,0,0,1,1,1988
Yvonne Buter,Netherlands,0,0,1,1,1988
Det de Beus,Netherlands,0,0,1,1,1988
Annemieke Fokke,Netherlands,0,0,1,1,1988
Noor Holsboer,Netherlands,0,0,1,1,1988
Lisanne Lejeune,Netherlands,0,0,1,1,1988
Helen Lejeune-van der Ben,Netherlands,0,0,1,1,1988
Anneloes Nieuwenhuizen,Netherlands,0,0,1,1,1988
Martine Ohr,Netherlands,0,0,1,1,1988
Marieke van Doorn,Netherlands,0,0,1,1,1988
Aletta van Manen,Netherlands,0,0,1,1,1988
Sophie von Weiler,Netherlands,0,0,1,1,1988
Laurien Willemse,Netherlands,0,0,1,1,1988
Ingrid Wolff,Netherlands,0,0,1,1,1988
Willemien Aardenburg,Netherlands,0,0,1,1,1988
Marc Benninga,Netherlands,0,0,1,1,1988
Floris Jan Bovelander,Netherlands,0,0,1,1,1988
Jacques Brinkman,Netherlands,0,0,1,1,1988
Maurits Crucq,Netherlands,0,0,1,1,1988
Marc Delissen,Netherlands,0,0,1,1,1988
Cees Jan Diepeveen,Netherlands,0,0,1,1,1988
Patrick Faber,Netherlands,0,0,1,1,1988
Ronald Jansen,Netherlands,0,0,1,1,1988
René Klaassen,Netherlands,0,0,1,1,1988
Hendrik Jan Kooijman,Netherlands,0,0,1,1,1988
Hidde Kruize,Netherlands,0,0,1,1,1988
Frank Leistra,Netherlands,0,0,1,1,1988
Erik Parlevliet,Netherlands,0,0,1,1,1988
Gert Jan Schlatmann,Netherlands,0,0,1,1,1988
Tim Steens,Netherlands,0,0,1,1,1988
Taco van den Honert,Netherlands,0,0,1,1,1988
Zsuzsa Jánosi-Németh,Hungary,0,0,1,1,1988
Edit Kovács,Hungary,0,0,1,1,1988
Gertrúd Stefanek,Hungary,0,0,1,1,1988
Zsuzsa Szőcs,Hungary,0,0,1,1,1988
Katalin Tuschák,Hungary,0,0,1,1,1988
Wladimir Reznitschenko,Germany,0,0,1,1,1988
István Busa,Hungary,0,0,1,1,1988
Zsolt Érsek,Hungary,0,0,1,1,1988
Róbert Gátai,Hungary,0,0,1,1,1988
Pál Szekeres,Hungary,0,0,1,1,1988
István Szelei,Hungary,0,0,1,1,1988
Massimo Cavaliere,Italy,0,0,1,1,1988
Gianfranco Dalla Barba,Italy,0,0,1,1,1988
Marco Marin,Italy,0,0,1,1,1988
Ferdinando Meglio,Italy,0,0,1,1,1988
Pavel Kolobkov,Russian Federation,0,0,1,1,1988
Igor Tikhomirov,Canada,0,0,1,1,1988
Mikhail Tishko,Soviet Union,0,0,1,1,1988
Rudi Bommer,West Germany,0,0,1,1,1988
Holger Fach,West Germany,0,0,1,1,1988
Wolfgang Funkel,West Germany,0,0,1,1,1988
Roland Grahammer,West Germany,0,0,1,1,1988
Armin Görtz,West Germany,0,0,1,1,1988
Thomas Häßler,West Germany,0,0,1,1,1988
Thomas Hörster,West Germany,0,0,1,1,1988
Olaf Janßen,West Germany,0,0,1,1,1988
Uwe Kamps,West Germany,0,0,1,1,1988
Gerhard Kleppinger,West Germany,0,0,1,1,1988
Jürgen Klinsmann,West Germany,0,0,1,1,1988
Frank Mill,West Germany,0,0,1,1,1988
Karl-Heinz Riedle,West Germany,0,0,1,1,1988
Christian Schreier,West Germany,0,0,1,1,1988
Michael Schulz,West Germany,0,0,1,1,1988
Ralf Sievers,West Germany,0,0,1,1,1988
Fritz Walter,West Germany,0,0,1,1,1988
Wolfram Wuttke,West Germany,0,0,1,1,1988
Diana Dudeva,Bulgaria,0,0,1,1,1988
Gabi Fähnrich,East Germany,0,0,1,1,1988
Martina Jentsch,East Germany,0,0,1,1,1988
Ulrike Klotz,East Germany,0,0,1,1,1988
Bettina Schieferdecker,East Germany,0,0,1,1,1988
Dörte Thümmler,East Germany,0,0,1,1,1988
Aleksandra Timoshenko,Soviet Union,0,0,1,1,1988
Phoebe Mills,United States,0,0,1,1,1988
Hiroyuki Konishi,Japan,0,0,1,1,1988
Koichi Mizushima,Japan,0,0,1,1,1988
Daisuke Nishikawa,Japan,0,0,1,1,1988
Toshiharu Sato,Japan,0,0,1,1,1988
Takahiro Yamada,Japan,0,0,1,1,1988
Park Jong-Hun,Republic of Korea,0,0,1,1,1988
Marius Gherman,Romania,0,0,1,1,1988
Natalia Rusnatschenko,Austria,0,0,1,1,1988
Alvaro Načinović,Croatia,0,0,1,1,1988
Goran Perkovac,Croatia,0,0,1,1,1988
Iztok Puc,Croatia,0,0,1,1,1988
Zlatan Saračević,Croatia,0,0,1,1,1988
Nataliya Anisimova,Russian Federation,0,0,1,1,1988
Marina Bazanova,Soviet Union,0,0,1,1,1988
Tatjana Dschandschgawa,Austria,0,0,1,1,1988
Tatyana Gorb,Soviet Union,0,0,1,1,1988
Elina Guseva,Russian Federation,0,0,1,1,1988
Larisa Karlova,Soviet Union,0,0,1,1,1988
Nataliya Lapitskaya,Russian Federation,0,0,1,1,1988
Svetlana Mankova,Soviet Union,0,0,1,1,1988
Nataliya Mitryuk,Soviet Union,0,0,1,1,1988
Nataliya Morskova,Russian Federation,0,0,1,1,1988
Yelena Nemashkalo,Soviet Union,0,0,1,1,1988
Olga Semyonova,Soviet Union,0,0,1,1,1988
Yevgeniya Tovstogan,Soviet Union,0,0,1,1,1988
Zinaida Turchina,Soviet Union,0,0,1,1,1988
Mirko Bašić,Croatia,0,0,1,1,1988
Jožef Holpert,Serbia,0,0,1,1,1988
Boris Jarak,Croatia,0,0,1,1,1988
Slobodan Kuzmanovski,Serbia,0,0,1,1,1988
Muhamed Memić,Bosnia and Herzegovina,0,0,1,1,1988
Zlatko Portner,Serbia,0,0,1,1,1988
Rolando Pušnik,Slovenia,0,0,1,1,1988
Momir Rnić,Serbia,0,0,1,1,1988
Irfan Smajlagić,Croatia,0,0,1,1,1988
Ermin Velić,Bosnia and Herzegovina,0,0,1,1,1988
Veselin Vujović,Montenegro,0,0,1,1,1988
Torsten Bréchôt,East Germany,0,0,1,1,1988
Bruno Carabetta,France,0,0,1,1,1988
Jo Yong-Cheol,Republic of Korea,0,0,1,1,1988
Shinji Hosokawa,Japan,0,0,1,1,1988
Akinobu Osako,Japan,0,0,1,1,1988
Ben Spijkers,Netherlands,0,0,1,1,1988
Dennis Stewart,Great Britain,0,0,1,1,1988
Mike Swain,United States,0,0,1,1,1988
Giorgi Tenadze,Georgia,0,0,1,1,1988
Amiran T'ot'ik'ashvili,Georgia,0,0,1,1,1988
Robert Van de Walle,Belgium,0,0,1,1,1988
Bashir Varayev,Russian Federation,0,0,1,1,1988
Grigory Verichev,Russian Federation,0,0,1,1,1988
Yosuke Yamamoto,Japan,0,0,1,1,1988
Graham Brookhouse,Great Britain,0,0,1,1,1988
Dominic Mahony,Great Britain,0,0,1,1,1988
Richard Phelps,Great Britain,0,0,1,1,1988
Vaho Iagorashvili,Georgia,0,0,1,1,1988
Magdalena Georgieva,Bulgaria,0,0,1,1,1988
Stefka Madina,Bulgaria,0,0,1,1,1988
Violeta Ninova-Yordanova,Bulgaria,0,0,1,1,1988
Han Yaqin,People's Republic of China,0,0,1,1,1988
He Yanwen,People's Republic of China,0,0,1,1,1988
Zhang Yali,People's Republic of China,0,0,1,1,1988
Zhou Xiuhua,People's Republic of China,0,0,1,1,1988
Patrick Sweeney,Great Britain,0,0,1,1,1988
Steffen Bogs,East Germany,0,0,1,1,1988
Heiko Habermann,East Germany,0,0,1,1,1988
Steffen Zühlke,East Germany,0,0,1,1,1988
Guido Grabow,West Germany,0,0,1,1,1988
Volker Grabow,West Germany,0,0,1,1,1988
Norbert Keßlau,West Germany,0,0,1,1,1988
Jens Köppen,East Germany,0,0,1,1,1988
Jörg Puttlitz,West Germany,0,0,1,1,1988
Lynley Hannen,New Zealand,0,0,1,1,1988
Nikki Payne,New Zealand,0,0,1,1,1988
Andrew Bird,New Zealand,0,0,1,1,1988
Greg Johnston,New Zealand,0,0,1,1,1988
George Keys,New Zealand,0,0,1,1,1988
Eric Verdonk,New Zealand,0,0,1,1,1988
Chris White,New Zealand,0,0,1,1,1988
Ian Wright,New Zealand,0,0,1,1,1988
Anișoara Bălan-Dobre,Romania,0,0,1,1,1988
Doina Ciucanu-Robu,Romania,0,0,1,1,1988
Anișoara Sorohan-Minea,Romania,0,0,1,1,1988
Sadik Mujkič,Slovenia,0,0,1,1,1988
Oleksandr Marchenko,Soviet Union,0,0,1,1,1988
Vasily Yakusha,Belarus,0,0,1,1,1988
Seth Bauer,United States,0,0,1,1,1988
Doug Burden,United States,0,0,1,1,1988
Jeff McLaughlin,United States,0,0,1,1,1988
Peter Nordell,United States,0,0,1,1,1988
Ted Patton,United States,0,0,1,1,1988
John Pescatore,United States,0,0,1,1,1988
"Jack Rusher, IV",United States,0,0,1,1,1988
Jon Smith,United States,0,0,1,1,1988
Mike Teti,United States,0,0,1,1,1988
Bojan Prešern,Slovenia,0,0,1,1,1988
Frans Peeters,Belgium,0,0,1,1,1988
Ihar Basinski,Belarus,0,0,1,1,1988
Xu Haifeng,People's Republic of China,0,0,1,1,1988
Jorge Guardiola,Spain,0,0,1,1,1988
Hans Riederer,Germany,0,0,1,1,1988
Zoltán Kovács,Hungary,0,0,1,1,1988
Attila Záhonyi,Hungary,0,0,1,1,1988
Marina Dobrancheva-Logvinenko,Russian Federation,0,0,1,1,1988
Anna Malukhina,Russian Federation,0,0,1,1,1988
Hennadiy Avramenko,Soviet Union,0,0,1,1,1988
Valentina Cherkasova,Russian Federation,0,0,1,1,1988
Kirill Ivanov,Russian Federation,0,0,1,1,1988
Julie M. McDonald,Australia,0,0,1,1,1988
Keltie Duggan,Canada,0,0,1,1,1988
Allison Higson,Canada,0,0,1,1,1988
Jane Kerr,Canada,0,0,1,1,1988
Lori Melien,Canada,0,0,1,1,1988
Patricia Noall,Canada,0,0,1,1,1988
Andrea Nugent,Canada,0,0,1,1,1988
Qian Hong,People's Republic of China,0,0,1,1,1988
Li Deliang,People's Republic of China,0,0,1,1,1988
Sergio López,Spain,0,0,1,1,1988
Catherine Plewinski,France,0,0,1,1,1988
Stéphan Caron,France,0,0,1,1,1988
Andy Jameson,Great Britain,0,0,1,1,1988
Anke Möhring,East Germany,0,0,1,1,1988
Thomas Fahrner,West Germany,0,0,1,1,1988
Rainer Henkel,West Germany,0,0,1,1,1988
Erik Hochstein,West Germany,0,0,1,1,1988
Dirk Richter,East Germany,0,0,1,1,1988
Peter Sitt,Germany,0,0,1,1,1988
Stefano Battistelli,Italy,0,0,1,1,1988
Miyako Tanaka,Japan,0,0,1,1,1988
Jesús Mena,Mexico,0,0,1,1,1988
Paul Kingsman,New Zealand,0,0,1,1,1988
Anthony Mosse,New Zealand,0,0,1,1,1988
Artur Wojdat,Poland,0,0,1,1,1988
Valery Lozik,Soviet Union,0,0,1,1,1988
Konstantin Petrov,Kazakhstan,0,0,1,1,1988
Sergey Zabolotnov,Soviet Union,0,0,1,1,1988
Mitzi Kremer,United States,0,0,1,1,1988
Kelly McCormick,United States,0,0,1,1,1988
Laura Walker,United States,0,0,1,1,1988
Paige Zemina,United States,0,0,1,1,1988
Daniel Castellani,Argentina,0,0,1,1,1988
Daniel Colla,Argentina,0,0,1,1,1988
Hugo Conte,Argentina,0,0,1,1,1988
Juan Carlos Cuminetti,Argentina,0,0,1,1,1988
José De Palma,Argentina,0,0,1,1,1988
Alejandro Diz,Argentina,0,0,1,1,1988
Waldo Kantor,Argentina,0,0,1,1,1988
Eduardo Martínez,Argentina,0,0,1,1,1988
Raúl Quiroga,Argentina,0,0,1,1,1988
Jon Emili Uriarte,Argentina,0,0,1,1,1988
Carlos Weber,Argentina,0,0,1,1,1988
Claudio Zulianello,Argentina,0,0,1,1,1988
Cui Yongmei,People's Republic of China,0,0,1,1,1988
Hou Yuzhu,People's Republic of China,0,0,1,1,1988
Jiang Ying,People's Republic of China,0,0,1,1,1988
Li Guojun,People's Republic of China,0,0,1,1,1988
Li Yueming,People's Republic of China,0,0,1,1,1988
Su Huijuan,People's Republic of China,0,0,1,1,1988
Wu Dan,People's Republic of China,0,0,1,1,1988
Yang Xiaojun,People's Republic of China,0,0,1,1,1988
Yang Xilan,People's Republic of China,0,0,1,1,1988
Zheng Meizhu,People's Republic of China,0,0,1,1,1988
Dmitry Apanasenko,Russian Federation,0,0,1,1,1988
Viktor Berendyuga,Soviet Union,0,0,1,1,1988
Mikheil Giorgadze,Georgia,0,0,1,1,1988
Yevgeny Grishin,Russian Federation,0,0,1,1,1988
Mikhail Ivanov,Russian Federation,0,0,1,1,1988
Aleksandr Kolotov,Russian Federation,0,0,1,1,1988
Sergey Kotenko,Kazakhstan,0,0,1,1,1988
Serghei Marcoci,Republic of Moldova,0,0,1,1,1988
Nurlan Mendygaliyev,Kazakhstan,0,0,1,1,1988
Giorgi Mshvenieradze,Georgia,0,0,1,1,1988
Sergey Naumov,Russian Federation,0,0,1,1,1988
Yevgeny Sharonov,Russian Federation,0,0,1,1,1988
Nikolay Smirnov,Soviet Union,0,0,1,1,1988
Aleksandar Varbanov,Bulgaria,0,0,1,1,1988
He Zhuoqiang,People's Republic of China,0,0,1,1,1988
Li Jinhe,People's Republic of China,0,0,1,1,1988
Liu Shoubin,People's Republic of China,0,0,1,1,1988
Ye Huanming,People's Republic of China,0,0,1,1,1988
Peter Immesberger,West Germany,0,0,1,1,1988
Ronny Weller,East Germany,0,0,1,1,1988
Martin Zawieja,Germany,0,0,1,1,1988
Lee Hyeong-Geun,Republic of Korea,0,0,1,1,1988
Sławomir Zawada,Poland,0,0,1,1,1988
Rakhmat Sofiadi,Bulgaria,0,0,1,1,1988
Bratan Tsenov,Bulgaria,0,0,1,1,1988
Simeon Shterev,Bulgaria,0,0,1,1,1988
Tapio Sipilä,Finland,0,0,1,1,1988
Andreas Schröder,East Germany,0,0,1,1,1988
Babis Kholidis,Greece,0,0,1,1,1988
An Dae-Hyeon,Republic of Korea,0,0,1,1,1988
Kim Sang-Gyu,Republic of Korea,0,0,1,1,1988
Kim Tae-U,Republic of Korea,0,0,1,1,1988
Lee Jae-Seok,Republic of Korea,0,0,1,1,1988
No Gyeong-Seon,Republic of Korea,0,0,1,1,1988
Józef Tracz,Poland,0,0,1,1,1988
Jozef Lohyňa,Czechoslovakia,0,0,1,1,1988
Tomas Johansson,Sweden,0,0,1,1,1988
Volodymyr Tohuzov,Soviet Union,0,0,1,1,1988
Sergey Karamchakov,Russian Federation,0,0,1,1,1988
Vladimir Popov,Russian Federation,0,0,1,1,1988
Nate Carr,United States,0,0,1,1,1988
Dennis Koslowski,United States,0,0,1,1,1988
Bill Scherr,United States,0,0,1,1,1988
Larisa Moskalenko,Soviet Union,0,0,1,1,1988
Irina Chunikhovskaya,Soviet Union,0,0,1,1,1988
Jesper Bank,Denmark,0,0,1,1,1988
John Cutler,New Zealand,0,0,1,1,1988
Nelson Falcão,Brazil,0,0,1,1,1988
Clinio Freitas,Brazil,0,0,1,1,1988
Mike Gebhardt,United States,0,0,1,1,1988
Lars Grael,Brazil,0,0,1,1,1988
Torben Grael,Brazil,0,0,1,1,1988
Jan Mathiasen,Denmark,0,0,1,1,1988
Charlie McKee,United States,0,0,1,1,1988
Frank McLaughlin,Canada,0,0,1,1,1988
John Millen,Canada,0,0,1,1,1988
Steen Secher,Denmark,0,0,1,1,1988
John Shadden,United States,0,0,1,1,1988
Róbson Caetano da Silva,Brazil,0,0,1,1,1988
Tsvetanka Khristova,Bulgaria,0,0,1,1,1988
Dave Steen,Canada,0,0,1,1,1988
Li Meisu,People's Republic of China,0,0,1,1,1988
Ahmed Salah,Djibouti,0,0,1,1,1988
Jüri Tamm,Estonia,0,0,1,1,1988
Seppo Räty,Finland,0,0,1,1,1988
Bruno Marie-Rose,France,0,0,1,1,1988
Max Morinière,France,0,0,1,1,1988
Gilles Quénéhervé,France,0,0,1,1,1988
Daniel Sangouma,France,0,0,1,1,1988
Yvonne Murray,Great Britain,0,0,1,1,1988
Mark Rowland,Great Britain,0,0,1,1,1988
Anke Behmer,East Germany,0,0,1,1,1988
Sabine Busch,East Germany,0,0,1,1,1988
Kirsten Emmelmann,East Germany,0,0,1,1,1988
Ellen Fiedler,East Germany,0,0,1,1,1988
Beate Koch,East Germany,0,0,1,1,1988
Dagmar Neubauer,East Germany,0,0,1,1,1988
Hansjörg Kunze,East Germany,0,0,1,1,1988
Grit Breuer,East Germany,0,0,1,1,1988
Katrin Dörre-Heinig,East Germany,0,0,1,1,1988
Claudia Zaczkiewicz,West Germany,0,0,1,1,1988
Rolf Danneberg,West Germany,0,0,1,1,1988
Norbert Dobeleit,West Germany,0,0,1,1,1988
Hartwig Gauder,East Germany,0,0,1,1,1988
Mark Henrich,West Germany,0,0,1,1,1988
Jens-Peter Herold,East Germany,0,0,1,1,1988
Edgar Itt,West Germany,0,0,1,1,1988
Bodo Kuhn,West Germany,0,0,1,1,1988
Ralf Lübke,West Germany,0,0,1,1,1988
Jörg Vaihinger,Germany,0,0,1,1,1988
Maurizio Damilano,Italy,0,0,1,1,1988
Kipkemboi Kimeli,Kenya,0,0,1,1,1988
Saïd Aouita,Morocco,0,0,1,1,1988
Galina Malchugina,Russian Federation,0,0,1,1,1988
Werner Günthör,Switzerland,0,0,1,1,1988
Patrik Sjöberg,Sweden,0,0,1,1,1988
Tamara Bykova,Russian Federation,0,0,1,1,1988
Galina Čisťakovová,Slovakia,0,0,1,1,1988
Lyudmila Kondratyeva,Russian Federation,0,0,1,1,1988
Nataliya Pomoshchnikova-Voronova,Russian Federation,0,0,1,1,1988
Marina Zhirova,Russian Federation,0,0,1,1,1988
Yelena Zhupiyeva-Vyazova,Soviet Union,0,0,1,1,1988
Grigory Yegorov,Kazakhstan,0,0,1,1,1988
Aleksandr Kovalenko,Belarus,0,0,1,1,1988
Rudolf Povarnitsyn,Soviet Union,0,0,1,1,1988
Kim Gallagher,United States,0,0,1,1,1988
Tonie Campbell,United States,0,0,1,1,1988
Edwin Moses,United States,0,0,1,1,1988
Larry Myricks,United States,0,0,1,1,1988
Calvin Smith,United States,0,0,1,1,1988
Connie Paraskevin-Young,United States,0,0,1,1,1988
Wendy Lian Williams,United States,0,0,1,1,1988
Wang Yajun,People's Republic of China,0,0,1,1,1988
Vitali Shcherba,Belarus,6,0,0,6,1992
Krisztina Egerszegi,Hungary,3,0,0,3,1992
Yevgeny Sadovy,Russian Federation,3,0,0,3,1992
Nicole Haislett,United States,3,0,0,3,1992
Aleksandr Popov,Russian Federation,2,2,0,4,1992
Lavinia Miloșovici,Romania,2,1,1,4,1992
Tatyana Gutsu,Ukraine,2,1,1,4,1992
Summer Sanders,United States,2,1,1,4,1992
Crissy Ahmann-Leighton,United States,2,1,0,3,1992
Jenny Thompson,United States,2,1,0,3,1992
Matt Biondi,United States,2,1,0,3,1992
Gwen Torrence,United States,2,1,0,3,1992
Tatyana Lysenko,Ukraine,2,0,1,3,1992
Jon Olsen,United States,2,0,1,3,1992
Mel Stewart,United States,2,0,1,3,1992
Deng Yaping,People's Republic of China,2,0,0,2,1992
Jo Yun-Jeong,Republic of Korea,2,0,0,2,1992
Nikolay Bukhalov,Bulgaria,2,0,0,2,1992
Kay Bluhm,East Germany,2,0,0,2,1992
Torsten Gutsche,Germany,2,0,0,2,1992
Nicole Uphoff-Becker,Germany,2,0,0,2,1992
Matt Ryan,Australia,2,0,0,2,1992
Giovanna Trillini,Italy,2,0,0,2,1992
Arkadiusz Skrzypaszek,Poland,2,0,0,2,1992
Kirsten Barnes,Canada,2,0,0,2,1992
Kathleen Heddle,Canada,2,0,0,2,1992
Marnie McBean,Canada,2,0,0,2,1992
Jessica Monroe,Canada,2,0,0,2,1992
Brenda Taylor,Canada,2,0,0,2,1992
Kay Worthington,Canada,2,0,0,2,1992
Marina Dobrancheva-Logvinenko,Russian Federation,2,0,0,2,1992
Tamás Darnyi,Hungary,2,0,0,2,1992
Nelson Diebel,United States,2,0,0,2,1992
Pablo Morales,United States,2,0,0,2,1992
Carl Lewis,United States,2,0,0,2,1992
Mike Marsh,United States,2,0,0,2,1992
Quincy Watts,United States,2,0,0,2,1992
Hryhoriy Misiutin,Ukraine,1,4,0,5,1992
Lin Li,People's Republic of China,1,2,0,3,1992
Zhuang Yong,People's Republic of China,1,2,0,3,1992
Dagmar Hase,Germany,1,2,0,3,1992
Vlad Pyshnenko,Russian Federation,1,2,0,3,1992
Rita Kőbán,Hungary,1,1,1,3,1992
Li Xiaoshuang,People's Republic of China,1,1,1,3,1992
Anita Nall,United States,1,1,1,3,1992
Kim Su-Nyeong,Republic of Korea,1,1,0,2,1992
Qiao Hong,People's Republic of China,1,1,0,2,1992
Anke Nothnagel-von Seck,East Germany,1,1,0,2,1992
Ramona Portwich,East Germany,1,1,0,2,1992
Birgit Fischer-Schmidt,East Germany,1,1,0,2,1992
Ulrich Papke,Germany,1,1,0,2,1992
Ingo Spelly,East Germany,1,1,0,2,1992
Isabell Werth,Germany,1,1,0,2,1992
Piet Raymakers,Netherlands,1,1,0,2,1992
Kathy Watt,Australia,1,1,0,2,1992
Jens Lehmann,Germany,1,1,0,2,1992
Bence Szabó,Hungary,1,1,0,2,1992
Lu Li,People's Republic of China,1,1,0,2,1992
Henrietta Ónodi,Hungary,1,1,0,2,1992
Elisabeta Oleniuc-Lipă,Romania,1,1,0,2,1992
Iulică Ruican,Romania,1,1,0,2,1992
Viorel Talapan,Romania,1,1,0,2,1992
Wang Yifu,People's Republic of China,1,1,0,2,1992
Kieren Perkins,Australia,1,1,0,2,1992
Yang Wenyi,People's Republic of China,1,1,0,2,1992
Veniamin Tayanovich,Russian Federation,1,1,0,2,1992
Janet Evans,United States,1,1,0,2,1992
Jeff Rouse,United States,1,1,0,2,1992
Olga Bryzgina,Soviet Union,1,1,0,2,1992
Liliya Nurutdinova,Russian Federation,1,1,0,2,1992
Steve Lewis,United States,1,1,0,2,1992
Mary Joe Fernandez,United States,1,0,1,2,1992
Éva Dónusz,Hungary,1,0,1,2,1992
Klaus Balkenhol,Germany,1,0,1,2,1992
Ihor Korobchinskyi,Ukraine,1,0,1,2,1992
Valeri Belenki,Azerbaijan,1,0,1,2,1992
Dimitrie Popescu,Romania,1,0,1,2,1992
Dumitru Răducanu,Romania,1,0,1,2,1992
Neculai Țaga,Romania,1,0,1,2,1992
Alena Rudkouskaya,Belarus,1,0,1,2,1992
Mark Tewksbury,Canada,1,0,1,2,1992
Lea Loveless,United States,1,0,1,2,1992
Angel Martino,United States,1,0,1,2,1992
Dave Berkoff,United States,1,0,1,2,1992
Joe Hudepohl,United States,1,0,1,2,1992
Tom Jager,United States,1,0,1,2,1992
Sally Gunnell,Great Britain,1,0,1,2,1992
Jackie Joyner-Kersee,United States,1,0,1,2,1992
Dennis Mitchell,United States,1,0,1,2,1992
Boris Becker,Germany,1,0,0,1,1992
Michael Stich,Germany,1,0,0,1,1992
Susi Susanti,Indonesia,1,0,0,1,1992
Alan Budikusuma,Indonesia,1,0,0,1,1992
Juan Carlos Holgado,Spain,1,0,0,1,1992
Alfonso Menéndez,Spain,1,0,0,1,1992
Antonio Vázquez,Spain,1,0,0,1,1992
Sébastien Flûte,France,1,0,0,1,1992
Jeong So-Yeong,Republic of Korea,1,0,0,1,1992
Hwang Hye-Yeong,Republic of Korea,1,0,0,1,1992
Kim Mun-Su,Republic of Korea,1,0,0,1,1992
Park Ju-Bong,Republic of Korea,1,0,0,1,1992
Omar Ajete,Cuba,1,0,0,1,1992
Rolando Arrojo,Cuba,1,0,0,1,1992
José Delgado,Cuba,1,0,0,1,1992
Giorge Díaz,Cuba,1,0,0,1,1992
José Antonio Estrada,Cuba,1,0,0,1,1992
Osvaldo Fernández,Cuba,1,0,0,1,1992
Lourdes Gourriel,Cuba,1,0,0,1,1992
Orlando Hernández,Cuba,1,0,0,1,1992
Alberto Hernández,Cuba,1,0,0,1,1992
Orestes Kindelán,Cuba,1,0,0,1,1992
Omar Linares,Cuba,1,0,0,1,1992
Germán Mesa,Cuba,1,0,0,1,1992
Víctor Mesa,Cuba,1,0,0,1,1992
Antonio Pacheco,Cuba,1,0,0,1,1992
Juan Padilla,Cuba,1,0,0,1,1992
Juan Carlos Pérez,Cuba,1,0,0,1,1992
Luis Ulacia,Cuba,1,0,0,1,1992
Ermidelio Urrutia,Cuba,1,0,0,1,1992
Jorge Luis Valdés,Cuba,1,0,0,1,1992
Lázaro Vargas,Cuba,1,0,0,1,1992
Roberto Balado,Cuba,1,0,0,1,1992
Joel Casamayor,Cuba,1,0,0,1,1992
Ariel Hernández,Cuba,1,0,0,1,1992
Juan Carlos Lemus,Cuba,1,0,0,1,1992
Rogelio Marcelo,Cuba,1,0,0,1,1992
Félix Savón,Cuba,1,0,0,1,1992
Héctor Vinent,Cuba,1,0,0,1,1992
Lee Eun-Gyeong,Republic of Korea,1,0,0,1,1992
Lu Lin,People's Republic of China,1,0,0,1,1992
Wang Tao,People's Republic of China,1,0,0,1,1992
Marc Rosset,Switzerland,1,0,0,1,1992
Jan-Ove Waldner,Sweden,1,0,0,1,1992
Jennifer Capriati,United States,1,0,0,1,1992
Gigi Fernandez,Puerto Rico,1,0,0,1,1992
Torsten May,Germany,1,0,0,1,1992
Andreas Tews,East Germany,1,0,0,1,1992
Michael Carruth,Ireland,1,0,0,1,1992
Svetlana Antipova-Zaboluyeva,Russian Federation,1,0,0,1,1992
Yelena Baranova,Russian Federation,1,0,0,1,1992
Elen Bunatyants-Shakirova,Russian Federation,1,0,0,1,1992
Irina Gerlits,Kazakhstan,1,0,0,1,1992
Yelena Khudashova,Russian Federation,1,0,0,1,1992
Irina Minkh,Russian Federation,1,0,0,1,1992
Yelena Shvaybovich,Belarus,1,0,0,1,1992
Irina Sumnikova,Russian Federation,1,0,0,1,1992
Maryna Tkachenko,Ukraine,1,0,0,1,1992
Yelena Tornikidu,Unified Team,1,0,0,1,1992
Nataliya Zasulskaya,Russian Federation,1,0,0,1,1992
Olena Zhyrko,Ukraine,1,0,0,1,1992
Charles Barkley,United States,1,0,0,1,1992
Larry Bird,United States,1,0,0,1,1992
Clyde Drexler,United States,1,0,0,1,1992
Patrick Ewing,United States,1,0,0,1,1992
Magic Johnson,United States,1,0,0,1,1992
Michael Jordan,United States,1,0,0,1,1992
Christian Laettner,United States,1,0,0,1,1992
Karl Malone,United States,1,0,0,1,1992
Chris Mullin,United States,1,0,0,1,1992
Scottie Pippen,United States,1,0,0,1,1992
David Robinson,United States,1,0,0,1,1992
John Stockton,United States,1,0,0,1,1992
Choi Chol-Su,Democratic People's Republic of Korea,1,0,0,1,1992
Oscar De La Hoya,United States,1,0,0,1,1992
Clint Robinson,Australia,1,0,0,1,1992
Dzmitry Douhalionok,Belarus,1,0,0,1,1992
Aliaksandr Masiaikou,Belarus,1,0,0,1,1992
Lukáš Pollert,Czech Republic,1,0,0,1,1992
Mikko Kolehmainen,Finland,1,0,0,1,1992
Elisabeth Micheler-Jones,Germany,1,0,0,1,1992
Oliver Kegel,Germany,1,0,0,1,1992
Thomas Reineck,Germany,1,0,0,1,1992
Mario von Appen,Germany,1,0,0,1,1992
André Wohllebe,East Germany,1,0,0,1,1992
Kinga Czigány,Hungary,1,0,0,1,1992
Erika Mészáros,Hungary,1,0,0,1,1992
Pierpaolo Ferrazzi,Italy,1,0,0,1,1992
Joe Jacobi,United States,1,0,0,1,1992
Scott Strausbaugh,United States,1,0,0,1,1992
Gillian Rolton,Australia,1,0,0,1,1992
Monica Theodorescu,Germany,1,0,0,1,1992
Ludger Beerbaum,Germany,1,0,0,1,1992
David Green,Australia,1,0,0,1,1992
Andrew Hoy,Australia,1,0,0,1,1992
Jos Lansink,Belgium,1,0,0,1,1992
Bert Romp,Netherlands,1,0,0,1,1992
Jan Tops,Netherlands,1,0,0,1,1992
Petra Roßner,East Germany,1,0,0,1,1992
Erika Salumäe,Estonia,1,0,0,1,1992
Chris Boardman,Great Britain,1,0,0,1,1992
Fabio Casartelli,Italy,1,0,0,1,1992
Bernd Dittert,East Germany,1,0,0,1,1992
Jens Fiedler,Germany,1,0,0,1,1992
Guido Fulst,Germany,1,0,0,1,1992
Michael Glöckner,Germany,1,0,0,1,1992
Giovanni Lombardi,Italy,1,0,0,1,1992
Christian Meyer,Germany,1,0,0,1,1992
José Moreno,Spain,1,0,0,1,1992
Uwe Peschel,Germany,1,0,0,1,1992
Michael Rich,Germany,1,0,0,1,1992
Stefan Steinweg,Germany,1,0,0,1,1992
Andreas Walzer,Germany,1,0,0,1,1992
Carmen Barea,Spain,1,0,0,1,1992
Sonia Barrio,Spain,1,0,0,1,1992
Mercedes Coghen,Spain,1,0,0,1,1992
Natalia Dorado,Spain,1,0,0,1,1992
Nagore Gabellanes,Spain,1,0,0,1,1992
Mariví González,Spain,1,0,0,1,1992
Anna Maiques,Spain,1,0,0,1,1992
Silvia Manrique,Spain,1,0,0,1,1992
Eli Maragall,Spain,1,0,0,1,1992
Teresa Motos,Spain,1,0,0,1,1992
Núria Olivé,Spain,1,0,0,1,1992
Virginia Ramírez,Spain,1,0,0,1,1992
Masa Rodríguez,Spain,1,0,0,1,1992
Maider Tellería,Spain,1,0,0,1,1992
Andreas Becker,Germany,1,0,0,1,1992
Büdi Blunck,Germany,1,0,0,1,1992
Carsten Fischer,Germany,1,0,0,1,1992
Volker Fried,Germany,1,0,0,1,1992
Michael Hilgers,Germany,1,0,0,1,1992
Andreas Keller,Germany,1,0,0,1,1992
Michael Knauth,Germany,1,0,0,1,1992
Oliver Kurtz,Germany,1,0,0,1,1992
Christian Mayerhöfer,Germany,1,0,0,1,1992
Sven Meinhardt,Germany,1,0,0,1,1992
Michael Metz,Germany,1,0,0,1,1992
Klaus Michler,Germany,1,0,0,1,1992
Christopher Reitz,Germany,1,0,0,1,1992
Stefan Saliger,Germany,1,0,0,1,1992
Jan Peter Tewes,Germany,1,0,0,1,1992
Stefan Tewes,Germany,1,0,0,1,1992
Diana Bianchedi,Italy,1,0,0,1,1992
Francesca Bortolozzi-Borella,Italy,1,0,0,1,1992
Dorina Vaccaroni,Italy,1,0,0,1,1992
Margherita Zalaffi,Italy,1,0,0,1,1992
Philippe Omnès,France,1,0,0,1,1992
Éric Srecki,France,1,0,0,1,1992
Elmar Borrmann,Germany,1,0,0,1,1992
Robert Felisiak,Germany,1,0,0,1,1992
Alexander Koch,Germany,1,0,0,1,1992
Uwe Proske,East Germany,1,0,0,1,1992
Wladimir Reznitschenko,Germany,1,0,0,1,1992
Arnd Schmitt,Germany,1,0,0,1,1992
Ulrich Schreck,Germany,1,0,0,1,1992
Udo Wagner,East Germany,1,0,0,1,1992
Thorsten Weidner,Germany,1,0,0,1,1992
Ingo Weißenborn,Germany,1,0,0,1,1992
Grigory Kiriyenko,Russian Federation,1,0,0,1,1992
Stanislav Pozdnyakov,Russian Federation,1,0,0,1,1992
Aleksandr Shirshov,Russian Federation,1,0,0,1,1992
Vadym Huttsait,Ukraine,1,0,0,1,1992
Georgy Pogosov,Soviet Union,1,0,0,1,1992
José Emilio Amavisca,Spain,1,0,0,1,1992
Rafa Berges,Spain,1,0,0,1,1992
Abelardo,Spain,1,0,0,1,1992
Albert Ferrer,Spain,1,0,0,1,1992
Pep Guardiola,Spain,1,0,0,1,1992
Miguel Hernández,Spain,1,0,0,1,1992
Toni,Spain,1,0,0,1,1992
Lasa,Spain,1,0,0,1,1992
Juanma López,Spain,1,0,0,1,1992
Luis Enrique,Spain,1,0,0,1,1992
Kiko,Spain,1,0,0,1,1992
Alfonso,Spain,1,0,0,1,1992
Pinilla,Spain,1,0,0,1,1992
Paco Soler,Spain,1,0,0,1,1992
Roberto Solozábal,Spain,1,0,0,1,1992
Gabriel Vidal,Spain,1,0,0,1,1992
David Villabona,Spain,1,0,0,1,1992
Sviatlana Bahinskaya,Belarus,1,0,0,1,1992
Roza Galiyeva,Russian Federation,1,0,0,1,1992
Yelena Grudneva,Russian Federation,1,0,0,1,1992
Aleksandra Timoshenko,Soviet Union,1,0,0,1,1992
Oksana Chusovitina,Germany,1,0,0,1,1992
Pae Gil-Su,Democratic People's Republic of Korea,1,0,0,1,1992
Aleksey Voropayev,Russian Federation,1,0,0,1,1992
Rustam Sharipov,Ukraine,1,0,0,1,1992
Trent Dimas,United States,1,0,0,1,1992
Talant Duyshebayev,Poland,1,0,0,1,1992
Cha Jae-Gyeong,Republic of Korea,1,0,0,1,1992
Hong Jeong-Ho,Republic of Korea,1,0,0,1,1992
Jang Ri-Ra,Republic of Korea,1,0,0,1,1992
Kim Hwa-Suk,Republic of Korea,1,0,0,1,1992
Lee Ho-Yeon,Republic of Korea,1,0,0,1,1992
Lee Mi-Yeong,Republic of Korea,1,0,0,1,1992
Im Oh-Gyeong,Republic of Korea,1,0,0,1,1992
Min Hye-Suk,Republic of Korea,1,0,0,1,1992
Mun Hyang-Ja,Republic of Korea,1,0,0,1,1992
Nam Eun-Yeong,Republic of Korea,1,0,0,1,1992
Oh Seong-Ok,Republic of Korea,1,0,0,1,1992
Park Jeong-Rim,Republic of Korea,1,0,0,1,1992
Park Gap-Suk,Republic of Korea,1,0,0,1,1992
Valery Gopin,Russian Federation,1,0,0,1,1992
Oleg Grebnev,Russian Federation,1,0,0,1,1992
Oleg Kiselyov,Russian Federation,1,0,0,1,1992
Vasily Kudinov,Russian Federation,1,0,0,1,1992
Andrey Lavrov,Russian Federation,1,0,0,1,1992
Andrey Barbashinsky,Belarus,1,0,0,1,1992
Sergey Bebeshko,Ukraine,1,0,0,1,1992
Yury Gavrilov,Ukraine,1,0,0,1,1992
Mikhail Yakimovich,Belarus,1,0,0,1,1992
Igor Chumak,Russian Federation,1,0,0,1,1992
Igor Vasilyev,Russian Federation,1,0,0,1,1992
Míriam Blasco,Spain,1,0,0,1,1992
Cathy Fleury-Vachon,France,1,0,0,1,1992
Kim Mi-Jeong,Republic of Korea,1,0,0,1,1992
Almudena Muñoz,Spain,1,0,0,1,1992
Cécile Nowak,France,1,0,0,1,1992
Odalis Revé,Cuba,1,0,0,1,1992
Zhuang Xiaoyan,People's Republic of China,1,0,0,1,1992
Nazim Hüseynov,Azerbaijan,1,0,0,1,1992
Davit Khakhaleishvili,Georgia,1,0,0,1,1992
Toshihiko Koga,Japan,1,0,0,1,1992
Antal Kovács,Hungary,1,0,0,1,1992
Waldemar Legień,Poland,1,0,0,1,1992
Rogério Sampaio,Brazil,1,0,0,1,1992
Hidehiko Yoshida,Japan,1,0,0,1,1992
Maciej Czyżowicz,Poland,1,0,0,1,1992
Dariusz Goździak,Poland,1,0,0,1,1992
Peter Antonie,Australia,1,0,0,1,1992
Andrew Cooper,Australia,1,0,0,1,1992
Nick Green,Australia,1,0,0,1,1992
Steve Hawkins,Australia,1,0,0,1,1992
Mike McKay,Australia,1,0,0,1,1992
James Tomkins,Australia,1,0,0,1,1992
Shannon Crawford,Canada,1,0,0,1,1992
Megan Delehanty,Canada,1,0,0,1,1992
Lesley Thompson-Willie,Canada,1,0,0,1,1992
Darren Barber,Canada,1,0,0,1,1992
Andy Crosby,Canada,1,0,0,1,1992
Michael Forgeron,Canada,1,0,0,1,1992
Robert Marland,Canada,1,0,0,1,1992
Terry Paul,Canada,1,0,0,1,1992
Derek Porter,Canada,1,0,0,1,1992
Michael Rascher,Canada,1,0,0,1,1992
Bruce Robertson,Canada,1,0,0,1,1992
John Wallace,Canada,1,0,0,1,1992
Garry Herbert,Great Britain,1,0,0,1,1992
Matthew Pinsent,Great Britain,1,0,0,1,1992
Steven Redgrave,Great Britain,1,0,0,1,1992
Greg Searle,Great Britain,1,0,0,1,1992
Jonny Searle,Great Britain,1,0,0,1,1992
Kathrin Boron,Germany,1,0,0,1,1992
Kerstin Köppen,Germany,1,0,0,1,1992
Kristina Mundt,East Germany,1,0,0,1,1992
Kerstin Müller,Germany,1,0,0,1,1992
Birgit Peter,East Germany,1,0,0,1,1992
Sybille Schmidt,Germany,1,0,0,1,1992
Andreas Hajek,Germany,1,0,0,1,1992
Thomas Lange,East Germany,1,0,0,1,1992
Michael Steinbach,Germany,1,0,0,1,1992
Stephan Volkert,Germany,1,0,0,1,1992
André Willms,Germany,1,0,0,1,1992
Hrachya Petikyan,Armenia,1,0,0,1,1992
Kanstantsin Lukaschyk,Belarus,1,0,0,1,1992
Zhang Shan,People's Republic of China,1,0,0,1,1992
Michael Jakosits,Germany,1,0,0,1,1992
Ralf Schumann,East Germany,1,0,0,1,1992
Yeo Gap-Sun,Republic of Korea,1,0,0,1,1992
Lee Eun-Cheol,Republic of Korea,1,0,0,1,1992
Petr Hrdlička,Czech Republic,1,0,0,1,1992
Yury Fedkin,Russian Federation,1,0,0,1,1992
Launi Meili,United States,1,0,0,1,1992
Sylvie Fréchette,Canada,1,0,0,1,1992
Fu Mingxia,People's Republic of China,1,0,0,1,1992
Gao Min,People's Republic of China,1,0,0,1,1992
Qian Hong,People's Republic of China,1,0,0,1,1992
Sun Shuwei,People's Republic of China,1,0,0,1,1992
Martín López-Zubero,Spain,1,0,0,1,1992
Kyoko Iwasaki,Japan,1,0,0,1,1992
Aleksey Kudryavtsev,Russian Federation,1,0,0,1,1992
Dmitry Lepikov,Russian Federation,1,0,0,1,1992
Yury Mukhin,Russian Federation,1,0,0,1,1992
Kristen Babb-Sprague,United States,1,0,0,1,1992
Karen Josephson,United States,1,0,0,1,1992
Sarah Josephson,United States,1,0,0,1,1992
Megan Kleine,United States,1,0,0,1,1992
Ashley Tappin,United States,1,0,0,1,1992
Dara Torres,United States,1,0,0,1,1992
Janie Wagstaff,United States,1,0,0,1,1992
Mike Barrowman,United States,1,0,0,1,1992
Hans Dersch,United States,1,0,0,1,1992
Shaun Jordan,United States,1,0,0,1,1992
Mark Lenzi,United States,1,0,0,1,1992
Joel Thomas,United States,1,0,0,1,1992
Jorge Edson,Brazil,1,0,0,1,1992
Janelson,Brazil,1,0,0,1,1992
Douglas,Brazil,1,0,0,1,1992
Paulão,Brazil,1,0,0,1,1992
Pampa,Brazil,1,0,0,1,1992
Giovane,Brazil,1,0,0,1,1992
Carlão,Brazil,1,0,0,1,1992
Maurício,Brazil,1,0,0,1,1992
Marcelo Negrão,Brazil,1,0,0,1,1992
Talmo,Brazil,1,0,0,1,1992
Amauri,Brazil,1,0,0,1,1992
Tande,Brazil,1,0,0,1,1992
Regla Bell,Cuba,1,0,0,1,1992
Mercedes Calderón,Cuba,1,0,0,1,1992
Magalys Carvajal,Cuba,1,0,0,1,1992
Marlenis Costa,Cuba,1,0,0,1,1992
Idalmis Gato,Cuba,1,0,0,1,1992
Lilia Izquierdo,Cuba,1,0,0,1,1992
Norka Latamblet,Cuba,1,0,0,1,1992
Mireya Luis,Cuba,1,0,0,1,1992
Tania Ortiz,Cuba,1,0,0,1,1992
Regla Torres,Cuba,1,0,0,1,1992
Francesco Attolico,Italy,1,0,0,1,1992
Alessandro Bovo,Italy,1,0,0,1,1992
Paolo Caldarella,Italy,1,0,0,1,1992
Sandro Campagna,Italy,1,0,0,1,1992
Marco D'Altrui,Italy,1,0,0,1,1992
Massimiliano Ferretti,Italy,1,0,0,1,1992
Mario Fiorillo,Italy,1,0,0,1,1992
Ferdinando Gandolfi,Italy,1,0,0,1,1992
Amedeo Pomilio,Italy,1,0,0,1,1992
Franco Porzio,Italy,1,0,0,1,1992
Giuseppe Porzio,Italy,1,0,0,1,1992
Carlo Silipo,Italy,1,0,0,1,1992
Israel Militosyan,Armenia,1,0,0,1,1992
Ivan Ivanov,Bulgaria,1,0,0,1,1992
Ronny Weller,East Germany,1,0,0,1,1992
Pyrros Dimas,Greece,1,0,0,1,1992
Akakios Kakiasvili,Georgia,1,0,0,1,1992
Jeon Byeong-Gwan,Republic of Korea,1,0,0,1,1992
Naim Süleymanoğlu,Turkey,1,0,0,1,1992
Tudor Casapu,Republic of Moldova,1,0,0,1,1992
Aliaksandr Kurlovich,Belarus,1,0,0,1,1992
Viktor Tregubov,Russian Federation,1,0,0,1,1992
Héctor Milián,Cuba,1,0,0,1,1992
Alejandro Puerto,Cuba,1,0,0,1,1992
Maik Bullmann,East Germany,1,0,0,1,1992
Oleg Kutscherenko,Germany,1,0,0,1,1992
Péter Farkas,Hungary,1,0,0,1,1992
Attila Repka,Hungary,1,0,0,1,1992
An Han-Bong,Republic of Korea,1,0,0,1,1992
Park Jang-Sun,Republic of Korea,1,0,0,1,1992
Jon Rønningen,Norway,1,0,0,1,1992
Kim Il-Ong,Democratic People's Republic of Korea,1,0,0,1,1992
Li Hak-Son,Democratic People's Republic of Korea,1,0,0,1,1992
Mnatsakan Iskandaryan,Armenia,1,0,0,1,1992
Leri Khabelovi,Georgia,1,0,0,1,1992
Makharbek Khadartsev,Russian Federation,1,0,0,1,1992
Aleksandr Karelin,Russian Federation,1,0,0,1,1992
Mehmet Akif Pirim,Turkey,1,0,0,1,1992
Bruce Baumgartner,United States,1,0,0,1,1992
Kevin Jackson,United States,1,0,0,1,1992
John Smith,United States,1,0,0,1,1992
Arsen Fadzayev,Russian Federation,1,0,0,1,1992
Linda Andersen,Norway,1,0,0,1,1992
Patricia Guerra,Spain,1,0,0,1,1992
Barbara Kendall,New Zealand,1,0,0,1,1992
Theresa Zabell,Spain,1,0,0,1,1992
Jesper Bank,Denmark,1,0,0,1,1992
Jordi Calafat,Spain,1,0,0,1,1992
Franck David,France,1,0,0,1,1992
Luis Doreste,Spain,1,0,0,1,1992
Hal Haenel,United States,1,0,0,1,1992
Nicolas Hénard,France,1,0,0,1,1992
Yves Loday,France,1,0,0,1,1992
Domingo Manrique,Spain,1,0,0,1,1992
Mark Reynolds,United States,1,0,0,1,1992
Kiko Sánchez,Spain,1,0,0,1,1992
Steen Secher,Denmark,1,0,0,1,1992
Jesper Seier,Denmark,1,0,0,1,1992
José María van der Ploeg,Spain,1,0,0,1,1992
Hassiba Boulmerka,Algeria,1,0,0,1,1992
Mark McKoy,Austria,1,0,0,1,1992
Chen Yueling,People's Republic of China,1,0,0,1,1992
Maritza Martén,Cuba,1,0,0,1,1992
Javier Sotomayor,Cuba,1,0,0,1,1992
Jan Železný,Czech Republic,1,0,0,1,1992
Robert Změlík,Czech Republic,1,0,0,1,1992
Fermín Cacho,Spain,1,0,0,1,1992
Daniel Plaza,Spain,1,0,0,1,1992
Derartu Tulu,Ethiopia,1,0,0,1,1992
Marie-José Pérec,France,1,0,0,1,1992
Linford Christie,Great Britain,1,0,0,1,1992
Heike Drechsler,East Germany,1,0,0,1,1992
Heike Redetzky-Henkel,Germany,1,0,0,1,1992
Silke Renk,East Germany,1,0,0,1,1992
Dieter Baumann,Germany,1,0,0,1,1992
Voula Patoulidou,Greece,1,0,0,1,1992
Matthew Birir,Kenya,1,0,0,1,1992
William Tanui,Kenya,1,0,0,1,1992
Hwang Yeong-Jo,Republic of Korea,1,0,0,1,1992
Romas Ubartas,Lithuania,1,0,0,1,1992
Khalid Skah,Morocco,1,0,0,1,1992
Ellen van Langen,Netherlands,1,0,0,1,1992
Valentina Yegorova,Russian Federation,1,0,0,1,1992
Svetlana Krivelyova,Russian Federation,1,0,0,1,1992
Yelena Romanova,Russian Federation,1,0,0,1,1992
Lyudmila Dzhigalova,Soviet Union,1,0,0,1,1992
Olga Nazarova,Russian Federation,1,0,0,1,1992
Yelena Ruzina,Russian Federation,1,0,0,1,1992
Marina Shmonina,Russian Federation,1,0,0,1,1992
Andrey Abduvaliyev,Tajikistan,1,0,0,1,1992
Andrey Perlov,Russian Federation,1,0,0,1,1992
Maksim Tarasov,Russian Federation,1,0,0,1,1992
Evelyn Ashford,United States,1,0,0,1,1992
Gail Devers,United States,1,0,0,1,1992
Michelle Finn,United States,1,0,0,1,1992
Carlette Guidry-White,United States,1,0,0,1,1992
Esther Jones,United States,1,0,0,1,1992
Leroy Burrell,United States,1,0,0,1,1992
Mike Conley,United States,1,0,0,1,1992
Darnell Hall,United States,1,0,0,1,1992
Chip Jenkins,United States,1,0,0,1,1992
James Jett,United States,1,0,0,1,1992
Michael Johnson,United States,1,0,0,1,1992
Mike Stulce,United States,1,0,0,1,1992
Andrew Valmon,United States,1,0,0,1,1992
Kevin Young,United States,1,0,0,1,1992
Maribel Martínez,Spain,1,0,0,1,1992
Li Jing,People's Republic of China,0,3,0,3,1992
Shannon Miller,United States,0,2,3,5,1992
Franziska van Almsick,Germany,0,2,2,4,1992
Anders Holmertz,Sweden,0,2,1,3,1992
Zsolt Gyulay,Hungary,0,2,0,2,1992
Veronica Cogeanu-Cochela,Romania,0,2,0,2,1992
Norbert Rózsa,Hungary,0,2,0,2,1992
Vladimir Selkov,Russian Federation,0,2,0,2,1992
Pavlo Khnykin,Ukraine,0,2,0,2,1992
Juliet Cuthbert,Jamaica,0,2,0,2,1992
Frankie Fredericks,Namibia,0,2,0,2,1992
Andreas Wecker,East Germany,0,1,2,3,1992
Daniela Hunger,East Germany,0,1,2,3,1992
Arantxa Sánchez Vicario,Spain,0,1,1,2,1992
Knut Holmann,Norway,0,1,1,2,1992
Agneta Andersson,Sweden,0,1,1,2,1992
Herbert Blöcker,Germany,0,1,1,2,1992
Blyth Tait,New Zealand,0,1,1,2,1992
Elvis Gregory,Cuba,0,1,1,2,1992
Pavel Kolobkov,Russian Federation,0,1,1,2,1992
Cristina Bontaș,Romania,0,1,1,2,1992
Guo Linyao,People's Republic of China,0,1,1,2,1992
Yukio Iketani,Japan,0,1,1,2,1992
Eduard Zenovka,Russian Federation,0,1,1,2,1992
Hayley Lewis,Australia,0,1,1,2,1992
Simone Osygus,Germany,0,1,1,2,1992
Irina Privalova,Russian Federation,0,1,1,2,1992
Jean-Philippe Gatien,France,0,1,0,1,1992
Steffi Graf,Germany,0,1,0,1,1992
Steffen Fetzner,Germany,0,1,0,1,1992
Jörg Roßkopf,Germany,0,1,0,1,1992
Rudy Gunawan,Indonesia,0,1,0,1,1992
Eddy Hartono,Indonesia,0,1,0,1,1992
Ardy Wiranata,Indonesia,0,1,0,1,1992
Ma Xiangjun,People's Republic of China,0,1,0,1,1992
Wang Hong,People's Republic of China,0,1,0,1,1992
Wang Xiaozhu,People's Republic of China,0,1,0,1,1992
Ismo Falck,Finland,0,1,0,1,1992
Jari Lipponen,Finland,0,1,0,1,1992
Tomi Poikolainen,Finland,0,1,0,1,1992
Chen Zihe,People's Republic of China,0,1,0,1,1992
Jun Gao,People's Republic of China,0,1,0,1,1992
Guan Weizhen,People's Republic of China,0,1,0,1,1992
Bang Su-Hyeon,Republic of Korea,0,1,0,1,1992
Mark Leduc,Canada,0,1,0,1,1992
Raúl González,Cuba,0,1,0,1,1992
Juan Hernández Sierra,Cuba,0,1,0,1,1992
Jeong Jae-Heon,Republic of Korea,0,1,0,1,1992
Nong Qunhua,People's Republic of China,0,1,0,1,1992
Conchita Martínez,Spain,0,1,0,1,1992
Jordi Arrese,Spain,0,1,0,1,1992
Wayne Ferreira,South Africa,0,1,0,1,1992
Pietie Norval,South Africa,0,1,0,1,1992
Faustino Reyes,Spain,0,1,0,1,1992
Chang Cheng-Hsien,Chinese Taipei,0,1,0,1,1992
Chang Wen-Chung,Chinese Taipei,0,1,0,1,1992
Chang Yaw-Teing,Chinese Taipei,0,1,0,1,1992
Chen Chi-Hsin,Chinese Taipei,0,1,0,1,1992
Chen Wei-Chen,Chinese Taipei,0,1,0,1,1992
Chiang Tai-Chuan,Chinese Taipei,0,1,0,1,1992
Huang Chung-Yi,Chinese Taipei,0,1,0,1,1992
Huang Wen-Po,Chinese Taipei,0,1,0,1,1992
Jong Yeu-Jeng,Chinese Taipei,0,1,0,1,1992
Ku Kuo-Chian,Chinese Taipei,0,1,0,1,1992
Kuo Lee Chien-Fu,Chinese Taipei,0,1,0,1,1992
Liao Ming-Hsiung,Chinese Taipei,0,1,0,1,1992
Lin Chao-Huang,Chinese Taipei,0,1,0,1,1992
Lin Kun-Han,Chinese Taipei,0,1,0,1,1992
Lo Chen-Jung,Chinese Taipei,0,1,0,1,1992
Lo Kuo-Chung,Chinese Taipei,0,1,0,1,1992
Pai Kun-Hong,Chinese Taipei,0,1,0,1,1992
Tsai Ming-Hung,Chinese Taipei,0,1,0,1,1992
Wang Kuang-Shih,Chinese Taipei,0,1,0,1,1992
Wu Shih-Hsin,Chinese Taipei,0,1,0,1,1992
Marco Rudolph,Germany,0,1,0,1,1992
Wayne McCullough,Ireland,0,1,0,1,1992
Orhan Delibas,Netherlands,0,1,0,1,1992
Richard Igbineghu,Nigeria,0,1,0,1,1992
David Izonritei,Nigeria,0,1,0,1,1992
Cong Xuedi,People's Republic of China,0,1,0,1,1992
He Jun,People's Republic of China,0,1,0,1,1992
Li Dongmei,People's Republic of China,0,1,0,1,1992
Li Xin,People's Republic of China,0,1,0,1,1992
Liu Jun,People's Republic of China,0,1,0,1,1992
Liu Qing,People's Republic of China,0,1,0,1,1992
Peng Ping,People's Republic of China,0,1,0,1,1992
Wang Fang,People's Republic of China,0,1,0,1,1992
Zhan Shuping,People's Republic of China,0,1,0,1,1992
Zheng Dongmei,People's Republic of China,0,1,0,1,1992
Zheng Haixia,People's Republic of China,0,1,0,1,1992
Vladan Alanović,Croatia,0,1,0,1,1992
Franjo Arapović,Croatia,0,1,0,1,1992
Danko Cvjetićanin,Croatia,0,1,0,1,1992
Alan Gregov,Croatia,0,1,0,1,1992
Arijan Komazec,Croatia,0,1,0,1,1992
Toni Kukoč,Croatia,0,1,0,1,1992
Aramis Naglić,Croatia,0,1,0,1,1992
Velimir Perasović,Croatia,0,1,0,1,1992
Dražen Petrović,Croatia,0,1,0,1,1992
Dino Rađa,Croatia,0,1,0,1,1992
Žan Tabak,Croatia,0,1,0,1,1992
Stojko Vranković,Croatia,0,1,0,1,1992
Daniel Bozhinov,Bulgaria,0,1,0,1,1992
Rostyslav Zaulychnyi,Ukraine,0,1,0,1,1992
Chris Byrd,United States,0,1,0,1,1992
Danielle Woodward,Australia,0,1,0,1,1992
Jiří Rohan,Czech Republic,0,1,0,1,1992
Miroslav Šimek,Czech Republic,0,1,0,1,1992
Arne Nielsson,Denmark,0,1,0,1,1992
Christian Frederiksen,Denmark,0,1,0,1,1992
Sylvain Curinier,France,0,1,0,1,1992
Gareth Marriott,Great Britain,0,1,0,1,1992
Katrin Borchert,Australia,0,1,0,1,1992
Attila Ábrahám,Hungary,0,1,0,1,1992
Ferenc Csipes,Hungary,0,1,0,1,1992
László Fidel,Hungary,0,1,0,1,1992
Ivans Klementjevs,Latvia,0,1,0,1,1992
Maciej Freimut,Poland,0,1,0,1,1992
Wojciech Kurpiewski,Poland,0,1,0,1,1992
Susanne Wiberg-Gunnarsson,Sweden,0,1,0,1,1992
Gunnar Olsson,Sweden,0,1,0,1,1992
Karl Sundqvist,Sweden,0,1,0,1,1992
Michał Śliwiński,Poland,0,1,0,1,1992
Tineke Bartels-de Vries,Netherlands,0,1,0,1,1992
Ellen Bontje,Netherlands,0,1,0,1,1992
Vicky Latta,New Zealand,0,1,0,1,1992
Annemarie Sanders-Keijzer,Netherlands,0,1,0,1,1992
Anky van Grunsven,Netherlands,0,1,0,1,1992
Boris Boor,Austria,0,1,0,1,1992
Thomas Frühmann,Austria,0,1,0,1,1992
Jörg Münzner,Austria,0,1,0,1,1992
Andrew Nicholson,New Zealand,0,1,0,1,1992
Hugo Simon,Austria,0,1,0,1,1992
Mark Todd,New Zealand,0,1,0,1,1992
Jeannie Longo-Ciprelli,France,0,1,0,1,1992
Annett Neumann,Germany,0,1,0,1,1992
Brett Aitken,Australia,0,1,0,1,1992
Flavio Anastasia,Italy,0,1,0,1,1992
Luca Colombo,Italy,0,1,0,1,1992
Gianfranco Contri,Italy,0,1,0,1,1992
Erik Dekker,Netherlands,0,1,0,1,1992
Shane Kelly,Australia,0,1,0,1,1992
Stephen McGlede,Australia,0,1,0,1,1992
Gary Neiwand,Australia,0,1,0,1,1992
Shaun O'Brien,Australia,0,1,0,1,1992
Stuart O'Grady,Australia,0,1,0,1,1992
Andrea Peron,Italy,0,1,0,1,1992
Léon van Bon,Netherlands,0,1,0,1,1992
John Bestall,Australia,0,1,0,1,1992
Warren Birmingham,Australia,0,1,0,1,1992
Lee Bodimeade,Australia,0,1,0,1,1992
Ashley Carey,Australia,0,1,0,1,1992
Greg Corbitt,Australia,0,1,0,1,1992
Stephen Davies,Australia,0,1,0,1,1992
Damon Diletti,Australia,0,1,0,1,1992
Lachlan Dreher,Australia,0,1,0,1,1992
Lachlan Elmer,Australia,0,1,0,1,1992
Dean Evans,Australia,0,1,0,1,1992
Paul Lewis,Australia,0,1,0,1,1992
Graham Reid,Australia,0,1,0,1,1992
Jay Stacy,Australia,0,1,0,1,1992
David Wansbrough,Australia,0,1,0,1,1992
Ken Wark,Australia,0,1,0,1,1992
Michael York,Australia,0,1,0,1,1992
Britta Becker,Germany,0,1,0,1,1992
Tanja Dickenscheid,Germany,0,1,0,1,1992
Nadine Ernsting-Krienke,Germany,0,1,0,1,1992
Christine Ferneck,Germany,0,1,0,1,1992
Eva Hagenbäumer,Germany,0,1,0,1,1992
Franziska Hentschel,Germany,0,1,0,1,1992
Caren Jungjohann,Germany,0,1,0,1,1992
Katrin Kauschke,Germany,0,1,0,1,1992
Irina Kuhnt,Germany,0,1,0,1,1992
Heike Lätzsch,Germany,0,1,0,1,1992
Susanne Müller,Germany,0,1,0,1,1992
Tina Peters,Germany,0,1,0,1,1992
Simone Thomaschinski-Gräßer,Germany,0,1,0,1,1992
Bianca Weiß,Germany,0,1,0,1,1992
Anke Wild,Germany,0,1,0,1,1992
Susanne Wollschläger,Germany,0,1,0,1,1992
Wang Huifeng,People's Republic of China,0,1,0,1,1992
Annette Dobmeier,Germany,0,1,0,1,1992
Anja Fichtel-Mauritz,Germany,0,1,0,1,1992
Zita Funkenhauser,Germany,0,1,0,1,1992
Monika Weber-Koszto,Germany,0,1,0,1,1992
Guillermo Betancourt,Cuba,0,1,0,1,1992
Tulio Díaz,Cuba,0,1,0,1,1992
Hermenegildo García,Cuba,0,1,0,1,1992
Óscar García,Cuba,0,1,0,1,1992
Péter Abay,Hungary,0,1,0,1,1992
Imre Bujdosó,Hungary,0,1,0,1,1992
Ferenc Hegedűs,Hungary,0,1,0,1,1992
Ernő Kolczonay,Hungary,0,1,0,1,1992
Iván Kovács,Hungary,0,1,0,1,1992
Krisztián Kulcsár,Hungary,0,1,0,1,1992
Csaba Köves,Hungary,0,1,0,1,1992
György Nébald,Hungary,0,1,0,1,1992
Gábor Totola,Hungary,0,1,0,1,1992
Marco Marin,Italy,0,1,0,1,1992
Serhiy Holubytskyi,Ukraine,0,1,0,1,1992
Dariusz Adamczuk,Poland,0,1,0,1,1992
Marek Bajor,Poland,0,1,0,1,1992
Jerzy Brzęczek,Poland,0,1,0,1,1992
Dariusz Gęsior,Poland,0,1,0,1,1992
Marcin Jałocha,Poland,0,1,0,1,1992
Andrzej Juskowiak,Poland,0,1,0,1,1992
Aleksander Kłak,Poland,0,1,0,1,1992
Andrzej Kobylański,Poland,0,1,0,1,1992
Wojciech Kowalczyk,Poland,0,1,0,1,1992
Marek Koźmiński,Poland,0,1,0,1,1992
Tomasz Łapiński,Poland,0,1,0,1,1992
Grzegorz Mielcarski,Poland,0,1,0,1,1992
Ryszard Staniek,Poland,0,1,0,1,1992
Piotr Świerczewski,Poland,0,1,0,1,1992
Tomasz Wałdoch,Poland,0,1,0,1,1992
Mirosław Waligóra,Poland,0,1,0,1,1992
Carolina Pascual,Spain,0,1,0,1,1992
Gina Gogean,Romania,0,1,0,1,1992
Vanda Hădărean,Romania,0,1,0,1,1992
Maria Neculiță,Romania,0,1,0,1,1992
Mirela Pașca,Romania,0,1,0,1,1992
Li Chunyang,People's Republic of China,0,1,0,1,1992
Li Dashuang,People's Republic of China,0,1,0,1,1992
Li Ge,People's Republic of China,0,1,0,1,1992
Mona Dahle,Norway,0,1,0,1,1992
Kristine Duvholt,Norway,0,1,0,1,1992
Siri Eftedal,Norway,0,1,0,1,1992
Hege Frøseth,Norway,0,1,0,1,1992
Susann Goksør-Bjerkrheim,Norway,0,1,0,1,1992
Henriette Henriksen,Norway,0,1,0,1,1992
Hanne Hogness,Norway,0,1,0,1,1992
Karin Pettersen,Norway,0,1,0,1,1992
Tonje Sagstuen,Norway,0,1,0,1,1992
Annette Skotvoll,Norway,0,1,0,1,1992
Ingrid Steen,Norway,0,1,0,1,1992
Heidi Sundal,Norway,0,1,0,1,1992
Cathrine Svendsen,Norway,0,1,0,1,1992
Heidi Tjugum,Norway,0,1,0,1,1992
Magnus Andersson,Sweden,0,1,0,1,1992
Robert Andersson,Sweden,0,1,0,1,1992
Anders Bäckegren,Sweden,0,1,0,1,1992
Per Carlén,Sweden,0,1,0,1,1992
Magnus Cato,Sweden,0,1,0,1,1992
Erik Hajas,Sweden,0,1,0,1,1992
Robert Hedin,Sweden,0,1,0,1,1992
Patrik Liljestrand,Sweden,0,1,0,1,1992
Ola Lindgren,Sweden,0,1,0,1,1992
Mats Olsson,Sweden,0,1,0,1,1992
Staffan Olsson,Sweden,0,1,0,1,1992
Axel Sjöblad,Sweden,0,1,0,1,1992
Tommy Suoraniemi,Sweden,0,1,0,1,1992
Tomas Svensson,Sweden,0,1,0,1,1992
Pierre Thorsson,Sweden,0,1,0,1,1992
Magnus Wislander,Sweden,0,1,0,1,1992
Yael Arad,Israel,0,1,0,1,1992
Nicola Fairbrother,Great Britain,0,1,0,1,1992
Noriko Mizoguchi,Japan,0,1,0,1,1992
Emanuela Pierantozzi,Italy,0,1,0,1,1992
Estela Rodríguez,Cuba,0,1,0,1,1992
Ryoko Tamura-Tani,Japan,0,1,0,1,1992
Yoko Tanabe,Japan,0,1,0,1,1992
József Csák,Hungary,0,1,0,1,1992
Bertalan Hajtós,Hungary,0,1,0,1,1992
Jason Morris,United States,0,1,0,1,1992
Naoya Ogawa,Japan,0,1,0,1,1992
Ray Stevens,Great Britain,0,1,0,1,1992
Pascal Tayot,France,0,1,0,1,1992
Yun Hyeon,Republic of Korea,0,1,0,1,1992
Attila Mizsér,Hungary,0,1,0,1,1992
Dmitry Svatkovsky,Russian Federation,0,1,0,1,1992
Anatoly Starostin,Russian Federation,0,1,0,1,1992
Arnold Jonke,Austria,0,1,0,1,1992
Christoph Zerbst,Austria,0,1,0,1,1992
Annelies Bredael,Belgium,0,1,0,1,1992
"Václav Chalupa, Jr.",Czech Republic,0,1,0,1,1992
Inge Althoff-Schwerzmann,Germany,0,1,0,1,1992
Stefani Werremeier,Germany,0,1,0,1,1992
Ralf Brudel,East Germany,0,1,0,1,1992
Colin von Ettingshausen,Germany,0,1,0,1,1992
Karsten Finger,Germany,0,1,0,1,1992
Peter Hoeltzenbein,Germany,0,1,0,1,1992
Uwe Kellner,Germany,0,1,0,1,1992
Thoralf Peters,Germany,0,1,0,1,1992
Hendrik Reiher,East Germany,0,1,0,1,1992
Carmine Abbagnale,Italy,0,1,0,1,1992
Giuseppe Abbagnale,Italy,0,1,0,1,1992
Giuseppe Di Capua,Italy,0,1,0,1,1992
Lars Bjønnes,Norway,0,1,0,1,1992
Per Sætersdal,Norway,0,1,0,1,1992
Rolf Thorsen,Norway,0,1,0,1,1992
Kjetil Undset,Norway,0,1,0,1,1992
Anișoara Bălan-Dobre,Romania,0,1,0,1,1992
Doina Liliana Snep-Bălan,Romania,0,1,0,1,1992
Iulia Bobeică-Bulie,Romania,0,1,0,1,1992
Constanța Pipotă-Burcică,Romania,0,1,0,1,1992
Adriana Chelariu-Bazon,Romania,0,1,0,1,1992
Doina Ciucanu-Robu,Romania,0,1,0,1,1992
Elena Georgescu,Romania,0,1,0,1,1992
Doina Ignat,Romania,0,1,0,1,1992
Victoria Lepădatu,Romania,0,1,0,1,1992
Veronica Necula,Romania,0,1,0,1,1992
Maria Pădurariu,Romania,0,1,0,1,1992
Dănuț Dobre,Romania,0,1,0,1,1992
Marin Gheorghe,Romania,0,1,0,1,1992
Gabriel Marin,Romania,0,1,0,1,1992
Vasile Măstăcan,Romania,0,1,0,1,1992
Vasile Năstase,Romania,0,1,0,1,1992
Valentin Robu,Romania,0,1,0,1,1992
Ioan Vizitiu,Romania,0,1,0,1,1992
Shelagh Donohoe,United States,0,1,0,1,1992
Cindy Eckert,United States,0,1,0,1,1992
Carol Feeney,United States,0,1,0,1,1992
Amy Fuller,United States,0,1,0,1,1992
Tom Bohrer,United States,0,1,0,1,1992
Doug Burden,United States,0,1,0,1,1992
"Pat Manning, Jr.",United States,0,1,0,1,1992
Jeff McLaughlin,United States,0,1,0,1,1992
Vesela Lecheva,Bulgaria,0,1,0,1,1992
Nonka Matova,Bulgaria,0,1,0,1,1992
Li Duihong,People's Republic of China,0,1,0,1,1992
Franck Badiou,France,0,1,0,1,1992
Kazumi Watanabe,Japan,0,1,0,1,1992
Afanasijs Kuzmins,Latvia,0,1,0,1,1992
Harald Stenvaag,Norway,0,1,0,1,1992
"Juan Jorge Giha, Jr.",Peru,0,1,0,1,1992
Anatoly Asrabayev,Russian Federation,0,1,0,1,1992
Sergey Pyzhyanov,Russian Federation,0,1,0,1,1992
Robert Foth,United States,0,1,0,1,1992
Jasna Šekarić,Individual Olympic Athletes,0,1,0,1,1992
Glen Housman,Australia,0,1,0,1,1992
Gustavo Borges,Brazil,0,1,0,1,1992
Penny Vilagos,Canada,0,1,0,1,1992
Vicky Vilagos,Canada,0,1,0,1,1992
Le Jingyi,People's Republic of China,0,1,0,1,1992
Lu Bin,People's Republic of China,0,1,0,1,1992
Wang Xiaohong,People's Republic of China,0,1,0,1,1992
Zhao Kun,People's Republic of China,0,1,0,1,1992
Tan Liangde,People's Republic of China,0,1,0,1,1992
Daniela Brendel,Germany,0,1,0,1,1992
Jana Dörries,Germany,0,1,0,1,1992
Bettina Ustrowski,Germany,0,1,0,1,1992
Tünde Szabó,Hungary,0,1,0,1,1992
Danyon Loader,New Zealand,0,1,0,1,1992
Rafał Szukała,Poland,0,1,0,1,1992
Irina Lashko,Australia,0,1,0,1,1992
Vladislav Kulikov,Russian Federation,0,1,0,1,1992
Lars Frölander,Sweden,0,1,0,1,1992
Christer Wallin,Sweden,0,1,0,1,1992
Tom Werner,Sweden,0,1,0,1,1992
Yelena Miroshina,Russian Federation,0,1,0,1,1992
Iurie Başcatov,Republic of Moldova,0,1,0,1,1992
Vasily Ivanov,Russian Federation,0,1,0,1,1992
Gennady Prigoda,Russian Federation,0,1,0,1,1992
Dmitry Volkov,Russian Federation,0,1,0,1,1992
Greg Burgess,United States,0,1,0,1,1992
Scott Donie,United States,0,1,0,1,1992
Eric Namesnik,United States,0,1,0,1,1992
Edwin Benne,Netherlands,0,1,0,1,1992
Peter Blangé,Netherlands,0,1,0,1,1992
Ron Boudrie,Netherlands,0,1,0,1,1992
Henk Jan Held,Netherlands,0,1,0,1,1992
Marko Klok,Netherlands,0,1,0,1,1992
Jan Posthuma,Netherlands,0,1,0,1,1992
Avital Selinger,Netherlands,0,1,0,1,1992
Martin Teffer,Netherlands,0,1,0,1,1992
Martin van der Horst,Netherlands,0,1,0,1,1992
Olof van der Meulen,Netherlands,0,1,0,1,1992
Ronald Zoodsma,Netherlands,0,1,0,1,1992
Ron Zwerver,Netherlands,0,1,0,1,1992
Yevgeniya Artamonova-Estes,Russian Federation,0,1,0,1,1992
Yelena Batukhtina-Tyurina,Russian Federation,0,1,0,1,1992
Nataliya Morozova,Russian Federation,0,1,0,1,1992
Marina Nikulina-Pankova,Russian Federation,0,1,0,1,1992
Valentina Ogiyenko,Russian Federation,0,1,0,1,1992
Svetlana Korytova,Russian Federation,0,1,0,1,1992
Jelena Ovchinnikova-Čebukina,Croatia,0,1,0,1,1992
Irina Smirnova-Ilchenko,Russian Federation,0,1,0,1,1992
Daniel Ballart,Spain,0,1,0,1,1992
Manuel Estiarte,Spain,0,1,0,1,1992
Pedro García,Spain,0,1,0,1,1992
Salvador Gómez,Spain,0,1,0,1,1992
Marco Antonio González,Spain,0,1,0,1,1992
Rubén Michavila,Spain,0,1,0,1,1992
Miki Oca,Spain,0,1,0,1,1992
Sergio Pedrerol,Spain,0,1,0,1,1992
Josep Picó,Spain,0,1,0,1,1992
Jesús Miguel Rollán,Spain,0,1,0,1,1992
Ricardo Sánchez,Spain,0,1,0,1,1992
Jordi Sans,Spain,0,1,0,1,1992
Yoto Yotov,Bulgaria,0,1,0,1,1992
Nikolaj Pešalov,Bulgaria,0,1,0,1,1992
Lin Qisheng,People's Republic of China,0,1,0,1,1992
Liu Shoubin,People's Republic of China,0,1,0,1,1992
Pablo Lara,Cuba,0,1,0,1,1992
Krzysztof Siemion,Poland,0,1,0,1,1992
Sergey Syrtsov,Russian Federation,0,1,0,1,1992
Tymur Taimazov,Ukraine,0,1,0,1,1992
Artur Akoyev,Russian Federation,0,1,0,1,1992
Leonid Taranenko,Belarus,0,1,0,1,1992
Siarhei Smal,Belarus,0,1,0,1,1992
Valentin Getsov,Bulgaria,0,1,0,1,1992
Jeff Thue,Canada,0,1,0,1,1992
Heiko Balz,Germany,0,1,0,1,1992
Alfred Ter-Mkrtchyan,Armenia,0,1,0,1,1992
Rifat Yildiz,Germany,0,1,0,1,1992
Asgari Mohammadian,Islamic Republic of Iran,0,1,0,1,1992
Vincenzo Maenza,Italy,0,1,0,1,1992
Kim Jong-Sin,Republic of Korea,0,1,0,1,1992
Piotr Stępień,Poland,0,1,0,1,1992
Józef Tracz,Poland,0,1,0,1,1992
Sergey Martynov,Russian Federation,0,1,0,1,1992
Tomas Johansson,Sweden,0,1,0,1,1992
Hakkı Başar,Turkey,0,1,0,1,1992
Kenan Şimşek,Turkey,0,1,0,1,1992
İslam Duquçiyev,Azerbaijan,0,1,0,1,1992
Elmadi Zhabrailov,Kazakhstan,0,1,0,1,1992
Zeke Jones,United States,0,1,0,1,1992
Dennis Koslowski,United States,0,1,0,1,1992
Kenny Monday,United States,0,1,0,1,1992
Leslie Egnot,New Zealand,0,1,0,1,1992
Jan Shearer,New Zealand,0,1,0,1,1992
Natalia Vía Dufresne,Spain,0,1,0,1,1992
Zhang Xiaodong,People's Republic of China,0,1,0,1,1992
Stephen Bourdow,United States,0,1,0,1,1992
Jim Brady,United States,0,1,0,1,1992
Kevin Burnham,United States,0,1,0,1,1992
Don Cowie,New Zealand,0,1,0,1,1992
Rod Davis,New Zealand,0,1,0,1,1992
Paul Foerster,United States,0,1,0,1,1992
Mike Gebhardt,United States,0,1,0,1,1992
Doug Kern,United States,0,1,0,1,1992
Brian Ledbetter,United States,0,1,0,1,1992
Kevin Mahaney,United States,0,1,0,1,1992
Keith Notary,United States,0,1,0,1,1992
Morgan Reeser,United States,0,1,0,1,1992
Randy Smyth,United States,0,1,0,1,1992
Natallia Shykalenka,Belarus,0,1,0,1,1992
Ihar Astapkovich,Belarus,0,1,0,1,1992
Tsvetanka Khristova,Bulgaria,0,1,0,1,1992
Guillaume LeBlanc,Canada,0,1,0,1,1992
Huang Zhihong,People's Republic of China,0,1,0,1,1992
Roberto Hernández,Cuba,0,1,0,1,1992
Héctor Herrera,Cuba,0,1,0,1,1992
Lázaro Martínez,Cuba,0,1,0,1,1992
Norberto Téllez,Cuba,0,1,0,1,1992
Antonio Peñalver,Spain,0,1,0,1,1992
Seppo Räty,Finland,0,1,0,1,1992
Alina Astafei,Germany,0,1,0,1,1992
Jürgen Schult,East Germany,0,1,0,1,1992
Winthrop Graham,Jamaica,0,1,0,1,1992
Yuko Arimori,Japan,0,1,0,1,1992
Koichi Morishita,Japan,0,1,0,1,1992
Paul Bitok,Kenya,0,1,0,1,1992
Richard Chelimo,Kenya,0,1,0,1,1992
Nixon Kiprotich,Kenya,0,1,0,1,1992
Patrick Sang,Kenya,0,1,0,1,1992
Rachid El-Basir,Morocco,0,1,0,1,1992
Carlos Mercenario,Mexico,0,1,0,1,1992
Olapade Adeniken,Nigeria,0,1,0,1,1992
Davidson Ezinwa,Nigeria,0,1,0,1,1992
Osmond Ezinwa,Nigeria,0,1,0,1,1992
Chidi Imoh,Nigeria,0,1,0,1,1992
Oluyemi Kayode,Nigeria,0,1,0,1,1992
Elana Meyer,South Africa,0,1,0,1,1992
Galina Malchugina,Russian Federation,0,1,0,1,1992
Yelena Nikolayeva,Russian Federation,0,1,0,1,1992
Lyudmila Rogachova,Russian Federation,0,1,0,1,1992
Marina Trandenkova,Russian Federation,0,1,0,1,1992
Igor Trandenkov,Russian Federation,0,1,0,1,1992
Patrik Sjöberg,Sweden,0,1,0,1,1992
Inesa Kravets,Soviet Union,0,1,0,1,1992
Irina Belova,Russian Federation,0,1,0,1,1992
Olga Bogoslovskaya,Russian Federation,0,1,0,1,1992
Tatyana Samolenko-Dorovskikh,Soviet Union,0,1,0,1,1992
Sandra Farmer-Patrick,Jamaica,0,1,0,1,1992
Denean Howard-Hill,United States,0,1,0,1,1992
Natasha Kaiser-Brown,United States,0,1,0,1,1992
LaVonna Martin,United States,0,1,0,1,1992
Jearl Miles-Clark,United States,0,1,0,1,1992
Rochelle Stevens,United States,0,1,0,1,1992
Dannette Young,United States,0,1,0,1,1992
Tony Dees,United States,0,1,0,1,1992
Jim Doehring,United States,0,1,0,1,1992
Mike Powell,United States,0,1,0,1,1992
Charlie Simpkins,United States,0,1,0,1,1992
Ioana Olteanu,Romania,0,1,0,1,1992
Sabine Bau,Germany,0,1,0,1,1992
Amy Van Dyken,United States,4,0,0,4,1996
Michelle Smith,Ireland,3,0,1,4,1996
Jenny Thompson,United States,3,0,0,3,1996
Josh Davis,United States,3,0,0,3,1996
Aleksandr Popov,Russian Federation,2,2,0,4,1996
"Gary Hall, Jr.",United States,2,2,0,4,1996
Aleksey Nemov,Russian Federation,2,1,3,6,1996
Liliya Podkopaieva,Ukraine,2,1,0,3,1996
Denis Pankratov,Russian Federation,2,1,0,3,1996
Angel Martino,United States,2,0,2,4,1996
Deng Yaping,People's Republic of China,2,0,0,2,1996
Kim Gyeong-Uk,Republic of Korea,2,0,0,2,1996
Justin Huish,United States,2,0,0,2,1996
Liu Guoliang,People's Republic of China,2,0,0,2,1996
Martin Doktor,Czech Republic,2,0,0,2,1996
Antonio Rossi,Italy,2,0,0,2,1996
Isabell Werth,Germany,2,0,0,2,1996
Uli Kirchhoff,Germany,2,0,0,2,1996
Laura Flessel-Colovic,France,2,0,0,2,1996
Stanislav Pozdnyakov,Russian Federation,2,0,0,2,1996
Shannon Miller,United States,2,0,0,2,1996
Fu Mingxia,People's Republic of China,2,0,0,2,1996
Danyon Loader,New Zealand,2,0,0,2,1996
Penny Heyns,South Africa,2,0,0,2,1996
Beth Botsford,United States,2,0,0,2,1996
Catherine Fox,United States,2,0,0,2,1996
Lisa Jacob,United States,2,0,0,2,1996
Jon Olsen,United States,2,0,0,2,1996
Jeff Rouse,United States,2,0,0,2,1996
Brad Schumacher,United States,2,0,0,2,1996
Donovan Bailey,Canada,2,0,0,2,1996
Marie-José Pérec,France,2,0,0,2,1996
Svetlana Masterkova,Russian Federation,2,0,0,2,1996
Gail Devers,United States,2,0,0,2,1996
Michael Johnson,United States,2,0,0,2,1996
Li Xiaoshuang,People's Republic of China,1,2,0,3,1996
Le Jingyi,People's Republic of China,1,2,0,3,1996
Amanda Beard,United States,1,2,0,3,1996
Whitney Hedgepeth,United States,1,2,0,3,1996
Simona Amânar,Romania,1,1,2,4,1996
Susie O'Neill,Australia,1,1,1,3,1996
Gil Yeong-Ah,Republic of Korea,1,1,0,2,1996
Ramona Portwich,East Germany,1,1,0,2,1996
Birgit Fischer-Schmidt,East Germany,1,1,0,2,1996
Kay Bluhm,East Germany,1,1,0,2,1996
Torsten Gutsche,Germany,1,1,0,2,1996
Daniele Scarpa,Italy,1,1,0,2,1996
Knut Holmann,Norway,1,1,0,2,1996
Jeannie Longo-Ciprelli,France,1,1,0,2,1996
Philippe Ermenault,France,1,1,0,2,1996
Valérie Barlois-Mevel-Leroux,France,1,1,0,2,1996
Valentina Vezzali,Italy,1,1,0,2,1996
Laura Cârlescu-Badea,Romania,1,1,0,2,1996
Aleksandr Beketov,Russian Federation,1,1,0,2,1996
Sergey Sharikov,Russian Federation,1,1,0,2,1996
Svetlana Khorkina,Russian Federation,1,1,0,2,1996
Amy Chow,United States,1,1,0,2,1996
Jeremy Linn,United States,1,1,0,2,1996
Tripp Schwenk,United States,1,1,0,2,1996
Wang Junxia,People's Republic of China,1,1,0,2,1996
Qiao Hong,People's Republic of China,1,0,1,2,1996
Csaba Horváth,Hungary,1,0,1,2,1996
György Kolonics,Hungary,1,0,1,2,1996
Agneta Andersson,Sweden,1,0,1,2,1996
Blyth Tait,New Zealand,1,0,1,2,1996
Giovanna Trillini,Italy,1,0,1,2,1996
Dominique Dawes,United States,1,0,1,2,1996
Rustam Sharipov,Ukraine,1,0,1,2,1996
Kathleen Heddle,Canada,1,0,1,2,1996
Marnie McBean,Canada,1,0,1,2,1996
Jean-Pierre Amat,France,1,0,1,2,1996
Roberto Di Donna,Italy,1,0,1,2,1996
Renata Mauer-Różańska,Poland,1,0,1,2,1996
Aleksandra Ivošev,Individual Olympic Athletes,1,0,1,2,1996
Krisztina Egerszegi,Hungary,1,0,1,2,1996
Gwen Torrence,United States,1,0,1,2,1996
Rexy Mainaky,Indonesia,1,0,0,1,1996
Ricky Subagja,Indonesia,1,0,0,1,1996
Todd Woodbridge,Australia,1,0,0,1,1996
Mark Woodforde,Australia,1,0,0,1,1996
Ge Fei,People's Republic of China,1,0,0,1,1996
Gu Jun,People's Republic of China,1,0,0,1,1996
Bang Su-Hyeon,Republic of Korea,1,0,0,1,1996
Kim Dong-Mun,Republic of Korea,1,0,0,1,1996
Laura Berg,United States,1,0,0,1,1996
Gillian Boxx,United States,1,0,0,1,1996
Sheila Cornell-Douty,United States,1,0,0,1,1996
Lisa Fernandez,United States,1,0,0,1,1996
Michele Granger,United States,1,0,0,1,1996
Lori Harrigan,United States,1,0,0,1,1996
Dionna Harris,United States,1,0,0,1,1996
Kim Maher,United States,1,0,0,1,1996
Leah O'Brien-Amico,United States,1,0,0,1,1996
Dot Richardson,United States,1,0,0,1,1996
Julie Smith,United States,1,0,0,1,1996
Michele Smith,United States,1,0,0,1,1996
Shelly Stokes,United States,1,0,0,1,1996
Dani Tyler,United States,1,0,0,1,1996
Christa Williams,United States,1,0,0,1,1996
Omar Ajete,Cuba,1,0,0,1,1996
Miguel Caldés,Cuba,1,0,0,1,1996
José Contreras,Cuba,1,0,0,1,1996
José Antonio Estrada,Cuba,1,0,0,1,1996
Jorge Fumero,Cuba,1,0,0,1,1996
Alberto Hernández,Cuba,1,0,0,1,1996
Rey Isaac,Cuba,1,0,0,1,1996
Orestes Kindelán,Cuba,1,0,0,1,1996
Pedro Luis Lazo,Cuba,1,0,0,1,1996
Omar Linares,Cuba,1,0,0,1,1996
Omar Luis,Cuba,1,0,0,1,1996
Juan Manrique,Cuba,1,0,0,1,1996
Eliécer Montes,Cuba,1,0,0,1,1996
Antonio Pacheco,Cuba,1,0,0,1,1996
Juan Padilla,Cuba,1,0,0,1,1996
Eduardo Paret,Cuba,1,0,0,1,1996
Ormari Romero,Cuba,1,0,0,1,1996
Antonio Scull,Cuba,1,0,0,1,1996
Luis Ulacia,Cuba,1,0,0,1,1996
Lázaro Vargas,Cuba,1,0,0,1,1996
Ariel Hernández,Cuba,1,0,0,1,1996
Maikro Romero,Cuba,1,0,0,1,1996
Félix Savón,Cuba,1,0,0,1,1996
Héctor Vinent,Cuba,1,0,0,1,1996
Kim Jo-Sun,Republic of Korea,1,0,0,1,1996
Yun Hye-Yeong,Republic of Korea,1,0,0,1,1996
Butch Johnson,United States,1,0,0,1,1996
Rod White,United States,1,0,0,1,1996
Kong Linghui,People's Republic of China,1,0,0,1,1996
Poul-Erik Høyer Larsen,Denmark,1,0,0,1,1996
Lindsay Davenport,United States,1,0,0,1,1996
Gigi Fernandez,Puerto Rico,1,0,0,1,1996
Mary Joe Fernandez,United States,1,0,0,1,1996
Andre Agassi,United States,1,0,0,1,1996
Hocine Soltani,Algeria,1,0,0,1,1996
István Kovács,Hungary,1,0,0,1,1996
Vasily Zhirov,Kazakhstan,1,0,0,1,1996
Jennifer Azzi,United States,1,0,0,1,1996
Ruthie Bolton-Holifield,United States,1,0,0,1,1996
Teresa Edwards,United States,1,0,0,1,1996
Venus Lacy,United States,1,0,0,1,1996
Lisa Leslie,United States,1,0,0,1,1996
Rebecca Lobo,United States,1,0,0,1,1996
Katrina McClain,United States,1,0,0,1,1996
Nikki McCray,United States,1,0,0,1,1996
Carla McGhee,United States,1,0,0,1,1996
Dawn Staley,United States,1,0,0,1,1996
Katy Steding,United States,1,0,0,1,1996
Sheryl Swoopes,United States,1,0,0,1,1996
Charles Barkley,United States,1,0,0,1,1996
Penny Hardaway,United States,1,0,0,1,1996
Grant Hill,United States,1,0,0,1,1996
Karl Malone,United States,1,0,0,1,1996
Reggie Miller,United States,1,0,0,1,1996
Shaquille O'Neal,United States,1,0,0,1,1996
Hakeem Olajuwon,United States,1,0,0,1,1996
Gary Payton,United States,1,0,0,1,1996
Scottie Pippen,United States,1,0,0,1,1996
Mitch Richmond,United States,1,0,0,1,1996
David Robinson,United States,1,0,0,1,1996
John Stockton,United States,1,0,0,1,1996
Daniel Bozhinov,Bulgaria,1,0,0,1,1996
Oleg Saitov,Russian Federation,1,0,0,1,1996
Somluck Kamsing,Thailand,1,0,0,1,1996
Wladimir Klitschko,Ukraine,1,0,0,1,1996
David Reid,United States,1,0,0,1,1996
Štěpánka Hilgertová,Czech Republic,1,0,0,1,1996
Franck Adisson,France,1,0,0,1,1996
Wilfrid Forgues,France,1,0,0,1,1996
Manuela Mucke,Germany,1,0,0,1,1996
Anett Schuck,Germany,1,0,0,1,1996
Andreas Dittmer,Germany,1,0,0,1,1996
Oliver Fix,Germany,1,0,0,1,1996
Detlef Hofmann,Germany,1,0,0,1,1996
Gunar Kirchbach,Germany,1,0,0,1,1996
Thomas Reineck,Germany,1,0,0,1,1996
Olaf Winter,Germany,1,0,0,1,1996
Mark Zabel,Germany,1,0,0,1,1996
Rita Kőbán,Hungary,1,0,0,1,1996
Michal Martikán,Slovakia,1,0,0,1,1996
Susanne Wiberg-Gunnarsson,Sweden,1,0,0,1,1996
Gillian Rolton,Australia,1,0,0,1,1996
Wendy Schaeffer,Australia,1,0,0,1,1996
Monica Theodorescu,Germany,1,0,0,1,1996
Klaus Balkenhol,Germany,1,0,0,1,1996
Ludger Beerbaum,Germany,1,0,0,1,1996
Phillip Dutton,Australia,1,0,0,1,1996
Andrew Hoy,Australia,1,0,0,1,1996
Lars Nieberg,Germany,1,0,0,1,1996
Martin Schaudt,Germany,1,0,0,1,1996
Franke Sloothaak,Germany,1,0,0,1,1996
Félicia Ballanger,France,1,0,0,1,1996
Antonella Bellutti,Italy,1,0,0,1,1996
Nathalie Even-Lancien,France,1,0,0,1,1996
Paola Pezzo,Italy,1,0,0,1,1996
Zulfiya Zabirova,Kazakhstan,1,0,0,1,1996
Bart Brentjens,Netherlands,1,0,0,1,1996
Christophe Capelle,France,1,0,0,1,1996
Andrea Collinelli,Italy,1,0,0,1,1996
Jens Fiedler,Germany,1,0,0,1,1996
Miguel Induráin,Spain,1,0,0,1,1996
Silvio Martinello,Italy,1,0,0,1,1996
Jean-Michel Monin,France,1,0,0,1,1996
Francis Moreau,France,1,0,0,1,1996
Pascal Richard,Switzerland,1,0,0,1,1996
Florian Rousseau,France,1,0,0,1,1996
Shelley Andrews,Australia,1,0,0,1,1996
Alyson Annan,Australia,1,0,0,1,1996
Louise Dobson,Australia,1,0,0,1,1996
Renita Farrell-Garard,Australia,1,0,0,1,1996
Juliet Haslam,Australia,1,0,0,1,1996
Rechelle Hawkes,Australia,1,0,0,1,1996
Clover Maitland,Australia,1,0,0,1,1996
Karen Marsden,Australia,1,0,0,1,1996
Jenny Morris,Australia,1,0,0,1,1996
Jackie Pereira,Australia,1,0,0,1,1996
Nova Peris-Kneebone,Australia,1,0,0,1,1996
Triny Powell,Australia,1,0,0,1,1996
Lisa Powell-Carruthers,Australia,1,0,0,1,1996
Danni Roche,Australia,1,0,0,1,1996
Kate Starre,Australia,1,0,0,1,1996
Liane Tooth,Australia,1,0,0,1,1996
Floris Jan Bovelander,Netherlands,1,0,0,1,1996
Jacques Brinkman,Netherlands,1,0,0,1,1996
Maurits Crucq,Netherlands,1,0,0,1,1996
Teun de Nooijer,Netherlands,1,0,0,1,1996
Marc Delissen,Netherlands,1,0,0,1,1996
Jeroen Delmeé,Netherlands,1,0,0,1,1996
Ronald Jansen,Netherlands,1,0,0,1,1996
Erik Jazet,Netherlands,1,0,0,1,1996
Leo Klein Gebbink,Netherlands,1,0,0,1,1996
Bram Lomans,Netherlands,1,0,0,1,1996
Taco van den Honert,Netherlands,1,0,0,1,1996
Tycho van Meer,Netherlands,1,0,0,1,1996
Wouter van Pelt,Netherlands,1,0,0,1,1996
Remco van Wijk,Netherlands,1,0,0,1,1996
Stephan Veen,Netherlands,1,0,0,1,1996
Guus Vogels,Netherlands,1,0,0,1,1996
Sophie Moressée-Pichot,France,1,0,0,1,1996
Francesca Bortolozzi-Borella,Italy,1,0,0,1,1996
Sandro Cuomo,Italy,1,0,0,1,1996
Angelo Mazzoni,Italy,1,0,0,1,1996
Alessandro Puccini,Italy,1,0,0,1,1996
Maurizio Randazzo,Italy,1,0,0,1,1996
Grigory Kiriyenko,Russian Federation,1,0,0,1,1996
Ilgar Mamedov,Russian Federation,1,0,0,1,1996
Vladislav Pavlovich,Russian Federation,1,0,0,1,1996
Dmitry Shevchenko,Russian Federation,1,0,0,1,1996
Daniel Amokachi,Nigeria,1,0,0,1,1996
Emmanuel Amunike,Nigeria,1,0,0,1,1996
Tijani Babangida,Nigeria,1,0,0,1,1996
Celestine Babayaro,Nigeria,1,0,0,1,1996
Joseph Dosu,Nigeria,1,0,0,1,1996
Teslim Fatusi,Nigeria,1,0,0,1,1996
Victor Ikpeba,Nigeria,1,0,0,1,1996
Nwankwo Kanu,Nigeria,1,0,0,1,1996
Garba Lawal,Nigeria,1,0,0,1,1996
Abiodun Obafemi,Nigeria,1,0,0,1,1996
Mobi Oparaku,Nigeria,1,0,0,1,1996
Jay-Jay Okocha,Nigeria,1,0,0,1,1996
Sunday Oliseh,Nigeria,1,0,0,1,1996
Wilson Oruma,Nigeria,1,0,0,1,1996
Uche Okechukwu,Nigeria,1,0,0,1,1996
Taribo West,Nigeria,1,0,0,1,1996
Michelle Akers,United States,1,0,0,1,1996
Brandi Chastain,United States,1,0,0,1,1996
Joy Fawcett,United States,1,0,0,1,1996
Julie Foudy,United States,1,0,0,1,1996
Carin Gabarra,United States,1,0,0,1,1996
Mia Hamm,United States,1,0,0,1,1996
Kristine Lilly,United States,1,0,0,1,1996
Shannon MacMillan,United States,1,0,0,1,1996
Tiffeny Milbrett,United States,1,0,0,1,1996
Carla Overbeck,United States,1,0,0,1,1996
Cindy Parlow,United States,1,0,0,1,1996
Tiffany Roberts,United States,1,0,0,1,1996
Briana Scurry,United States,1,0,0,1,1996
Tisha Venturini,United States,1,0,0,1,1996
Marta Baldó,Spain,1,0,0,1,1996
Núria Cabanillas,Spain,1,0,0,1,1996
Estela Giménez,Spain,1,0,0,1,1996
Lorena Guréndez,Spain,1,0,0,1,1996
Tania Lamarca,Spain,1,0,0,1,1996
Estíbaliz Martínez,Spain,1,0,0,1,1996
Kateryna Serebrianska,Ukraine,1,0,0,1,1996
Amanda Borden,United States,1,0,0,1,1996
Dominique Moceanu,United States,1,0,0,1,1996
Jaycie Phelps,United States,1,0,0,1,1996
Kerri Strug,United States,1,0,0,1,1996
Andreas Wecker,East Germany,1,0,0,1,1996
Ioannis Melissanidis,Greece,1,0,0,1,1996
Jury Chechi,Italy,1,0,0,1,1996
Sergey Kharkov,Russian Federation,1,0,0,1,1996
Nikolay Kryukov,Russian Federation,1,0,0,1,1996
Yevgeny Podgorny,Russian Federation,1,0,0,1,1996
Dmitry Trush,Russian Federation,1,0,0,1,1996
Dmitry Vasilenko,Russian Federation,1,0,0,1,1996
Aleksey Voropayev,Russian Federation,1,0,0,1,1996
Donghua Li,Switzerland,1,0,0,1,1996
Patrik Ćavar,Croatia,1,0,0,1,1996
Valner Franković,Croatia,1,0,0,1,1996
Slavko Goluža,Croatia,1,0,0,1,1996
Bruno Gudelj,Croatia,1,0,0,1,1996
Vladimir Jelčić,Croatia,1,0,0,1,1996
Božidar Jović,Croatia,1,0,0,1,1996
Nenad Kljaić,Croatia,1,0,0,1,1996
Venio Losert,Croatia,1,0,0,1,1996
Valter Matošević,Croatia,1,0,0,1,1996
Zoran Mikulić,Croatia,1,0,0,1,1996
Alvaro Načinović,Croatia,1,0,0,1,1996
Goran Perkovac,Croatia,1,0,0,1,1996
Iztok Puc,Croatia,1,0,0,1,1996
Zlatan Saračević,Croatia,1,0,0,1,1996
Vladimir Šujster,Croatia,1,0,0,1,1996
Anja Andersen,Denmark,1,0,0,1,1996
Camilla Andersen,Denmark,1,0,0,1,1996
Heidi Astrup,Denmark,1,0,0,1,1996
Conny Hamann,Denmark,1,0,0,1,1996
Tina Bøttzau,Denmark,1,0,0,1,1996
Marianne Florman,Denmark,1,0,0,1,1996
Anja Byrial Hansen,Denmark,1,0,0,1,1996
Anette Hoffmann-Møberg,Denmark,1,0,0,1,1996
Tonje Kjærgaard,Denmark,1,0,0,1,1996
Janne Kolling,Denmark,1,0,0,1,1996
Susanne Munk Lauritsen,Denmark,1,0,0,1,1996
Gitte Madsen,Denmark,1,0,0,1,1996
Lene Rantala,Denmark,1,0,0,1,1996
Gitte Sunesen,Denmark,1,0,0,1,1996
Anne Dorthe Tanderup,Denmark,1,0,0,1,1996
Irfan Smajlagić,Croatia,1,0,0,1,1996
Jo Min-Seon,Republic of Korea,1,0,0,1,1996
Yuko Emoto,Japan,1,0,0,1,1996
Driulis González,Cuba,1,0,0,1,1996
Kye Sun-Hui,Democratic People's Republic of Korea,1,0,0,1,1996
Marie-Claire Restoux,France,1,0,0,1,1996
Sun Fuming,People's Republic of China,1,0,0,1,1996
Ulla Werbrouck,Belgium,1,0,0,1,1996
Djamel Bouras,France,1,0,0,1,1996
David Douillet,France,1,0,0,1,1996
Jeon Gi-Yeong,Republic of Korea,1,0,0,1,1996
Kenzo Nakamura,Japan,1,0,0,1,1996
Paweł Nastula,Poland,1,0,0,1,1996
Tadahiro Nomura,Japan,1,0,0,1,1996
Udo Quellmalz,East Germany,1,0,0,1,1996
Alex Parygin,Australia,1,0,0,1,1996
Kate Slatter,Australia,1,0,0,1,1996
Megan Still,Australia,1,0,0,1,1996
Drew Ginn,Australia,1,0,0,1,1996
Nick Green,Australia,1,0,0,1,1996
Mike McKay,Australia,1,0,0,1,1996
James Tomkins,Australia,1,0,0,1,1996
Katsiaryna Khadatovich-Karsten,Belarus,1,0,0,1,1996
Eskild Ebbesen,Denmark,1,0,0,1,1996
Victor Feddersen,Denmark,1,0,0,1,1996
Niels Henriksen,Denmark,1,0,0,1,1996
Thomas Poulsen,Denmark,1,0,0,1,1996
Matthew Pinsent,Great Britain,1,0,0,1,1996
Steven Redgrave,Great Britain,1,0,0,1,1996
Jana Sorgers,East Germany,1,0,0,1,1996
Kathrin Boron,Germany,1,0,0,1,1996
Kerstin Köppen,Germany,1,0,0,1,1996
Katrin Rutschow-Stomporowski,Germany,1,0,0,1,1996
Andreas Hajek,Germany,1,0,0,1,1996
André Steiner,Germany,1,0,0,1,1996
Stephan Volkert,Germany,1,0,0,1,1996
André Willms,Germany,1,0,0,1,1996
Agostino Abbagnale,Italy,1,0,0,1,1996
Davide Tizzano,Italy,1,0,0,1,1996
Michiel Bartman,Netherlands,1,0,0,1,1996
Jeroen Duyster,Netherlands,1,0,0,1,1996
Ronald Florijn,Netherlands,1,0,0,1,1996
Koos Maasdijk,Netherlands,1,0,0,1,1996
Nico Rienks,Netherlands,1,0,0,1,1996
Diederik Simon,Netherlands,1,0,0,1,1996
Niels van der Zwan,Netherlands,1,0,0,1,1996
Niels van Steenis,Netherlands,1,0,0,1,1996
Henk Jan Zwolle,Netherlands,1,0,0,1,1996
Constanța Pipotă-Burcică,Romania,1,0,0,1,1996
Veronica Cogeanu-Cochela,Romania,1,0,0,1,1996
Liliana Gafencu,Romania,1,0,0,1,1996
Elena Georgescu,Romania,1,0,0,1,1996
Doina Ignat,Romania,1,0,0,1,1996
Camelia Macoviciuc-Mihalcea,Romania,1,0,0,1,1996
Elisabeta Oleniuc-Lipă,Romania,1,0,0,1,1996
Marioara Popescu-Ciobanu,Romania,1,0,0,1,1996
Doina Spîrcu,Romania,1,0,0,1,1996
Anca Tănase,Romania,1,0,0,1,1996
Markus Gier,Switzerland,1,0,0,1,1996
Michael Gier,Switzerland,1,0,0,1,1996
Xeno Müller,Switzerland,1,0,0,1,1996
Michael Diamond,Australia,1,0,0,1,1996
Russell Mark,Australia,1,0,0,1,1996
Li Duihong,People's Republic of China,1,0,0,1,1996
Yang Ling,People's Republic of China,1,0,0,1,1996
Christian Klees,Germany,1,0,0,1,1996
Ralf Schumann,East Germany,1,0,0,1,1996
Ennio Falco,Italy,1,0,0,1,1996
Olga Klochneva-Kuznetsova,Russian Federation,1,0,0,1,1996
Artyom Khadzhibekov,Russian Federation,1,0,0,1,1996
Boris Kokorev,Russian Federation,1,0,0,1,1996
Kim Rhode,United States,1,0,0,1,1996
Kieren Perkins,Australia,1,0,0,1,1996
Fred Deburghgraeve,Belgium,1,0,0,1,1996
Xiong Ni,People's Republic of China,1,0,0,1,1996
Claudia Poll,Costa Rica,1,0,0,1,1996
Attila Czene,Hungary,1,0,0,1,1996
Norbert Rózsa,Hungary,1,0,0,1,1996
Dmitry Sautin,Russian Federation,1,0,0,1,1996
Brooke Bennett,United States,1,0,0,1,1996
Suzannah Bianco,United States,1,0,0,1,1996
Tammy Cleland-McGregor,United States,1,0,0,1,1996
Becky Dyroen-Lancer,United States,1,0,0,1,1996
Trina Jackson,United States,1,0,0,1,1996
Emily LeSueur,United States,1,0,0,1,1996
Heather Pease Olson,United States,1,0,0,1,1996
Kristine Quance,United States,1,0,0,1,1996
Annette Salmeen,United States,1,0,0,1,1996
Jill Savery,United States,1,0,0,1,1996
Nathalie Schneyder,United States,1,0,0,1,1996
Heather Simmons-Carrasco,United States,1,0,0,1,1996
Jill Sudduth,United States,1,0,0,1,1996
Sheila Taormina,United States,1,0,0,1,1996
Cristina Teuscher,United States,1,0,0,1,1996
Margot Thien,United States,1,0,0,1,1996
Melanie Valerio,United States,1,0,0,1,1996
Ashley Whitney,United States,1,0,0,1,1996
Brad Bridgewater,United States,1,0,0,1,1996
Tom Dolan,United States,1,0,0,1,1996
David Fox,United States,1,0,0,1,1996
Kurt Grote,United States,1,0,0,1,1996
John Hargis,United States,1,0,0,1,1996
Mark Henderson,United States,1,0,0,1,1996
Joe Hudepohl,United States,1,0,0,1,1996
Scott Tucker,United States,1,0,0,1,1996
Sandra,Brazil,1,0,0,1,1996
Jackie Silva,Brazil,1,0,0,1,1996
Kent Steffes,United States,1,0,0,1,1996
Regla Bell,Cuba,1,0,0,1,1996
Magalys Carvajal,Cuba,1,0,0,1,1996
Marlenis Costa,Cuba,1,0,0,1,1996
Ana Ivis Fernández,Cuba,1,0,0,1,1996
Idalmis Gato,Cuba,1,0,0,1,1996
Lilia Izquierdo,Cuba,1,0,0,1,1996
Mireya Luis,Cuba,1,0,0,1,1996
Raisa O'Farrill,Cuba,1,0,0,1,1996
Yumilka Ruiz,Cuba,1,0,0,1,1996
Regla Torres,Cuba,1,0,0,1,1996
Peter Blangé,Netherlands,1,0,0,1,1996
Guido Görtzen,Netherlands,1,0,0,1,1996
Rob Grabert,Netherlands,1,0,0,1,1996
Henk Jan Held,Netherlands,1,0,0,1,1996
Misha Latuhihin,Netherlands,1,0,0,1,1996
Jan Posthuma,Netherlands,1,0,0,1,1996
Brecht Rodenburg,Netherlands,1,0,0,1,1996
Richard Schuil,Netherlands,1,0,0,1,1996
Mike van de Goor,Netherlands,1,0,0,1,1996
Bas van de Goor,Netherlands,1,0,0,1,1996
Olof van der Meulen,Netherlands,1,0,0,1,1996
Ron Zwerver,Netherlands,1,0,0,1,1996
Karch Kiraly,United States,1,0,0,1,1996
José María Abarca,Spain,1,0,0,1,1996
Daniel Ballart,Spain,1,0,0,1,1996
Manuel Estiarte,Spain,1,0,0,1,1996
Pedro García,Spain,1,0,0,1,1996
Salvador Gómez,Spain,1,0,0,1,1996
Iván Moro,Spain,1,0,0,1,1996
Miki Oca,Spain,1,0,0,1,1996
Jordi Payá,Spain,1,0,0,1,1996
Sergio Pedrerol,Spain,1,0,0,1,1996
Jesús Miguel Rollán,Spain,1,0,0,1,1996
Carles Sanz,Spain,1,0,0,1,1996
Jordi Sans,Spain,1,0,0,1,1996
Tang Lingsheng,People's Republic of China,1,0,0,1,1996
Zhan Xugang,People's Republic of China,1,0,0,1,1996
Pablo Lara,Cuba,1,0,0,1,1996
Pyrros Dimas,Greece,1,0,0,1,1996
Akakios Kakiasvili,Georgia,1,0,0,1,1996
Aleksey Petrov,Russian Federation,1,0,0,1,1996
Andrey Chemerkin,Russian Federation,1,0,0,1,1996
Halil Mutlu,Turkey,1,0,0,1,1996
Naim Süleymanoğlu,Turkey,1,0,0,1,1996
Tymur Taimazov,Ukraine,1,0,0,1,1996
Armen Nazaryan,Armenia,1,0,0,1,1996
Valentin Yordanov,Bulgaria,1,0,0,1,1996
Filiberto Azcuy,Cuba,1,0,0,1,1996
Rasoul Khadem Azgadhi,Islamic Republic of Iran,1,0,0,1,1996
Yury Melnichenko,Kazakhstan,1,0,0,1,1996
Sim Gwon-Ho,Republic of Korea,1,0,0,1,1996
Ryszard Wolny,Poland,1,0,0,1,1996
Andrzej Wroński,Poland,1,0,0,1,1996
Włodzimierz Zawadzki,Poland,1,0,0,1,1996
Kim Il-Ong,Democratic People's Republic of Korea,1,0,0,1,1996
Vadim Bogiyev,Russian Federation,1,0,0,1,1996
Aleksandr Karelin,Russian Federation,1,0,0,1,1996
Khadzhimurat Magomedov,Russian Federation,1,0,0,1,1996
Buvaysar Saytiyev,Russian Federation,1,0,0,1,1996
Mahmut Demir,Turkey,1,0,0,1,1996
Hamza Yerlikaya,Turkey,1,0,0,1,1996
V'iacheslav Oliynyk,Ukraine,1,0,0,1,1996
Kurt Angle,United States,1,0,0,1,1996
Tom Brands,United States,1,0,0,1,1996
Kendall Cross,United States,1,0,0,1,1996
Lee Lai Shan,"Hong Kong, China",1,0,0,1,1996
Kristine Roug,Denmark,1,0,0,1,1996
Theresa Zabell,Spain,1,0,0,1,1996
Pepote,Spain,1,0,0,1,1996
Yevhen Braslavets,Ukraine,1,0,0,1,1996
Marcelo Ferreira,Brazil,1,0,0,1,1996
Thomas Flach,East Germany,1,0,0,1,1996
Torben Grael,Brazil,1,0,0,1,1996
Bernd Jäkel,East Germany,1,0,0,1,1996
Nikos Kaklamanakis,Greece,1,0,0,1,1996
Mateusz Kusznierewicz,Poland,1,0,0,1,1996
Fernando León,Spain,1,0,0,1,1996
Ihor Matviyenko,Ukraine,1,0,0,1,1996
Robert Scheidt,Brazil,1,0,0,1,1996
Jochen Schümann,East Germany,1,0,0,1,1996
Noureddine Morceli,Algeria,1,0,0,1,1996
Vénuste Niyongabo,Burundi,1,0,0,1,1996
Stefka Kostadinova,Bulgaria,1,0,0,1,1996
Carlton Chambers,Canada,1,0,0,1,1996
Robert Esmie,Canada,1,0,0,1,1996
Glenroy Gilbert,Canada,1,0,0,1,1996
Bruny Surin,Canada,1,0,0,1,1996
Jan Železný,Czech Republic,1,0,0,1,1996
Jefferson Pérez,Ecuador,1,0,0,1,1996
Fatuma Roba,Ethiopia,1,0,0,1,1996
Haile Gebrselassie,Ethiopia,1,0,0,1,1996
Heli Rantanen,Finland,1,0,0,1,1996
Jean Galfione,France,1,0,0,1,1996
Astrid Kumbernuss,Germany,1,0,0,1,1996
Ilke Wyludda,Germany,1,0,0,1,1996
Lars Riedel,Germany,1,0,0,1,1996
Balázs Kiss,Hungary,1,0,0,1,1996
Deon Hemmings,Jamaica,1,0,0,1,1996
Joseph Keter,Kenya,1,0,0,1,1996
Chioma Ajunwa,Nigeria,1,0,0,1,1996
Vebjørn Rodal,Norway,1,0,0,1,1996
Robert Korzeniowski,Poland,1,0,0,1,1996
Fernanda Ribeiro,Portugal,1,0,0,1,1996
Josia Thugwane,South Africa,1,0,0,1,1996
Yelena Nikolayeva,Russian Federation,1,0,0,1,1996
Ludmila Narozhilenko-Engquist,Russian Federation,1,0,0,1,1996
Ghada Shouaa,Syrian Arab Republic,1,0,0,1,1996
Inesa Kravets,Soviet Union,1,0,0,1,1996
Chryste Gaines,United States,1,0,0,1,1996
Kim Graham,United States,1,0,0,1,1996
Carlette Guidry-White,United States,1,0,0,1,1996
Maicel Malone,United States,1,0,0,1,1996
Jearl Miles-Clark,United States,1,0,0,1,1996
Inger Miller,United States,1,0,0,1,1996
Rochelle Stevens,United States,1,0,0,1,1996
Linetta Wilson,United States,1,0,0,1,1996
Derrick Adkins,United States,1,0,0,1,1996
Charles Austin,United States,1,0,0,1,1996
Randy Barnes,United States,1,0,0,1,1996
Alvin Harrison,United States,1,0,0,1,1996
Kenny Harrison,United States,1,0,0,1,1996
Allen Johnson,United States,1,0,0,1,1996
Carl Lewis,United States,1,0,0,1,1996
Anthuan Maybank,United States,1,0,0,1,1996
Derek Mills,United States,1,0,0,1,1996
Dan O'Brien,United States,1,0,0,1,1996
Jason Rouser,United States,1,0,0,1,1996
LaMont Smith,United States,1,0,0,1,1996
Ioana Olteanu,Romania,1,0,0,1,1996
Ryan Berube,United States,1,0,0,1,1996
Begoña Vía Dufresne,Spain,1,0,0,1,1996
Staci Wilson,United States,1,0,0,1,1996
Dagmar Hase,Germany,0,3,1,4,1996
Franziska van Almsick,Germany,0,2,1,3,1996
Merlene Ottey-Page,Jamaica,0,2,1,3,1996
Wang Tao,People's Republic of China,0,2,0,2,1996
Beniamino Bonomi,Italy,0,2,0,2,1996
Anky van Grunsven,Netherlands,0,2,0,2,1996
Sergey Belyayev,Kazakhstan,0,2,0,2,1996
Roman Yegorov,Russian Federation,0,2,0,2,1996
Roger Black,Great Britain,0,2,0,2,1996
Frankie Fredericks,Namibia,0,2,0,2,1996
Gina Gogean,Romania,0,1,3,4,1996
Daniel Kowalski,Australia,0,1,2,3,1996
Sandra Völker,Germany,0,1,2,3,1996
Oh Gyo-Mun,Republic of Korea,0,1,1,2,1996
Jana Novotná,Czech Republic,0,1,1,2,1996
Arantxa Sánchez Vicario,Spain,0,1,1,2,1996
Sven Rothenberger,Netherlands,0,1,1,2,1996
Fan Bin,People's Republic of China,0,1,1,2,1996
"Wolfram Waibel, Jr.",Austria,0,1,1,2,1996
Marina Dobrancheva-Logvinenko,Russian Federation,0,1,1,2,1996
Nicole Livingstone-Stevenson,Australia,0,1,1,2,1996
Sam Riley,Australia,0,1,1,2,1996
Scott Miller,Australia,0,1,1,2,1996
Gustavo Borges,Brazil,0,1,1,2,1996
Shan Ying,People's Republic of China,0,1,1,2,1996
Meike Freitag,Germany,0,1,1,2,1996
Simone Osygus,Germany,0,1,1,2,1996
Vladislav Kulikov,Russian Federation,0,1,1,2,1996
Falilat Ogunkoya,Nigeria,0,1,1,2,1996
Ingrid Haringa,Netherlands,0,1,1,2,1996
Neil Broad,Great Britain,0,1,0,1,1996
Tim Henman,Great Britain,0,1,0,1,1996
Mia Audina,Indonesia,0,1,0,1,1996
He Ying,People's Republic of China,0,1,0,1,1996
Barbara Mensing,Germany,0,1,0,1,1996
Cornelia Pfohl,Germany,0,1,0,1,1996
Sandra Wagner-Sachse,Germany,0,1,0,1,1996
Chen Jing,Chinese Taipei,0,1,0,1,1996
Jang Hye-Ok,Republic of Korea,0,1,0,1,1996
Na Gyeong-Min,Republic of Korea,0,1,0,1,1996
Park Ju-Bong,Republic of Korea,0,1,0,1,1996
Cheah Soon Kit,Malaysia,0,1,0,1,1996
Yap Kim Hock,Malaysia,0,1,0,1,1996
Serafim Todorov,Bulgaria,0,1,0,1,1996
Toncho Tonchev,Bulgaria,0,1,0,1,1996
David Defiagbon,Canada,0,1,0,1,1996
Chen Hong,People's Republic of China,0,1,0,1,1996
He Liping,People's Republic of China,0,1,0,1,1996
Lei Li,People's Republic of China,0,1,0,1,1996
Liu Xuqing,People's Republic of China,0,1,0,1,1996
Liu Yaju,People's Republic of China,0,1,0,1,1996
Ma Ying,People's Republic of China,0,1,0,1,1996
Ou Jingbai,People's Republic of China,0,1,0,1,1996
Tao Hua,People's Republic of China,0,1,0,1,1996
Wang Lihong,People's Republic of China,0,1,0,1,1996
Wang Ying,People's Republic of China,0,1,0,1,1996
Wei Qiang,People's Republic of China,0,1,0,1,1996
Xu Jian,People's Republic of China,0,1,0,1,1996
Yan Fang,People's Republic of China,0,1,0,1,1996
Zhang Chunfang,People's Republic of China,0,1,0,1,1996
Kosuke Fukudome,Japan,0,1,0,1,1996
Tadahito Iguchi,Japan,0,1,0,1,1996
Makoto Imaoka,Japan,0,1,0,1,1996
Takeo Kawamura,Japan,0,1,0,1,1996
Jutaro Kimura,Japan,0,1,0,1,1996
Takashi Kurosu,Japan,0,1,0,1,1996
Takao Kuwamoto,Japan,0,1,0,1,1996
Nobuhiko Matsunaka,Japan,0,1,0,1,1996
Koichi Misawa,Japan,0,1,0,1,1996
Masahiko Mori,Japan,0,1,0,1,1996
Masao Morinaka,Japan,0,1,0,1,1996
Daishin Nakamura,Japan,0,1,0,1,1996
Masahiro Nojima,Japan,0,1,0,1,1996
Hideaki Okubo,Japan,0,1,0,1,1996
Hitoshi Ono,Japan,0,1,0,1,1996
Yasuyuki Saigo,Japan,0,1,0,1,1996
Tomoaki Sato,Japan,0,1,0,1,1996
Masanori Sugiura,Japan,0,1,0,1,1996
Takayuki Takabayashi,Japan,0,1,0,1,1996
Yoshitomo Tani,Japan,0,1,0,1,1996
Alfredo Duvergel,Cuba,0,1,0,1,1996
Juan Hernández Sierra,Cuba,0,1,0,1,1996
Arnaldo Mesa,Cuba,0,1,0,1,1996
Jang Yong-Ho,Republic of Korea,0,1,0,1,1996
Kim Bo-Ram,Republic of Korea,0,1,0,1,1996
Magnus Petersson,Sweden,0,1,0,1,1996
Liu Wei,People's Republic of China,0,1,0,1,1996
Qiao Yunping,People's Republic of China,0,1,0,1,1996
Dong Jiong,People's Republic of China,0,1,0,1,1996
Lu Lin,People's Republic of China,0,1,0,1,1996
Helena Suková,Czech Republic,0,1,0,1,1996
Sergi Bruguera,Spain,0,1,0,1,1996
An Zhongxin,People's Republic of China,0,1,0,1,1996
Oktay Urkal,Germany,0,1,0,1,1996
Bolat Zhumadilov,Kazakhstan,0,1,0,1,1996
Lee Seung-Bae,Republic of Korea,0,1,0,1,1996
Leila,Brazil,0,1,0,1,1996
Marta Sobral,Brazil,0,1,0,1,1996
Janeth,Brazil,0,1,0,1,1996
Roseli,Brazil,0,1,0,1,1996
Hortência,Brazil,0,1,0,1,1996
Alessandra,Brazil,0,1,0,1,1996
Cláudia,Brazil,0,1,0,1,1996
Adriana,Brazil,0,1,0,1,1996
Silvinha,Brazil,0,1,0,1,1996
Cíntia,Brazil,0,1,0,1,1996
Branca,Brazil,0,1,0,1,1996
Paula,Brazil,0,1,0,1,1996
Miroslav Berić,Serbia,0,1,0,1,1996
Dejan Bodiroga,Serbia,0,1,0,1,1996
Predrag Danilović,Serbia,0,1,0,1,1996
Vlade Divac,Serbia,0,1,0,1,1996
Saša Đorđević,Serbia,0,1,0,1,1996
Nikola Lončar,Serbia,0,1,0,1,1996
Saša Obradović,Serbia,0,1,0,1,1996
Žarko Paspalj,Montenegro,0,1,0,1,1996
Zelly Rebrača,Serbia,0,1,0,1,1996
Zoran Savić,Serbia,0,1,0,1,1996
Dejan Tomašević,Serbia,0,1,0,1,1996
Milenko Topić,Serbia,0,1,0,1,1996
Mansueto Velasco,Philippines,0,1,0,1,1996
Paea Wolfgramm,Tonga,0,1,0,1,1996
Malik Beyleroğlu,Turkey,0,1,0,1,1996
Caroline Brunet,Canada,0,1,0,1,1996
Lukáš Pollert,Czech Republic,0,1,0,1,1996
Jiří Rohan,Czech Republic,0,1,0,1,1996
Miroslav Šimek,Czech Republic,0,1,0,1,1996
Attila Adrovicz,Hungary,0,1,0,1,1996
Ferenc Csipes,Hungary,0,1,0,1,1996
András Rajna,Hungary,0,1,0,1,1996
Ivans Klementjevs,Latvia,0,1,0,1,1996
Antonel Borșan,Romania,0,1,0,1,1996
Marcel Glăvan,Romania,0,1,0,1,1996
Andraž Vehovar,Slovenia,0,1,0,1,1996
Daniela Baumer,Switzerland,0,1,0,1,1996
Sabine Eichenberger,Switzerland,0,1,0,1,1996
Ingrid Haralamow-Raimann,Switzerland,0,1,0,1,1996
Gabi Müller,Switzerland,0,1,0,1,1996
Slavomír Kňazovický,Czechoslovakia,0,1,0,1,1996
Victor Reneischi,Republic of Moldova,0,1,0,1,1996
Nicolae Juravschi,Republic of Moldova,0,1,0,1,1996
Dana Chladek,United States,0,1,0,1,1996
Tineke Bartels-de Vries,Netherlands,0,1,0,1,1996
Leslie Burr-Howard,United States,0,1,0,1,1996
Sally Clark,New Zealand,0,1,0,1,1996
Jill Henneberg,United States,0,1,0,1,1996
Anne Kursinski,United States,0,1,0,1,1996
Karen Lende O'Connor,United States,0,1,0,1,1996
Gonnelien Rothenberger-Gordijn,Netherlands,0,1,0,1,1996
Bruce Davidson,United States,0,1,0,1,1996
Peter Leone,United States,0,1,0,1,1996
Michael Matz,United States,0,1,0,1,1996
Willi Melliger,Switzerland,0,1,0,1,1996
David O'Connor,United States,0,1,0,1,1996
Imelda Chiappa,Italy,0,1,0,1,1996
Marion Clignet,France,0,1,0,1,1996
Michelle Ferris,Australia,0,1,0,1,1996
Alison Sydor,Canada,0,1,0,1,1996
Thomas Frischknecht,Switzerland,0,1,0,1,1996
Eduard Gritsun,Russian Federation,0,1,0,1,1996
Erin Hartwell,United States,0,1,0,1,1996
Nikolay Kuznetsov,Russian Federation,0,1,0,1,1996
Aleksey Markov,Russian Federation,0,1,0,1,1996
Marty Nothstein,United States,0,1,0,1,1996
Abraham Olano,Spain,0,1,0,1,1996
Anton Shantyr,Russian Federation,0,1,0,1,1996
Rolf Sørensen,Denmark,0,1,0,1,1996
Brian Walton,Canada,0,1,0,1,1996
Jaime Amat,Spain,0,1,0,1,1996
Pol Amat,Spain,0,1,0,1,1996
Xavi Arnau,Spain,0,1,0,1,1996
Jordi Arnau,Spain,0,1,0,1,1996
Óscar Barrena,Spain,0,1,0,1,1996
Ignacio Cobos,Spain,0,1,0,1,1996
Juan Antonio Dinarés,Spain,0,1,0,1,1996
Juan Escarré,Spain,0,1,0,1,1996
Xavier Escudé,Spain,0,1,0,1,1996
Juantxo García-Mauriño,Spain,0,1,0,1,1996
Antonio González,Spain,0,1,0,1,1996
Ramón Jufresa,Spain,0,1,0,1,1996
Kim Malgosa,Spain,0,1,0,1,1996
Víctor Pujol,Spain,0,1,0,1,1996
Ramón Sala,Spain,0,1,0,1,1996
Pablo Usoz,Spain,0,1,0,1,1996
Jang Eun-Jeong,Republic of Korea,0,1,0,1,1996
Jo Eun-Jeong,Republic of Korea,0,1,0,1,1996
Choi Eun-Gyeong,Republic of Korea,0,1,0,1,1996
Choi Mi-Sun,Republic of Korea,0,1,0,1,1996
Jeon Yeong-Seon,Republic of Korea,0,1,0,1,1996
Jin Deok-San,Republic of Korea,0,1,0,1,1996
Kim Myeong-Ok,Republic of Korea,0,1,0,1,1996
Gwon Su-Hyeon,Republic of Korea,0,1,0,1,1996
Gwon Chang-Suk,Republic of Korea,0,1,0,1,1996
Lee Eun-Gyeong,Republic of Korea,0,1,0,1,1996
Lee Eun-Yeong,Republic of Korea,0,1,0,1,1996
Lee Ji-Yeong,Republic of Korea,0,1,0,1,1996
Im Jeong-Suk,Republic of Korea,0,1,0,1,1996
Oh Seung-Sin,Republic of Korea,0,1,0,1,1996
U Hyeon-Jeong,Republic of Korea,0,1,0,1,1996
Yu Je-Suk,Republic of Korea,0,1,0,1,1996
Laura Chiesa,Italy,0,1,0,1,1996
Elisa Uga,Italy,0,1,0,1,1996
Margherita Zalaffi,Italy,0,1,0,1,1996
Reka Lazăr-Szabo,Romania,0,1,0,1,1996
Roxana Scarlat,Romania,0,1,0,1,1996
Iván Trevejo,Cuba,0,1,0,1,1996
Lionel Plumenail,France,0,1,0,1,1996
Csaba Köves,Hungary,0,1,0,1,1996
József Navarrete,Hungary,0,1,0,1,1996
Bence Szabó,Hungary,0,1,0,1,1996
Piotr Kiełpikowski,Poland,0,1,0,1,1996
Adam Krzesiński,Poland,0,1,0,1,1996
Ryszard Sobczak,Poland,0,1,0,1,1996
Pavel Kolobkov,Russian Federation,0,1,0,1,1996
Valery Zakharevich,Russian Federation,0,1,0,1,1996
Matías Almeyda,Argentina,0,1,0,1,1996
Roberto Ayala,Argentina,0,1,0,1,1996
Christian Bassedas,Argentina,0,1,0,1,1996
Carlos Bossio,Argentina,0,1,0,1,1996
Pablo Cavallero,Argentina,0,1,0,1,1996
José Antonio Chamot,Argentina,0,1,0,1,1996
Hernán Crespo,Argentina,0,1,0,1,1996
Marcelo Delgado,Argentina,0,1,0,1,1996
Marcelo Gallardo,Argentina,0,1,0,1,1996
Claudio López,Argentina,0,1,0,1,1996
Gustavo López,Argentina,0,1,0,1,1996
Hugo Morales,Argentina,0,1,0,1,1996
Ariel Ortega,Argentina,0,1,0,1,1996
Pablo Paz,Argentina,0,1,0,1,1996
Héctor Pineda,Argentina,0,1,0,1,1996
Roberto Sensini,Argentina,0,1,0,1,1996
Diego Simeone,Argentina,0,1,0,1,1996
Javier Zanetti,Argentina,0,1,0,1,1996
Chen Yufeng,People's Republic of China,0,1,0,1,1996
Fan Yunjie,People's Republic of China,0,1,0,1,1996
Gao Hong,People's Republic of China,0,1,0,1,1996
Liu Ailing,People's Republic of China,0,1,0,1,1996
Liu Ying,People's Republic of China,0,1,0,1,1996
Shi Guihong,People's Republic of China,0,1,0,1,1996
Shui Qingxia,People's Republic of China,0,1,0,1,1996
Sun Qingmei,People's Republic of China,0,1,0,1,1996
Sun Wen,People's Republic of China,0,1,0,1,1996
Wang Liping,People's Republic of China,0,1,0,1,1996
Wei Haiying,People's Republic of China,0,1,0,1,1996
Wen Lirong,People's Republic of China,0,1,0,1,1996
Xie Huilin,People's Republic of China,0,1,0,1,1996
Zhao Lihong,People's Republic of China,0,1,0,1,1996
Yu Hongqi,People's Republic of China,0,1,0,1,1996
Ina Delcheva,Bulgaria,0,1,0,1,1996
Valentina Kevliyan,Bulgaria,0,1,0,1,1996
Mariya Koleva,Bulgaria,0,1,0,1,1996
Maya Tabakova,Bulgaria,0,1,0,1,1996
Ivelina Taleva,Bulgaria,0,1,0,1,1996
Vyara Vatashka,Bulgaria,0,1,0,1,1996
Bi Wenjing,People's Republic of China,0,1,0,1,1996
Mo Huilan,People's Republic of China,0,1,0,1,1996
Yana Batyrshina,Russian Federation,0,1,0,1,1996
Yelena Dolgopolova,Russian Federation,0,1,0,1,1996
Roza Galiyeva,Russian Federation,0,1,0,1,1996
Yelena Grosheva,Russian Federation,0,1,0,1,1996
Dina Kochetkova,Russian Federation,0,1,0,1,1996
Yevgeniya Kuznetsova,Bulgaria,0,1,0,1,1996
Oksana Lyapina,Russian Federation,0,1,0,1,1996
Krasimir Dunev,Bulgaria,0,1,0,1,1996
Fan Hongbin,People's Republic of China,0,1,0,1,1996
Huang Huadong,People's Republic of China,0,1,0,1,1996
Huang Liping,People's Republic of China,0,1,0,1,1996
Shen Jian,People's Republic of China,0,1,0,1,1996
Zhang Jinjing,People's Republic of China,0,1,0,1,1996
Szilveszter Csollány,Hungary,0,1,0,1,1996
Yeo Hong-Cheol,Republic of Korea,0,1,0,1,1996
Dan Burincă,Romania,0,1,0,1,1996
Marius Urzică,Romania,0,1,0,1,1996
Jair Lynch,United States,0,1,0,1,1996
Jo Eun-Hui,Republic of Korea,0,1,0,1,1996
Han Seon-Hui,Republic of Korea,0,1,0,1,1996
Hong Jeong-Ho,Republic of Korea,0,1,0,1,1996
Heo Sun-Yeong,Republic of Korea,0,1,0,1,1996
Kim Jeong-Sim,Republic of Korea,0,1,0,1,1996
Kim Eun-Mi,Republic of Korea,0,1,0,1,1996
Kim Jeong-Mi,Republic of Korea,0,1,0,1,1996
Kim Mi-Sim,Republic of Korea,0,1,0,1,1996
Kim Rang,Republic of Korea,0,1,0,1,1996
Lee Sang-Eun,Republic of Korea,0,1,0,1,1996
Im Oh-Gyeong,Republic of Korea,0,1,0,1,1996
Mun Hyang-Ja,Republic of Korea,0,1,0,1,1996
Oh Seong-Ok,Republic of Korea,0,1,0,1,1996
Oh Yeong-Ran,Republic of Korea,0,1,0,1,1996
Park Jeong-Rim,Republic of Korea,0,1,0,1,1996
Magnus Andersson,Sweden,0,1,0,1,1996
Robert Andersson,Sweden,0,1,0,1,1996
Per Carlén,Sweden,0,1,0,1,1996
Martin Frändesjö,Sweden,0,1,0,1,1996
Erik Hajas,Sweden,0,1,0,1,1996
Robert Hedin,Sweden,0,1,0,1,1996
Andreas Larsson,Sweden,0,1,0,1,1996
Ola Lindgren,Sweden,0,1,0,1,1996
Stefan Lövgren,Sweden,0,1,0,1,1996
Mats Olsson,Sweden,0,1,0,1,1996
Staffan Olsson,Sweden,0,1,0,1,1996
Johan Pettersson,Sweden,0,1,0,1,1996
Tomas Sivertsson,Sweden,0,1,0,1,1996
Tomas Svensson,Sweden,0,1,0,1,1996
Pierre Thorsson,Sweden,0,1,0,1,1996
Magnus Wislander,Sweden,0,1,0,1,1996
Jeong Seon-Yong,Republic of Korea,0,1,0,1,1996
Hyeon Suk-Hui,Republic of Korea,0,1,0,1,1996
Estela Rodríguez,Cuba,0,1,0,1,1996
Aneta Szczepańska,Poland,0,1,0,1,1996
Ryoko Tamura-Tani,Japan,0,1,0,1,1996
Yoko Tanabe,Japan,0,1,0,1,1996
Gella Vandecaveye,Belgium,0,1,0,1,1996
Armen Bagdasarov,Uzbekistan,0,1,0,1,1996
Girolamo Giovinazzo,Italy,0,1,0,1,1996
Kim Min-Su,Republic of Korea,0,1,0,1,1996
Toshihiko Koga,Japan,0,1,0,1,1996
Gwak Dae-Seong,Republic of Korea,0,1,0,1,1996
Yukimasa Nakamura,Japan,0,1,0,1,1996
Ernesto Pérez,Spain,0,1,0,1,1996
Eduard Zenovka,Russian Federation,0,1,0,1,1996
Robert Scott,Australia,0,1,0,1,1996
David Weightman,Australia,0,1,0,1,1996
Alison Korn,Canada,0,1,0,1,1996
Silken Laumann,Canada,0,1,0,1,1996
Theresa Luke,Canada,0,1,0,1,1996
Maria Maunder,Canada,0,1,0,1,1996
Heather McDermid,Canada,0,1,0,1,1996
Jessica Monroe,Canada,0,1,0,1,1996
Emma Robinson,Canada,0,1,0,1,1996
Lesley Thompson-Willie,Canada,0,1,0,1,1996
Tosha Tsang,Canada,0,1,0,1,1996
Anna Van der Kamp,Canada,0,1,0,1,1996
Dave Boyes,Canada,0,1,0,1,1996
Gavin Hassett,Canada,0,1,0,1,1996
Jeff Lay,Canada,0,1,0,1,1996
Brian Peaker,Canada,0,1,0,1,1996
Derek Porter,Canada,0,1,0,1,1996
Cao Mianying,People's Republic of China,0,1,0,1,1996
Zhang Xiuyun,People's Republic of China,0,1,0,1,1996
Gilles Bosquet,France,0,1,0,1,1996
Daniel Fauché,France,0,1,0,1,1996
Olivier Moncelet,France,0,1,0,1,1996
Bertrand Vecten,France,0,1,0,1,1996
Roland Baar,Germany,0,1,0,1,1996
Wolfram Huhn,Germany,0,1,0,1,1996
Detlef Kirchhoff,East Germany,0,1,0,1,1996
Mark Kleinschmidt,Germany,0,1,0,1,1996
Frank Richter,Germany,0,1,0,1,1996
Thorsten Streppelhoff,Germany,0,1,0,1,1996
Peter Thiede,Germany,0,1,0,1,1996
Ulrich Viefers,Germany,0,1,0,1,1996
Marc Weber,Germany,0,1,0,1,1996
Maarten van der Linden,Netherlands,0,1,0,1,1996
Pepijn Aardewijn,Netherlands,0,1,0,1,1996
Steffen Størseth,Norway,0,1,0,1,1996
Kjetil Undset,Norway,0,1,0,1,1996
Inna Frolova,Soviet Union,0,1,0,1,1996
Svitlana Maziy,Soviet Union,0,1,0,1,1996
Dina Miftakhutdynova,Ukraine,0,1,0,1,1996
Olena Ronzhyna-Morozova,Ukraine,0,1,0,1,1996
Teresa Bell,United States,0,1,0,1,1996
Lindsay Burns,United States,0,1,0,1,1996
Karen Kraft,United States,0,1,0,1,1996
Missy Schwen-Ryan,United States,0,1,0,1,1996
Jason Gailes,United States,0,1,0,1,1996
Brian Jamieson,United States,0,1,0,1,1996
Eric Mueller,United States,0,1,0,1,1996
Tim Young,United States,0,1,0,1,1996
Ihar Basinski,Belarus,0,1,0,1,1996
Diana Yorgova,Bulgaria,0,1,0,1,1996
Emil Milev,Bulgaria,0,1,0,1,1996
Wang Yifu,People's Republic of China,0,1,0,1,1996
Xiao Jun,People's Republic of China,0,1,0,1,1996
Petra Horneber,Germany,0,1,0,1,1996
Susanne Kiermayer,Germany,0,1,0,1,1996
Albano Pera,Italy,0,1,0,1,1996
Mirosław Rzepkowski,Poland,0,1,0,1,1996
Irina Gerasimyonok,Russian Federation,0,1,0,1,1996
Josh Lakatos,United States,0,1,0,1,1996
Helen Denman,Australia,0,1,0,1,1996
Angela Kennedy,Australia,0,1,0,1,1996
Sarah Ryan,Australia,0,1,0,1,1996
Petria Thomas,Australia,0,1,0,1,1996
Lisa Alexander,Canada,0,1,0,1,1996
Janice Bremner,Canada,0,1,0,1,1996
Karen Clark,Canada,0,1,0,1,1996
Karen Fonteyne,Canada,0,1,0,1,1996
Sylvie Fréchette,Canada,0,1,0,1,1996
Valérie Hould-Marchand,Canada,0,1,0,1,1996
Christine Larsen,Canada,0,1,0,1,1996
Marianne Limpert,Canada,0,1,0,1,1996
Cari Read,Canada,0,1,0,1,1996
Erin Woodley,Canada,0,1,0,1,1996
Chao Na,People's Republic of China,0,1,0,1,1996
Liu Limin,People's Republic of China,0,1,0,1,1996
Nian Yun,People's Republic of China,0,1,0,1,1996
Yu Zhuocheng,People's Republic of China,0,1,0,1,1996
Rodolfo Falcón,Cuba,0,1,0,1,1996
Jani Sievinen,Finland,0,1,0,1,1996
Paul Palmer,Great Britain,0,1,0,1,1996
Kerstin Kielgaß,Germany,0,1,0,1,1996
Anke Scholz,Germany,0,1,0,1,1996
Annika Walter,Germany,0,1,0,1,1996
Jan Hempel,East Germany,0,1,0,1,1996
Károly Güttler,Hungary,0,1,0,1,1996
Irina Lashko,Australia,0,1,0,1,1996
Roman Ivanovsky,Russian Federation,0,1,0,1,1996
Stanislav Lopukhov,Russian Federation,0,1,0,1,1996
Denis Pimankov,Russian Federation,0,1,0,1,1996
Vladimir Predkin,Russian Federation,0,1,0,1,1996
Vlad Pyshnenko,Russian Federation,0,1,0,1,1996
Vladimir Selkov,Russian Federation,0,1,0,1,1996
Konstantin Ushkov,Kyrgyzstan,0,1,0,1,1996
Lars Frölander,Sweden,0,1,0,1,1996
Anders Holmertz,Sweden,0,1,0,1,1996
Anders Lyrbring,Sweden,0,1,0,1,1996
Christer Wallin,Sweden,0,1,0,1,1996
Allison Wagner,United States,0,1,0,1,1996
Tom Malchow,United States,0,1,0,1,1996
Eric Namesnik,United States,0,1,0,1,1996
Mônica Rodrigues,Brazil,0,1,0,1,1996
Adriana Samuel,Brazil,0,1,0,1,1996
Mike Dodd,United States,0,1,0,1,1996
Mike Whitmarsh,United States,0,1,0,1,1996
Cui Yongmei,People's Republic of China,0,1,0,1,1996
He Qi,People's Republic of China,0,1,0,1,1996
Lai Yawen,People's Republic of China,0,1,0,1,1996
Li Yan,People's Republic of China,0,1,0,1,1996
Sun Yue,People's Republic of China,0,1,0,1,1996
Wang Lina,People's Republic of China,0,1,0,1,1996
Wang Yi,People's Republic of China,0,1,0,1,1996
Wang Ziling,People's Republic of China,0,1,0,1,1996
Wu Yongmei,People's Republic of China,0,1,0,1,1996
Lorenzo Bernardi,Italy,0,1,0,1,1996
Vigor Bovolenta,Italy,0,1,0,1,1996
Marco Bracci,Italy,0,1,0,1,1996
Luca Cantagalli,Italy,0,1,0,1,1996
Andrea Gardini,Italy,0,1,0,1,1996
Andrea Giani,Italy,0,1,0,1,1996
Pasquale Gravina,Italy,0,1,0,1,1996
Marco Meoni,Italy,0,1,0,1,1996
Samuele Papi,Italy,0,1,0,1,1996
Andrea Sartoretti,Italy,0,1,0,1,1996
Paolo Tofoli,Italy,0,1,0,1,1996
Andrea Zorzi,Italy,0,1,0,1,1996
Perica Bukić,Croatia,0,1,0,1,1996
Damir Glavan,Croatia,0,1,0,1,1996
Igor Hinić,Croatia,0,1,0,1,1996
Vjekoslav Kobešćak,Croatia,0,1,0,1,1996
Joško Kreković,Croatia,0,1,0,1,1996
Ognjen Kržić,Croatia,0,1,0,1,1996
Dubravko Šimenc,Croatia,0,1,0,1,1996
Siniša Školneković,Croatia,0,1,0,1,1996
Ratko Štritof,Croatia,0,1,0,1,1996
Tino Vegar,Croatia,0,1,0,1,1996
Renato Vrbičić,Croatia,0,1,0,1,1996
Zdeslav Vrdoljak,Croatia,0,1,0,1,1996
Yoto Yotov,Bulgaria,0,1,0,1,1996
Zhang Xiangsen,People's Republic of China,0,1,0,1,1996
Marc Huster,Germany,0,1,0,1,1996
Ronny Weller,East Germany,0,1,0,1,1996
Leonidas Kokas,Greece,0,1,0,1,1996
Valerios Leonidis,Greece,0,1,0,1,1996
Leonidas Sabanis,Greece,0,1,0,1,1996
Anatoly Khrapaty,Kazakhstan,0,1,0,1,1996
Kim Myong-Nam,Democratic People's Republic of Korea,0,1,0,1,1996
Sergey Syrtsov,Russian Federation,0,1,0,1,1996
Armen Mkrtchyan,Armenia,0,1,0,1,1996
Namiq Abdullayev,Azerbaijan,0,1,0,1,1996
Siarhei Lishtvan,Belarus,0,1,0,1,1996
Aliaksei Miadzvedzeu,Belarus,0,1,0,1,1996
Aliaksandr Paulau,Belarus,0,1,0,1,1996
Gia Sissaouri,Canada,0,1,0,1,1996
Juan Luis Marén,Cuba,0,1,0,1,1996
Marko Asell,Finland,0,1,0,1,1996
Ghani Yalouz,France,0,1,0,1,1996
Thomas Zander,Germany,0,1,0,1,1996
Abbas Jadidi,Islamic Republic of Iran,0,1,0,1,1996
Jang Jae-Seong,Republic of Korea,0,1,0,1,1996
Park Jang-Sun,Republic of Korea,0,1,0,1,1996
Yang Hyeong-Mo,Republic of Korea,0,1,0,1,1996
Jacek Fafiński,Poland,0,1,0,1,1996
Makharbek Khadartsev,Russian Federation,0,1,0,1,1996
Matt Ghaffari,United States,0,1,0,1,1996
Dennis Hall,United States,0,1,0,1,1996
Brandon Paulson,United States,0,1,0,1,1996
Townsend Saunders,United States,0,1,0,1,1996
Barbara Kendall,New Zealand,0,1,0,1,1996
Alicia Kinoshita,Japan,0,1,0,1,1996
Margriet Matthijsse,Netherlands,0,1,0,1,1996
Yumiko Shige,Japan,0,1,0,1,1996
Ben Ainslie,Great Britain,0,1,0,1,1996
Mitch Booth,Australia,0,1,0,1,1996
Carlos Espínola,Argentina,0,1,0,1,1996
Sébastien Godefroid,Belgium,0,1,0,1,1996
Andrew Landenberger,Australia,0,1,0,1,1996
Bobby Lohse,Sweden,0,1,0,1,1996
John Merricks,Great Britain,0,1,0,1,1996
Dmitry Shabanov,Russian Federation,0,1,0,1,1996
Georgy Shayduko,Russian Federation,0,1,0,1,1996
Igor Skalin,Russian Federation,0,1,0,1,1996
Ian Walker,Great Britain,0,1,0,1,1996
Hans Wallén,Sweden,0,1,0,1,1996
Cathy Freeman,Australia,0,1,0,1,1996
Louise McPaul-Currey,Australia,0,1,0,1,1996
Eldece Clarke-Lewis,The Bahamas,0,1,0,1,1996
Pauline Davis-Thompson,The Bahamas,0,1,0,1,1996
Debbie Ferguson-McKenzie,The Bahamas,0,1,0,1,1996
Savatheda Fynes,The Bahamas,0,1,0,1,1996
Chandra Sturrup,The Bahamas,0,1,0,1,1996
Natasha Sazanovich,Belarus,0,1,0,1,1996
Uladzimir Dubroushchyk,Belarus,0,1,0,1,1996
Sui Xinmei,People's Republic of China,0,1,0,1,1996
Ana Fidelia Quirós,Cuba,0,1,0,1,1996
Fermín Cacho,Spain,0,1,0,1,1996
Steve Backley,Great Britain,0,1,0,1,1996
Jamie Baulch,Great Britain,0,1,0,1,1996
Jonathan Edwards,Great Britain,0,1,0,1,1996
Mark Hylton,Great Britain,0,1,0,1,1996
Du'aine Ladejo,Great Britain,0,1,0,1,1996
Mark Richardson,Great Britain,0,1,0,1,1996
Iwan Thomas,Great Britain,0,1,0,1,1996
Frank Busemann,Germany,0,1,0,1,1996
Niki Bakogianni,Greece,0,1,0,1,1996
Fiona May,Great Britain,0,1,0,1,1996
Elisabetta Perrone,Italy,0,1,0,1,1996
James Beckford,Jamaica,0,1,0,1,1996
Pauline Konga,Kenya,0,1,0,1,1996
Paul Bitok,Kenya,0,1,0,1,1996
Moses Kiptanui,Kenya,0,1,0,1,1996
Paul Tergat,Kenya,0,1,0,1,1996
Lee Bong-Ju,Republic of Korea,0,1,0,1,1996
Bisi Afolabi,Nigeria,0,1,0,1,1996
Charity Opara,Nigeria,0,1,0,1,1996
Fatimat Yusuf-Olukoju,Nigeria,0,1,0,1,1996
Artur Partyka,Poland,0,1,0,1,1996
Gabriela Szabo,Romania,0,1,0,1,1996
Hezekiél Sepeng,South Africa,0,1,0,1,1996
Valentina Yegorova,Russian Federation,0,1,0,1,1996
Inna Lasovskaya,Russian Federation,0,1,0,1,1996
Nataliya Sadova,Russian Federation,0,1,0,1,1996
Ilya Markov,Russian Federation,0,1,0,1,1996
Igor Trandenkov,Russian Federation,0,1,0,1,1996
Brigita Bukovec,Slovenia,0,1,0,1,1996
Mikhail Shchennikov,Russian Federation,0,1,0,1,1996
Kim Batten,United States,0,1,0,1,1996
Mark Crear,United States,0,1,0,1,1996
Lance Deal,United States,0,1,0,1,1996
Jon Drummond,United States,0,1,0,1,1996
John Godina,United States,0,1,0,1,1996
Tim Harden,United States,0,1,0,1,1996
Mike Marsh,United States,0,1,0,1,1996
Dennis Mitchell,United States,0,1,0,1,1996
Tim Montgomery,United States,0,1,0,1,1996
Samuel Matete,Zambia,0,1,0,1,1996
Gábor Horváth,Hungary,0,1,0,1,1996
Jarosław Rodzewicz,Poland,0,1,0,1,1996
Gwak Hye-Jeong,Republic of Korea,0,1,0,1,1996
Ian Thorpe,Australia,3,2,0,5,2000
Leontien Zijlaard-van Moorsel,Netherlands,3,1,0,4,2000
Inge de Bruijn,Netherlands,3,1,0,4,2000
Jenny Thompson,United States,3,0,1,4,2000
Lenny Krayzelburg,United States,3,0,0,3,2000
Michael Klim,Australia,2,2,0,4,2000
Aleksey Nemov,Russian Federation,2,1,3,6,2000
"Gary Hall, Jr.",United States,2,1,1,4,2000
Florian Rousseau,France,2,1,0,3,2000
Yelena Zamolodchikova,Russian Federation,2,1,0,3,2000
Yana Klochkova,Ukraine,2,1,0,3,2000
Dara Torres,United States,2,0,3,5,2000
Pieter van den Hoogenband,Netherlands,2,0,2,4,2000
Simona Amânar,Romania,2,0,1,3,2000
Birgit Fischer-Schmidt,East Germany,2,0,0,2,2000
Zoltán Kammerer,Hungary,2,0,0,2,2000
Knut Holmann,Norway,2,0,0,2,2000
Félicia Ballanger,France,2,0,0,2,2000
Robert Bartko,Germany,2,0,0,2,2000
Valentina Vezzali,Italy,2,0,0,2,2000
Doina Ignat,Romania,2,0,0,2,2000
Xiong Ni,People's Republic of China,2,0,0,2,2000
Olga Brusnikina,Russian Federation,2,0,0,2,2000
Mariya Kiselyova,Russian Federation,2,0,0,2,2000
Brooke Bennett,United States,2,0,0,2,2000
Ashley Tappin,United States,2,0,0,2,2000
Amy Van Dyken,United States,2,0,0,2,2000
Pauline Davis-Thompson,The Bahamas,2,0,0,2,2000
Robert Korzeniowski,Poland,2,0,0,2,2000
Yun Mi-Jin,Republic of Korea,2,0,0,2,2000
Maurice Greene,United States,2,0,0,2,2000
Katrin Wagner-Augustin,Germany,2,0,0,2,2000
Botond Storcz,Hungary,2,0,0,2,2000
Li Xiaopeng,People's Republic of China,2,0,0,2,2000
Georgeta Damian-Andrunache,Romania,2,0,0,2,2000
Grant Hackett,Australia,2,0,0,2,2000
Todd Pearson,Australia,2,0,0,2,2000
Domenico Fioravanti,Italy,2,0,0,2,2000
Diana Mocanu,Romania,2,0,0,2,2000
Megan Quann-Jendrick,United States,2,0,0,2,2000
Wang Nan,People's Republic of China,2,0,0,2,2000
Courtney Shealy,United States,2,0,0,2,2000
Venus Williams,United States,2,0,0,2,2000
Susie O'Neill,Australia,1,3,0,4,2000
Svetlana Khorkina,Russian Federation,1,2,0,3,2000
Dmitry Sautin,Russian Federation,1,1,2,4,2000
Massi Rosolino,Italy,1,1,1,3,2000
Kong Linghui,People's Republic of China,1,1,0,2,2000
Anky van Grunsven,Netherlands,1,1,0,2,2000
Isabell Werth,Germany,1,1,0,2,2000
Andrew Hoy,Australia,1,1,0,2,2000
Jens Lehmann,Germany,1,1,0,2,2000
Fu Mingxia,People's Republic of China,1,1,0,2,2000
Tian Liang,People's Republic of China,1,1,0,2,2000
Tom Dolan,United States,1,1,0,2,2000
Kim Nam-Sun,Republic of Korea,1,1,0,2,2000
Jason Queally,Great Britain,1,1,0,2,2000
Jan Ullrich,Germany,1,1,0,2,2000
Li Na,People's Republic of China,1,1,0,2,2000
Yang Wei,People's Republic of China,1,1,0,2,2000
Maria Olaru,Romania,1,1,0,2,2000
Andreea Răducan,Romania,1,1,0,2,2000
Tao Luna,People's Republic of China,1,1,0,2,2000
Adam Pine,Australia,1,1,0,2,2000
Anthony Ervin,United States,1,1,0,2,2000
Jason Lezak,United States,1,1,0,2,2000
Ed Moses,United States,1,1,0,2,2000
Neil Walker,United States,1,1,0,2,2000
Diana Munz,United States,1,1,0,2,2000
Li Ju,People's Republic of China,1,1,0,2,2000
Kim Su-Nyeong,Republic of Korea,1,0,1,2,2000
Andreas Dittmer,Germany,1,0,1,2,2000
David O'Connor,United States,1,0,1,2,2000
Giovanna Trillini,Italy,1,0,1,2,2000
Liu Xuan,People's Republic of China,1,0,1,2,2000
Gabriela Szabo,Romania,1,0,1,2,2000
Irina Privalova,Russian Federation,1,0,1,2,2000
Gao Ling,People's Republic of China,1,0,1,2,2000
Florin Popescu,Romania,1,0,1,2,2000
Mitică Pricop,Romania,1,0,1,2,2000
Ulla Salzgeber,Germany,1,0,1,2,2000
Simon Fairweather,Australia,1,0,0,1,2000
Sébastien Lareau,Canada,1,0,0,1,2000
Daniel Nestor,Canada,1,0,0,1,2000
Ge Fei,People's Republic of China,1,0,0,1,2000
Gu Jun,People's Republic of China,1,0,0,1,2000
Laura Berg,United States,1,0,0,1,2000
Sheila Cornell-Douty,United States,1,0,0,1,2000
Lisa Fernandez,United States,1,0,0,1,2000
Lori Harrigan,United States,1,0,0,1,2000
Leah O'Brien-Amico,United States,1,0,0,1,2000
Dot Richardson,United States,1,0,0,1,2000
Michele Smith,United States,1,0,0,1,2000
Christa Williams,United States,1,0,0,1,2000
Félix Savón,Cuba,1,0,0,1,2000
Jang Yong-Ho,Republic of Korea,1,0,0,1,2000
Oh Gyo-Mun,Republic of Korea,1,0,0,1,2000
Yermakhan Ibraimov,Kazakhstan,1,0,0,1,2000
Ruthie Bolton-Holifield,United States,1,0,0,1,2000
Teresa Edwards,United States,1,0,0,1,2000
Lisa Leslie,United States,1,0,0,1,2000
Nikki McCray,United States,1,0,0,1,2000
Dawn Staley,United States,1,0,0,1,2000
Sheryl Swoopes,United States,1,0,0,1,2000
Gary Payton,United States,1,0,0,1,2000
Aleksandr Lebzyak,Russian Federation,1,0,0,1,2000
Oleg Saitov,Russian Federation,1,0,0,1,2000
Mukhammad Kadyr Abdullayev,Uzbekistan,1,0,0,1,2000
Štěpánka Hilgertová,Czech Republic,1,0,0,1,2000
Manuela Mucke,Germany,1,0,0,1,2000
Anett Schuck,Germany,1,0,0,1,2000
György Kolonics,Hungary,1,0,0,1,2000
Imre Pulai,Hungary,1,0,0,1,2000
Josefa Idem-Guerrini,Italy,1,0,0,1,2000
Beniamino Bonomi,Italy,1,0,0,1,2000
Antonio Rossi,Italy,1,0,0,1,2000
Otto Becker,Germany,1,0,0,1,2000
Ludger Beerbaum,Germany,1,0,0,1,2000
Phillip Dutton,Australia,1,0,0,1,2000
Lars Nieberg,Germany,1,0,0,1,2000
Matt Ryan,Australia,1,0,0,1,2000
Antonella Bellutti,Italy,1,0,0,1,2000
Paola Pezzo,Italy,1,0,0,1,2000
Brett Aitken,Australia,1,0,0,1,2000
Guido Fulst,Germany,1,0,0,1,2000
Vyacheslav Yekimov,Russian Federation,1,0,0,1,2000
Joan Llaneras,Spain,1,0,0,1,2000
Miguel Martinez,France,1,0,0,1,2000
Scott McGrory,Australia,1,0,0,1,2000
Marty Nothstein,United States,1,0,0,1,2000
Alyson Annan,Australia,1,0,0,1,2000
Renita Farrell-Garard,Australia,1,0,0,1,2000
Juliet Haslam,Australia,1,0,0,1,2000
Rechelle Hawkes,Australia,1,0,0,1,2000
Clover Maitland,Australia,1,0,0,1,2000
Jenny Morris,Australia,1,0,0,1,2000
Alison Peek,Australia,1,0,0,1,2000
Triny Powell,Australia,1,0,0,1,2000
Lisa Powell-Carruthers,Australia,1,0,0,1,2000
Kate Starre,Australia,1,0,0,1,2000
Jacques Brinkman,Netherlands,1,0,0,1,2000
Teun de Nooijer,Netherlands,1,0,0,1,2000
Jeroen Delmeé,Netherlands,1,0,0,1,2000
Ronald Jansen,Netherlands,1,0,0,1,2000
Erik Jazet,Netherlands,1,0,0,1,2000
Bram Lomans,Netherlands,1,0,0,1,2000
Wouter van Pelt,Netherlands,1,0,0,1,2000
Remco van Wijk,Netherlands,1,0,0,1,2000
Stephan Veen,Netherlands,1,0,0,1,2000
Guus Vogels,Netherlands,1,0,0,1,2000
Oksana Yermakova,Estonia,1,0,0,1,2000
Tímea Nagy,Hungary,1,0,0,1,2000
Diana Bianchedi,Italy,1,0,0,1,2000
Karina Aznavuryan,Russian Federation,1,0,0,1,2000
Mariya Mazina,Russian Federation,1,0,0,1,2000
Patrice Lhôtellier,France,1,0,0,1,2000
Lionel Plumenail,France,1,0,0,1,2000
Angelo Mazzoni,Italy,1,0,0,1,2000
Maurizio Randazzo,Italy,1,0,0,1,2000
Kim Yeong-Ho,Republic of Korea,1,0,0,1,2000
Mihai Covaliu,Romania,1,0,0,1,2000
Pavel Kolobkov,Russian Federation,1,0,0,1,2000
Stanislav Pozdnyakov,Russian Federation,1,0,0,1,2000
Sergey Sharikov,Russian Federation,1,0,0,1,2000
Gro Espeseth,Norway,1,0,0,1,2000
Bente Nordby,Norway,1,0,0,1,2000
Marianne Pettersen,Norway,1,0,0,1,2000
Hege Riise,Norway,1,0,0,1,2000
Brit Sandaune,Norway,1,0,0,1,2000
Szilveszter Csollány,Hungary,1,0,0,1,2000
Marius Urzică,Romania,1,0,0,1,2000
Camilla Andersen,Denmark,1,0,0,1,2000
Tina Bøttzau,Denmark,1,0,0,1,2000
Anette Hoffmann-Møberg,Denmark,1,0,0,1,2000
Tonje Kjærgaard,Denmark,1,0,0,1,2000
Janne Kolling,Denmark,1,0,0,1,2000
Lene Rantala,Denmark,1,0,0,1,2000
Dmitry Filippov,Russian Federation,1,0,0,1,2000
Vyacheslav Gorpishin,Russian Federation,1,0,0,1,2000
Vasily Kudinov,Russian Federation,1,0,0,1,2000
Igor Lavrov,Russian Federation,1,0,0,1,2000
Andrey Lavrov,Russian Federation,1,0,0,1,2000
Sergey Pogorelov,Russian Federation,1,0,0,1,2000
Pavel Sukosyan,Russian Federation,1,0,0,1,2000
Dmitry Torgovanov,Russian Federation,1,0,0,1,2000
Lev Voronin,Russian Federation,1,0,0,1,2000
Aleksandr Tuchkin,Russian Federation,1,0,0,1,2000
Isabel Fernández,Spain,1,0,0,1,2000
Ryoko Tamura-Tani,Japan,1,0,0,1,2000
Legna Verdecia,Cuba,1,0,0,1,2000
David Douillet,France,1,0,0,1,2000
Mark Huizinga,Netherlands,1,0,0,1,2000
Tadahiro Nomura,Japan,1,0,0,1,2000
Dmitry Svatkovsky,Russian Federation,1,0,0,1,2000
Katsiaryna Khadatovich-Karsten,Belarus,1,0,0,1,2000
Michel Andrieux,France,1,0,0,1,2000
Xavier Dorfman,France,1,0,0,1,2000
Jean-Christophe Rolland,France,1,0,0,1,2000
James Cracknell,Great Britain,1,0,0,1,2000
Tim Foster,Great Britain,1,0,0,1,2000
Ben Hunt-Davis,Great Britain,1,0,0,1,2000
Matthew Pinsent,Great Britain,1,0,0,1,2000
Steven Redgrave,Great Britain,1,0,0,1,2000
Kathrin Boron,Germany,1,0,0,1,2000
Meike Evers,Germany,1,0,0,1,2000
Manuela Lutze,Germany,1,0,0,1,2000
Jana Thieme,Germany,1,0,0,1,2000
Agostino Abbagnale,Italy,1,0,0,1,2000
Rossano Galtarossa,Italy,1,0,0,1,2000
Rob Waddell,New Zealand,1,0,0,1,2000
Robert Sycz,Poland,1,0,0,1,2000
Constanța Pipotă-Burcică,Romania,1,0,0,1,2000
Veronica Cogeanu-Cochela,Romania,1,0,0,1,2000
Liliana Gafencu,Romania,1,0,0,1,2000
Elena Georgescu,Romania,1,0,0,1,2000
Elisabeta Oleniuc-Lipă,Romania,1,0,0,1,2000
Viorica Susanu,Romania,1,0,0,1,2000
Angela Tamaș-Alupei,Romania,1,0,0,1,2000
Iztok Čop,Slovenia,1,0,0,1,2000
Luka Špik,Slovenia,1,0,0,1,2000
Michael Diamond,Australia,1,0,0,1,2000
Mariya Grozdeva,Bulgaria,1,0,0,1,2000
Tanyu Kiryakov,Bulgaria,1,0,0,1,2000
Yang Ling,People's Republic of China,1,0,0,1,2000
Franck Dumoulin,France,1,0,0,1,2000
Richard Faulds,Great Britain,1,0,0,1,2000
Daina Gudzinevičiūtė,Lithuania,1,0,0,1,2000
Renata Mauer-Różańska,Poland,1,0,0,1,2000
Rajmond Debevec,Slovenia,1,0,0,1,2000
Nancy Napolski-Johnson,United States,1,0,0,1,2000
Chris Fydler,Australia,1,0,0,1,2000
Daniel Kowalski,Australia,1,0,0,1,2000
Xiao Hailiang,People's Republic of China,1,0,0,1,2000
Ágnes Kovács,Hungary,1,0,0,1,2000
Yelena Azarova,Russian Federation,1,0,0,1,2000
Vera Ilyina,Russian Federation,1,0,0,1,2000
Olga Novokshchenova,Russian Federation,1,0,0,1,2000
Lars Frölander,Sweden,1,0,0,1,2000
Tom Malchow,United States,1,0,0,1,2000
Natalie Cook,Australia,1,0,0,1,2000
Kerri-Ann Pottharst,Australia,1,0,0,1,2000
Regla Bell,Cuba,1,0,0,1,2000
Marlenis Costa,Cuba,1,0,0,1,2000
Ana Ivis Fernández,Cuba,1,0,0,1,2000
Mireya Luis,Cuba,1,0,0,1,2000
Yumilka Ruiz,Cuba,1,0,0,1,2000
Regla Torres,Cuba,1,0,0,1,2000
Vladimir Batez,Montenegro,1,0,0,1,2000
Andrija Gerić,Serbia,1,0,0,1,2000
Nikola Grbić,Serbia,1,0,0,1,2000
Vladimir Grbić,Serbia,1,0,0,1,2000
Slobodan Kovač,Serbia,1,0,0,1,2000
Đula Mešter,Serbia,1,0,0,1,2000
Goran Vujević,Montenegro,1,0,0,1,2000
Tibor Benedek,Hungary,1,0,0,1,2000
Rajmund Fodor,Hungary,1,0,0,1,2000
Tamás Kásás,Hungary,1,0,0,1,2000
Zoltán Kósz,Hungary,1,0,0,1,2000
Zsolt Varga,Hungary,1,0,0,1,2000
Nikolaj Pešalov,Bulgaria,1,0,0,1,2000
Zhan Xugang,People's Republic of China,1,0,0,1,2000
Pyrros Dimas,Greece,1,0,0,1,2000
Akakios Kakiasvili,Georgia,1,0,0,1,2000
Halil Mutlu,Turkey,1,0,0,1,2000
Armen Nazaryan,Armenia,1,0,0,1,2000
Namiq Abdullayev,Azerbaijan,1,0,0,1,2000
Filiberto Azcuy,Cuba,1,0,0,1,2000
Sim Gwon-Ho,Republic of Korea,1,0,0,1,2000
Mikael Ljungberg,Sweden,1,0,0,1,2000
Hamza Yerlikaya,Turkey,1,0,0,1,2000
Sagid Murtazaliyev,Russian Federation,1,0,0,1,2000
Jenny Armstrong,Australia,1,0,0,1,2000
Shirley Robertson,Great Britain,1,0,0,1,2000
Alessandra Sensini,Italy,1,0,0,1,2000
Ben Ainslie,Great Britain,1,0,0,1,2000
Jesper Bank,Denmark,1,0,0,1,2000
Roman Hagara,Austria,1,0,0,1,2000
Thomas Johanson,Finland,1,0,0,1,2000
Tom King,Australia,1,0,0,1,2000
Mark Reynolds,United States,1,0,0,1,2000
Christoph Sieber,Austria,1,0,0,1,2000
Nouria Mérah-Benida,Algeria,1,0,0,1,2000
Cathy Freeman,Australia,1,0,0,1,2000
Eldece Clarke-Lewis,The Bahamas,1,0,0,1,2000
Debbie Ferguson-McKenzie,The Bahamas,1,0,0,1,2000
Savatheda Fynes,The Bahamas,1,0,0,1,2000
Chandra Sturrup,The Bahamas,1,0,0,1,2000
Elina Zverava,Belarus,1,0,0,1,2000
María Isabel Urrutia,Colombia,1,0,0,1,2000
Anier García,Cuba,1,0,0,1,2000
Iván Pedroso,Cuba,1,0,0,1,2000
Jan Železný,Czech Republic,1,0,0,1,2000
Erki Nool,Estonia,1,0,0,1,2000
Derartu Tulu,Ethiopia,1,0,0,1,2000
Haile Gebrselassie,Ethiopia,1,0,0,1,2000
Arsi Harju,Finland,1,0,0,1,2000
Denise Lewis,Great Britain,1,0,0,1,2000
Jonathan Edwards,Great Britain,1,0,0,1,2000
Heike Drechsler,East Germany,1,0,0,1,2000
Virgilijus Alekna,Lithuania,1,0,0,1,2000
Maria Mutola,Mozambique,1,0,0,1,2000
Sunday Bada,Nigeria,1,0,0,1,2000
Clement Chukwu,Nigeria,1,0,0,1,2000
Jude Monye,Nigeria,1,0,0,1,2000
Trine Solberg-Hattestad,Norway,1,0,0,1,2000
Szymon Ziółkowski,Poland,1,0,0,1,2000
Jearl Miles-Clark,United States,1,0,0,1,2000
Jon Drummond,United States,1,0,0,1,2000
Michael Johnson,United States,1,0,0,1,2000
Tim Montgomery,United States,1,0,0,1,2000
Nils Schumann,Germany,1,0,0,1,2000
Zhang Jun,People's Republic of China,1,0,0,1,2000
Tony Gunawan,Indonesia,1,0,0,1,2000
Candra Wijaya,Indonesia,1,0,0,1,2000
Shareef Abdur-Rahim,United States,1,0,0,1,2000
Ray Allen,United States,1,0,0,1,2000
Vin Baker,United States,1,0,0,1,2000
Vince Carter,United States,1,0,0,1,2000
Kevin Garnett,United States,1,0,0,1,2000
Tim Hardaway,United States,1,0,0,1,2000
Allan Houston,United States,1,0,0,1,2000
Jason Kidd,United States,1,0,0,1,2000
Antonio McDyess,United States,1,0,0,1,2000
Alonzo Mourning,United States,1,0,0,1,2000
Steve Smith,United States,1,0,0,1,2000
Kim Cheong-Tae,Republic of Korea,1,0,0,1,2000
Yanina Pravalinskaya-Karolchyk,Belarus,1,0,0,1,2000
Tereza Marinova,Bulgaria,1,0,0,1,2000
Wang Liping,People's Republic of China,1,0,0,1,2000
Gezahgne Abera,Ethiopia,1,0,0,1,2000
Million Wolde,Ethiopia,1,0,0,1,2000
Kostas Kenteris,Greece,1,0,0,1,2000
Naoko Takahashi,Japan,1,0,0,1,2000
Reuben Kosgei,Kenya,1,0,0,1,2000
Noah Ngeny,Kenya,1,0,0,1,2000
Olga Shishigina,Kazakhstan,1,0,0,1,2000
Nduka Awazie,Nigeria,1,0,0,1,2000
Fidelis Gadzama,Nigeria,1,0,0,1,2000
Enefiok Udo-Obong,Nigeria,1,0,0,1,2000
Kamila Skolimowska,Poland,1,0,0,1,2000
Sergey Klyugin,Russian Federation,1,0,0,1,2000
Karen Brødsgaard,Denmark,1,0,0,1,2000
Katrine Fruelund,Denmark,1,0,0,1,2000
Maja Grønbæk,Denmark,1,0,0,1,2000
Lotte Kiærskou,Denmark,1,0,0,1,2000
Karin Mortensen,Denmark,1,0,0,1,2000
Anja Nielsen,Denmark,1,0,0,1,2000
Rikke Petersen Schmidt,Denmark,1,0,0,1,2000
Christina Roslyng,Denmark,1,0,0,1,2000
Mette Vestergaard,Denmark,1,0,0,1,2000
Yelena Yelesina,Russian Federation,1,0,0,1,2000
Andrea Anderson,United States,1,0,0,1,2000
Kenny Brokenburr,United States,1,0,0,1,2000
LaTasha Colander-Richardson,United States,1,0,0,1,2000
Stacy Dragila,United States,1,0,0,1,2000
Monique Hennagan,United States,1,0,0,1,2000
Nick Hysong,United States,1,0,0,1,2000
Brian Lewis,United States,1,0,0,1,2000
Angelo Taylor,United States,1,0,0,1,2000
"Bernard Williams, III",United States,1,0,0,1,2000
Gong Zhichao,People's Republic of China,1,0,0,1,2000
Ji Xinpeng,People's Republic of China,1,0,0,1,2000
Brent Abernathy,United States,1,0,0,1,2000
Kurt Ainsworth,United States,1,0,0,1,2000
Pat Borders,United States,1,0,0,1,2000
Sean Burroughs,United States,1,0,0,1,2000
John Cotton,United States,1,0,0,1,2000
Travis Dawkins,United States,1,0,0,1,2000
Adam Everett,United States,1,0,0,1,2000
Ryan Franklin,United States,1,0,0,1,2000
Chris George,United States,1,0,0,1,2000
Shane Heams,United States,1,0,0,1,2000
Marcus Jensen,United States,1,0,0,1,2000
Mike Kinkade,United States,1,0,0,1,2000
Rick Krivda,United States,1,0,0,1,2000
Doug Mientkiewicz,United States,1,0,0,1,2000
Mike Neill,United States,1,0,0,1,2000
Roy Oswalt,United States,1,0,0,1,2000
Jon Rauch,United States,1,0,0,1,2000
Anthony Sanders,United States,1,0,0,1,2000
Bobby Seay,United States,1,0,0,1,2000
Ben Sheets,United States,1,0,0,1,2000
Brad Wilkerson,United States,1,0,0,1,2000
Todd Williams,United States,1,0,0,1,2000
Ernie Young,United States,1,0,0,1,2000
Tim Young,United States,1,0,0,1,2000
Jorge Gutiérrez,Cuba,1,0,0,1,2000
Mario Kindelán,Cuba,1,0,0,1,2000
Guillermo Rigondeaux,Cuba,1,0,0,1,2000
Brahim Asloum,France,1,0,0,1,2000
Audley Harrison,Great Britain,1,0,0,1,2000
Bekzat Sattarkhanov,Kazakhstan,1,0,0,1,2000
Wijan Ponlid,Thailand,1,0,0,1,2000
Yolanda Griffith,United States,1,0,0,1,2000
DeLisha Milton-Jones,United States,1,0,0,1,2000
Katie Smith,United States,1,0,0,1,2000
Natalie Williams,United States,1,0,0,1,2000
Kara Wolters,United States,1,0,0,1,2000
Tony Estanguet,France,1,0,0,1,2000
Thomas Schmidt,Germany,1,0,0,1,2000
Gábor Horváth,Hungary,1,0,0,1,2000
Ferenc Novák,Hungary,1,0,0,1,2000
Ákos Vereckei,Hungary,1,0,0,1,2000
Pavol Hochschorner,Slovakia,1,0,0,1,2000
Peter Hochschorner,Slovakia,1,0,0,1,2000
Laurent Gané,France,1,0,0,1,2000
Arnaud Tournant,France,1,0,0,1,2000
Daniel Becke,Germany,1,0,0,1,2000
Olaf Pollack,Germany,1,0,0,1,2000
Sang Xue,People's Republic of China,1,0,0,1,2000
Igor Lukashin,Russian Federation,1,0,0,1,2000
Yuliya Pakhalina,Russian Federation,1,0,0,1,2000
Laura Wilkinson,United States,1,0,0,1,2000
Stuart Tinney,Australia,1,0,0,1,2000
Nadine Capellmann,Germany,1,0,0,1,2000
Marcus Ehning,Germany,1,0,0,1,2000
Alexandra Simons de Ridder,Germany,1,0,0,1,2000
Jeroen Dubbeldam,Netherlands,1,0,0,1,2000
Jean-Noël Ferrari,France,1,0,0,1,2000
Brice Guyart,France,1,0,0,1,2000
Paolo Milanoli,Italy,1,0,0,1,2000
Alfredo Rota,Italy,1,0,0,1,2000
Aleksey Frosin,Russian Federation,1,0,0,1,2000
Tatyana Logunova,Russian Federation,1,0,0,1,2000
Kristin Bekkevold,Norway,1,0,0,1,2000
Christine Bøe Jensen,Norway,1,0,0,1,2000
Ragnhild Gulbrandsen,Norway,1,0,0,1,2000
Solveig Gulbrandsen,Norway,1,0,0,1,2000
Margunn Haugenes,Norway,1,0,0,1,2000
Silje Jørgensen,Norway,1,0,0,1,2000
Monica Knudsen,Norway,1,0,0,1,2000
Gøril Kringen,Norway,1,0,0,1,2000
Unni Lehn,Norway,1,0,0,1,2000
Dagny Mellgren,Norway,1,0,0,1,2000
Anita Rapp,Norway,1,0,0,1,2000
Anne Tønnessen,Norway,1,0,0,1,2000
Patrice Abanda,Cameroon,1,0,0,1,2000
Nicolas Alnoudji,Cameroon,1,0,0,1,2000
Clément Beaud,Cameroon,1,0,0,1,2000
Daniel Bekono,Cameroon,1,0,0,1,2000
Serge Branco,Cameroon,1,0,0,1,2000
Joël Epalle,Cameroon,1,0,0,1,2000
Lauren,Cameroon,1,0,0,1,2000
Samuel Eto'o,Cameroon,1,0,0,1,2000
Idriss Carlos Kameni,Cameroon,1,0,0,1,2000
Modeste M'Bami,Cameroon,1,0,0,1,2000
Patrick M'Boma,Cameroon,1,0,0,1,2000
Albert Meyong Zé,Cameroon,1,0,0,1,2000
Serge Mimpo,Cameroon,1,0,0,1,2000
Daniel N'Gom Komé,Cameroon,1,0,0,1,2000
Aaron Nguimbat,Cameroon,1,0,0,1,2000
Geremi,Cameroon,1,0,0,1,2000
Patrick Suffo,Cameroon,1,0,0,1,2000
Pierre Womé,Cameroon,1,0,0,1,2000
Huang Xu,People's Republic of China,1,0,0,1,2000
Xiao Junfeng,People's Republic of China,1,0,0,1,2000
Xing Aowei,People's Republic of China,1,0,0,1,2000
Zheng Lihui,People's Republic of China,1,0,0,1,2000
Gervasio Deferr,Spain,1,0,0,1,2000
Oleg Khodkov,Russian Federation,1,0,0,1,2000
Eduard Koksharov,Russian Federation,1,0,0,1,2000
Stanislav Kulinchenko,Russian Federation,1,0,0,1,2000
Dmitry Kuzelev,Russian Federation,1,0,0,1,2000
Denis Krivoshlykov,Russian Federation,1,0,0,1,2000
Igors Vihrovs,Latvia,1,0,0,1,2000
Loredana Boboc,Romania,1,0,0,1,2000
Andreea Isărescu,Romania,1,0,0,1,2000
Claudia Presăcan,Romania,1,0,0,1,2000
Yuliya Barsukova,Russian Federation,1,0,0,1,2000
Irina Belova,Russian Federation,1,0,0,1,2000
Yelena Shalamova,Russian Federation,1,0,0,1,2000
Nataliya Lavrova,Russian Federation,1,0,0,1,2000
Mariya Netesova,Russian Federation,1,0,0,1,2000
Vera Shimanskaya,Russian Federation,1,0,0,1,2000
Irina Zilber,Russian Federation,1,0,0,1,2000
Irina Karavayeva,Russian Federation,1,0,0,1,2000
Aleksandr Moskalenko,Russian Federation,1,0,0,1,2000
Jaap-Derk Buma,Netherlands,1,0,0,1,2000
Marten Eikelboom,Netherlands,1,0,0,1,2000
Piet-Hein Geeris,Netherlands,1,0,0,1,2000
Sander van der Weide,Netherlands,1,0,0,1,2000
Diederik van Weel,Netherlands,1,0,0,1,2000
Peter Windt,Netherlands,1,0,0,1,2000
Katie Allen,Australia,1,0,0,1,2000
Nikki Hudson,Australia,1,0,0,1,2000
Rachel Imison,Australia,1,0,0,1,2000
Claire Mitchell-Taverner,Australia,1,0,0,1,2000
Angie Skirving-Lambert,Australia,1,0,0,1,2000
Julie Towers,Australia,1,0,0,1,2000
Tang Lin,People's Republic of China,1,0,0,1,2000
Yuan Hua,People's Republic of China,1,0,0,1,2000
Sibelis Veranes,Cuba,1,0,0,1,2000
Séverine Vandenhende,France,1,0,0,1,2000
Giuseppe Maddaloni,Italy,1,0,0,1,2000
Kosei Inoue,Japan,1,0,0,1,2000
Makoto Takimoto,Japan,1,0,0,1,2000
Hüseyin Özkan,Turkey,1,0,0,1,2000
Steph Cook,Great Britain,1,0,0,1,2000
Jean-Christophe Bette,France,1,0,0,1,2000
Yves Hocdé,France,1,0,0,1,2000
Laurent Porchier,France,1,0,0,1,2000
Louis Attrill,Great Britain,1,0,0,1,2000
Simon Dennis,Great Britain,1,0,0,1,2000
Rowley Douglas,Great Britain,1,0,0,1,2000
Luka Grubor,Great Britain,1,0,0,1,2000
Andrew Lindsay,Great Britain,1,0,0,1,2000
Fred Scarlett,Great Britain,1,0,0,1,2000
Steve Trapmore,Great Britain,1,0,0,1,2000
Kieran West,Great Britain,1,0,0,1,2000
Kerstin Kowalski-El-Qalqili,Germany,1,0,0,1,2000
Manja Kowalski,Germany,1,0,0,1,2000
Simone Raineri,Italy,1,0,0,1,2000
Alessio Sartori,Italy,1,0,0,1,2000
Tomasz Kucharski,Poland,1,0,0,1,2000
Maria Dumitrache,Romania,1,0,0,1,2000
Mark Turnbull,Australia,1,0,0,1,2000
Belinda Stowell,Australia,1,0,0,1,2000
Hans-Peter Steinacher,Austria,1,0,0,1,2000
Henrik Blakskjær,Denmark,1,0,0,1,2000
Thomas Jacobsen,Denmark,1,0,0,1,2000
Jyrki Järvi,Finland,1,0,0,1,2000
Iain Percy,Great Britain,1,0,0,1,2000
Magnus Liljedahl,United States,1,0,0,1,2000
Zemfira Meftəkhətddinova,Azerbaijan,1,0,0,1,2000
Cai Yalin,People's Republic of China,1,0,0,1,2000
Sergey Alifirenko,Russian Federation,1,0,0,1,2000
Jonas Edman,Sweden,1,0,0,1,2000
Pia Hansen,Sweden,1,0,0,1,2000
Mykola Milchev,Ukraine,1,0,0,1,2000
Christie Ambrosi,United States,1,0,0,1,2000
Jennifer Brundage,United States,1,0,0,1,2000
Crystl Bustos,United States,1,0,0,1,2000
Danielle Henderson,United States,1,0,0,1,2000
Jennifer McFalls,United States,1,0,0,1,2000
Stacey Nuveman,United States,1,0,0,1,2000
Michelle Venturella,United States,1,0,0,1,2000
Ashley Callus,Australia,1,0,0,1,2000
Bill Kirby,Australia,1,0,0,1,2000
Ian Crocker,United States,1,0,0,1,2000
Tommy Hannan,United States,1,0,0,1,2000
Sam Arsenault,United States,1,0,0,1,2000
B. J. Bedford,United States,1,0,0,1,2000
Lindsay Benko,United States,1,0,0,1,2000
Kim Black,United States,1,0,0,1,2000
Misty Hyman,United States,1,0,0,1,2000
Erin Phenix,United States,1,0,0,1,2000
Yelena Soya,Russian Federation,1,0,0,1,2000
Yuliya Vasilyeva,Russian Federation,1,0,0,1,2000
Olga Vasyukova,Russian Federation,1,0,0,1,2000
Wang Liqin,People's Republic of China,1,0,0,1,2000
Yan Sen,People's Republic of China,1,0,0,1,2000
Staciana Stitts,United States,1,0,0,1,2000
Julia Stowers,United States,1,0,0,1,2000
Lauren Burns,Australia,1,0,0,1,2000
Chen Zhong,People's Republic of China,1,0,0,1,2000
Ángel Matos,Cuba,1,0,0,1,2000
Mikhail Mouroutsos,Greece,1,0,0,1,2000
Jeong Jae-Eun,Republic of Korea,1,0,0,1,2000
Kim Gyeong-Hun,Republic of Korea,1,0,0,1,2000
Lee Seon-Hui,Republic of Korea,1,0,0,1,2000
Steven Lopez,United States,1,0,0,1,2000
Yevgeny Kafelnikov,Russian Federation,1,0,0,1,2000
Brigitte McMahon,Switzerland,1,0,0,1,2000
Dain Blanton,United States,1,0,0,1,2000
Eric Fonoimoana,United States,1,0,0,1,2000
Serena Williams,United States,1,0,0,1,2000
Simon Whitfield,Canada,1,0,0,1,2000
Tai Agüero,Cuba,1,0,0,1,2000
Mirka Francis,Cuba,1,0,0,1,2000
Péter Biros,Hungary,1,0,0,1,2000
Gergő Kiss,Hungary,1,0,0,1,2000
Tamás Märcz,Hungary,1,0,0,1,2000
Tamás Molnár,Hungary,1,0,0,1,2000
Barnabás Steinmetz,Hungary,1,0,0,1,2000
Zoltán Szécsi,Hungary,1,0,0,1,2000
Bulcsú Székely,Hungary,1,0,0,1,2000
Attila Vári,Hungary,1,0,0,1,2000
Chen Xiaomin,People's Republic of China,1,0,0,1,2000
Ding Meiyuan,People's Republic of China,1,0,0,1,2000
Lin Weining,People's Republic of China,1,0,0,1,2000
Yang Xia,People's Republic of China,1,0,0,1,2000
Slobodan Boškan,Serbia,1,0,0,1,2000
Vasa Mijić,Serbia,1,0,0,1,2000
Ivan Miljković,Serbia,1,0,0,1,2000
Igor Vušurović,Montenegro,1,0,0,1,2000
Ioana Olteanu,Romania,1,0,0,1,2000
Naomi Castle,Australia,1,0,0,1,2000
Joanne Fox,Australia,1,0,0,1,2000
Bridgette Gusterson,Australia,1,0,0,1,2000
Simone Hankin,Australia,1,0,0,1,2000
Yvette Higgins,Australia,1,0,0,1,2000
Kate Hooper,Australia,1,0,0,1,2000
Bronwyn Mayer-Smith,Australia,1,0,0,1,2000
Gail Miller,Australia,1,0,0,1,2000
Melissa Mills,Australia,1,0,0,1,2000
Debbie Watson,Australia,1,0,0,1,2000
Liz Weekes,Australia,1,0,0,1,2000
Danielle Woodhouse,Australia,1,0,0,1,2000
Taryn Woods,Australia,1,0,0,1,2000
Galabin Boevski,Bulgaria,1,0,0,1,2000
Hossein Reza Zadeh,Islamic Republic of Iran,1,0,0,1,2000
Hossein Tavakoli,Islamic Republic of Iran,1,0,0,1,2000
Soraya Jiménez,Mexico,1,0,0,1,2000
Tara Nott-Cunningham,United States,1,0,0,1,2000
Daniel Igali,Canada,1,0,0,1,2000
Murat Kardanov,Russian Federation,1,0,0,1,2000
David Musuľbes,Russian Federation,1,0,0,1,2000
Murad Umakhanov,Russian Federation,1,0,0,1,2000
Adam Saytiyev,Russian Federation,1,0,0,1,2000
Varteres Samurgashev,Russian Federation,1,0,0,1,2000
Ali Reza Dabir,Islamic Republic of Iran,1,0,0,1,2000
Rulon Gardner,United States,1,0,0,1,2000
Brandon Slay,United States,1,0,0,1,2000
Irina Pershina,Russian Federation,1,0,0,1,2000
Petria Thomas,Australia,0,2,1,3,2000
Therèse Alshammar,Sweden,0,2,1,3,2000
Yekaterina Lobaznyuk,Russian Federation,0,2,1,3,2000
Matt Welsh,Australia,0,2,1,3,2000
Petar Merkov,Bulgaria,0,2,0,2,2000
Gianna Hablützel-Bürki,Switzerland,0,2,0,2,2000
Eeke van Nes,Netherlands,0,2,0,2,2000
Guo Jingjing,People's Republic of China,0,2,0,2,2000
Miya Tachibana,Japan,0,2,0,2,2000
Miho Takeda,Japan,0,2,0,2,2000
Martina Moravcová,Czech Republic,0,2,0,2,2000
Josh Davis,United States,0,2,0,2,2000
Deon Hemmings,Jamaica,0,2,0,2,2000
Lorraine Graham,Jamaica,0,2,0,2,2000
Tayna Lawrence,Jamaica,0,2,0,2,2000
Katalin Kovács,Hungary,0,2,0,2,2000
Szilvia Szabó,Hungary,0,2,0,2,2000
Hu Jia,People's Republic of China,0,2,0,2,2000
Matthieu Gourdain,France,0,2,0,2,2000
Hugues Obry,France,0,2,0,2,2000
Pieta van Dishoeck,Netherlands,0,2,0,2,2000
Leisel Jones,Australia,0,2,0,2,2000
Giaan Rooney,Australia,0,2,0,2,2000
Liu Guoliang,People's Republic of China,0,1,1,2,2000
Gary Neiwand,Australia,0,1,1,2,2000
Lee Ju-Hyeong,Republic of Korea,0,1,1,2,2000
Ihar Basinski,Belarus,0,1,1,2,2000
Anne Montminy,Canada,0,1,1,2,2000
Mai Nakamura,Japan,0,1,1,2,2000
Beatrice Coadă-Cășlaru,Romania,0,1,1,2,2000
Gete Wami,Ethiopia,0,1,1,2,2000
Beverly McDonald,Jamaica,0,1,1,2,2000
Merlene Ottey-Page,Jamaica,0,1,1,2,2000
Greg Haughton,Jamaica,0,1,1,2,2000
Ato Boldon,Trinidad and Tobago,0,1,1,2,2000
Vic Wunderle,United States,0,1,1,2,2000
Rita König,Germany,0,1,1,2,2000
Aleksey Bondarenko,Russian Federation,0,1,1,2,2000
Yelena Produnova,Russian Federation,0,1,1,2,2000
Oleksandr Beresh,Ukraine,0,1,1,2,2000
Geoff Huegill,Australia,0,1,1,2,2000
Klete Keller,United States,0,1,1,2,2000
Minarti Timur,Indonesia,0,1,0,1,2000
Tri Kusharyanto,Indonesia,0,1,0,1,2000
Todd Woodbridge,Australia,0,1,0,1,2000
Mark Woodforde,Australia,0,1,0,1,2000
Yu Yong-Seong,Republic of Korea,0,1,0,1,2000
Naomi Matsumoto,Japan,0,1,0,1,2000
Haruka Saito,Japan,0,1,0,1,2000
Juri Takayama,Japan,0,1,0,1,2000
Noriko Yamaji,Japan,0,1,0,1,2000
Omar Ajete,Cuba,0,1,0,1,2000
Miguel Caldés,Cuba,0,1,0,1,2000
José Contreras,Cuba,0,1,0,1,2000
Orestes Kindelán,Cuba,0,1,0,1,2000
Pedro Luis Lazo,Cuba,0,1,0,1,2000
Omar Linares,Cuba,0,1,0,1,2000
Juan Manrique,Cuba,0,1,0,1,2000
Germán Mesa,Cuba,0,1,0,1,2000
Antonio Pacheco,Cuba,0,1,0,1,2000
Antonio Scull,Cuba,0,1,0,1,2000
Luis Ulacia,Cuba,0,1,0,1,2000
Matteo Bisiani,Italy,0,1,0,1,2000
Ilario Di Buò,Italy,0,1,0,1,2000
Michele Frangilli,Italy,0,1,0,1,2000
Olena Sadovnycha,Ukraine,0,1,0,1,2000
Camilla Martin,Denmark,0,1,0,1,2000
Jan-Ove Waldner,Sweden,0,1,0,1,2000
Misako Ando,Japan,0,1,0,1,2000
Rafael Lozano,Spain,0,1,0,1,2000
Bolat Zhumadilov,Kazakhstan,0,1,0,1,2000
Carla Boyd,Australia,0,1,0,1,2000
Michelle Brogan-Griffiths,Australia,0,1,0,1,2000
Sandy Brondello,Australia,0,1,0,1,2000
Trish Fallon,Australia,0,1,0,1,2000
Shelley Gorman-Sandie,Australia,0,1,0,1,2000
Rachael Sporn,Australia,0,1,0,1,2000
Michele Timms,Australia,0,1,0,1,2000
Jenny Whittle,Australia,0,1,0,1,2000
Marian Simion,Romania,0,1,0,1,2000
Raimkul Malakhbekov,Russian Federation,0,1,0,1,2000
Danny Collins,Australia,0,1,0,1,2000
Andrew Trim,Australia,0,1,0,1,2000
Caroline Brunet,Canada,0,1,0,1,2000
Paul Ratcliffe,Great Britain,0,1,0,1,2000
Mark Zabel,Germany,0,1,0,1,2000
Rita Kőbán,Hungary,0,1,0,1,2000
Paweł Baraszkiewicz,Poland,0,1,0,1,2000
Krzysztof Kołomański,Poland,0,1,0,1,2000
Michał Staniszewski,Poland,0,1,0,1,2000
Michal Martikán,Slovakia,0,1,0,1,2000
Henrik Nilsson,Sweden,0,1,0,1,2000
Markus Oscarsson,Sweden,0,1,0,1,2000
Ellen Bontje,Netherlands,0,1,0,1,2000
Lesley McNaught-Mändli,Switzerland,0,1,0,1,2000
Markus Fuchs,Switzerland,0,1,0,1,2000
Beat Mändli,Switzerland,0,1,0,1,2000
Willi Melliger,Switzerland,0,1,0,1,2000
Ian Stark,Great Britain,0,1,0,1,2000
Marion Clignet,France,0,1,0,1,2000
Michelle Ferris,Australia,0,1,0,1,2000
Oksana Grishina,Russian Federation,0,1,0,1,2000
Étienne De Wilde,Belgium,0,1,0,1,2000
Oleksandr Fedenko,Ukraine,0,1,0,1,2000
Serhiy Matvieiev,Ukraine,0,1,0,1,2000
Oleksandr Symonenko,Ukraine,0,1,0,1,2000
Aleksandr Vinokurov,Kazakhstan,0,1,0,1,2000
Milton Wynants,Uruguay,0,1,0,1,2000
Magdalena Aicega,Argentina,0,1,0,1,2000
Anabel Gambero,Argentina,0,1,0,1,2000
Karina Masotta,Argentina,0,1,0,1,2000
Vanina Oneto,Argentina,0,1,0,1,2000
Jorgelina Rimoldi,Argentina,0,1,0,1,2000
Ceci Rognoni,Argentina,0,1,0,1,2000
Ayelén Stepnik,Argentina,0,1,0,1,2000
Jeon Jong-Ha,Republic of Korea,0,1,0,1,2000
Gang Geon-Uk,Republic of Korea,0,1,0,1,2000
Kim Yong-Bae,Republic of Korea,0,1,0,1,2000
Kim Yun,Republic of Korea,0,1,0,1,2000
Song Seong-Tae,Republic of Korea,0,1,0,1,2000
Anna Rybicka,Poland,0,1,0,1,2000
Barbara Wolnicka-Szewczyk,Poland,0,1,0,1,2000
Dong Zhaozhi,People's Republic of China,0,1,0,1,2000
Wang Haibin,People's Republic of China,0,1,0,1,2000
Ye Chong,People's Republic of China,0,1,0,1,2000
Jean-François Di Martino,France,0,1,0,1,2000
Éric Srecki,France,0,1,0,1,2000
Damien Touya,France,0,1,0,1,2000
Brandi Chastain,United States,0,1,0,1,2000
Joy Fawcett,United States,0,1,0,1,2000
Julie Foudy,United States,0,1,0,1,2000
Mia Hamm,United States,0,1,0,1,2000
Kristine Lilly,United States,0,1,0,1,2000
Shannon MacMillan,United States,0,1,0,1,2000
Tiffeny Milbrett,United States,0,1,0,1,2000
Cindy Parlow,United States,0,1,0,1,2000
Éric Poujade,France,0,1,0,1,2000
Oleksandr Svitlychnyi,Ukraine,0,1,0,1,2000
Andrea Farkas,Hungary,0,1,0,1,2000
Anikó Kántor,Hungary,0,1,0,1,2000
Beatrix Kökény,Hungary,0,1,0,1,2000
Anikó Nagy,Hungary,0,1,0,1,2000
Ildikó Pádár,Hungary,0,1,0,1,2000
Beáta Siti,Hungary,0,1,0,1,2000
Magnus Andersson,Sweden,0,1,0,1,2000
Martin Frändesjö,Sweden,0,1,0,1,2000
Andreas Larsson,Sweden,0,1,0,1,2000
Ola Lindgren,Sweden,0,1,0,1,2000
Stefan Lövgren,Sweden,0,1,0,1,2000
Staffan Olsson,Sweden,0,1,0,1,2000
Johan Pettersson,Sweden,0,1,0,1,2000
Tomas Sivertsson,Sweden,0,1,0,1,2000
Tomas Svensson,Sweden,0,1,0,1,2000
Pierre Thorsson,Sweden,0,1,0,1,2000
Magnus Wislander,Sweden,0,1,0,1,2000
Driulis González,Cuba,0,1,0,1,2000
Kate Howey,Great Britain,0,1,0,1,2000
Noriko Sugawara-Narazaki,Japan,0,1,0,1,2000
Larbi Benboudaoud,France,0,1,0,1,2000
Jo In-Cheol,Republic of Korea,0,1,0,1,2000
Nicolas Gill,Canada,0,1,0,1,2000
Kate Slatter,Australia,0,1,0,1,2000
Simon Burgess,Australia,0,1,0,1,2000
Anthony Edwards,Australia,0,1,0,1,2000
Jaime Fernandez,Australia,0,1,0,1,2000
Brett Hayman,Australia,0,1,0,1,2000
Rob Jahrling,Australia,0,1,0,1,2000
Mike McKay,Australia,0,1,0,1,2000
Nick Porzig,Australia,0,1,0,1,2000
Rumyana Dzhadzharova-Neykova,Bulgaria,0,1,0,1,2000
Guin Batten,Great Britain,0,1,0,1,2000
Miriam Batten,Great Britain,0,1,0,1,2000
Gillian Lindsay,Great Britain,0,1,0,1,2000
Lorenzo Carboncini,Italy,0,1,0,1,2000
Riccardo Dei Rossi,Italy,0,1,0,1,2000
Valter Molea,Italy,0,1,0,1,2000
Carlo Mornati,Italy,0,1,0,1,2000
Leonardo Pettinari,Italy,0,1,0,1,2000
Tessa Appeldoorn,Netherlands,0,1,0,1,2000
Elien Meijer,Netherlands,0,1,0,1,2000
Nelleke Penninx,Netherlands,0,1,0,1,2000
Anneke Venema,Netherlands,0,1,0,1,2000
Marieke Westerhof,Netherlands,0,1,0,1,2000
Michiel Bartman,Netherlands,0,1,0,1,2000
Diederik Simon,Netherlands,0,1,0,1,2000
Fredrik Bekken,Norway,0,1,0,1,2000
Olaf Tufte,Norway,0,1,0,1,2000
Xeno Müller,Switzerland,0,1,0,1,2000
Ted Murphy,United States,0,1,0,1,2000
Russell Mark,Australia,0,1,0,1,2000
Wang Yifu,People's Republic of China,0,1,0,1,2000
Torben Grimmel,Denmark,0,1,0,1,2000
Juha Hirvi,Finland,0,1,0,1,2000
Ian Peel,Great Britain,0,1,0,1,2000
Deborah Gelisio,Italy,0,1,0,1,2000
Oleg Moldovan,Republic of Moldova,0,1,0,1,2000
Svetlana Dyomina,Russian Federation,0,1,0,1,2000
Artyom Khadzhibekov,Russian Federation,0,1,0,1,2000
Michel Ansermet,Switzerland,0,1,0,1,2000
Petr Málek,Czech Republic,0,1,0,1,2000
Jasna Šekarić,Individual Olympic Athletes,0,1,0,1,2000
Sarah Ryan,Australia,0,1,0,1,2000
Ryan Mitchell,Australia,0,1,0,1,2000
Kieren Perkins,Australia,0,1,0,1,2000
Ayano Egami,Japan,0,1,0,1,2000
Raika Fujii,Japan,0,1,0,1,2000
Rei Jimbo,Japan,0,1,0,1,2000
Fernando Platas,Mexico,0,1,0,1,2000
Wilma van Hofwegen-van Rijn,Netherlands,0,1,0,1,2000
Aleksandr Popov,Russian Federation,0,1,0,1,2000
Denys Sylantiev,Ukraine,0,1,0,1,2000
Scott Tucker,United States,0,1,0,1,2000
Zé Marco,Brazil,0,1,0,1,2000
Yevgeniya Artamonova-Estes,Russian Federation,0,1,0,1,2000
Yelena Batukhtina-Tyurina,Russian Federation,0,1,0,1,2000
Lena Godina,Russian Federation,0,1,0,1,2000
Tatyana Gracheva,Russian Federation,0,1,0,1,2000
Nataliya Morozova,Russian Federation,0,1,0,1,2000
Lyubov Sokolova-Shashkova,Russian Federation,0,1,0,1,2000
Yelizaveta Tishchenko,Russian Federation,0,1,0,1,2000
Valery Goryushev,Russian Federation,0,1,0,1,2000
Vadim Khamuttskikh,Russian Federation,0,1,0,1,2000
Aleksey Kazakov,Russian Federation,0,1,0,1,2000
Ruslan Olikhver,Russian Federation,0,1,0,1,2000
Igor Shulepov,Russian Federation,0,1,0,1,2000
Sergey Tetyukhin,Russian Federation,0,1,0,1,2000
Konstantin Ushakov,Russian Federation,0,1,0,1,2000
Dmitry Dugin,Russian Federation,0,1,0,1,2000
Sergey Garbuzov,Russian Federation,0,1,0,1,2000
Dmitry Gorshkov,Russian Federation,0,1,0,1,2000
Aleksandr Yeryshov,Russian Federation,0,1,0,1,2000
Nikolay Kozlov,Russian Federation,0,1,0,1,2000
Nikolay Maksimov,Kazakhstan,0,1,0,1,2000
Dmitry Stratan,Russian Federation,0,1,0,1,2000
Marc Huster,Germany,0,1,0,1,2000
Ronny Weller,East Germany,0,1,0,1,2000
Viktor Mitrou,Greece,0,1,0,1,2000
Leonidas Sabanis,Greece,0,1,0,1,2000
Serafim Barzakov,Bulgaria,0,1,0,1,2000
Juan Luis Marén,Cuba,0,1,0,1,2000
Lázaro Rivas,Cuba,0,1,0,1,2000
Islam Bayramukov,Kazakhstan,0,1,0,1,2000
Aleksandr Karelin,Russian Federation,0,1,0,1,2000
JJ Isler,United States,0,1,0,1,2000
Margriet Matthijsse,Netherlands,0,1,0,1,2000
Luca Devoti,Italy,0,1,0,1,2000
Carlos Espínola,Argentina,0,1,0,1,2000
Paul Foerster,United States,0,1,0,1,2000
John Forbes,Australia,0,1,0,1,2000
Robert Scheidt,Brazil,0,1,0,1,2000
Jochen Schümann,East Germany,0,1,0,1,2000
Ian Walker,Great Britain,0,1,0,1,2000
Mirela Maniani-Tzelili,Albania,0,1,0,1,2000
André da Silva,Brazil,0,1,0,1,2000
Claudinei da Silva,Brazil,0,1,0,1,2000
Édson Ribeiro,Brazil,0,1,0,1,2000
Yoel García,Cuba,0,1,0,1,2000
Javier Sotomayor,Cuba,0,1,0,1,2000
Steve Backley,Great Britain,0,1,0,1,2000
Darren Campbell,Great Britain,0,1,0,1,2000
Lars Riedel,Germany,0,1,0,1,2000
Anastasia Kelesidou,Greece,0,1,0,1,2000
Aikaterini Thanou,Greece,0,1,0,1,2000
Sonia O'Sullivan,Ireland,0,1,0,1,2000
Fiona May,Great Britain,0,1,0,1,2000
Merlene Frazer,Jamaica,0,1,0,1,2000
Sandie Richards,Jamaica,0,1,0,1,2000
Catherine Pomales-Scott,Jamaica,0,1,0,1,2000
Michael McDonald,Jamaica,0,1,0,1,2000
Paul Tergat,Kenya,0,1,0,1,2000
Eric Wainaina,Kenya,0,1,0,1,2000
Hadi Soua'an Al-Somaily,Kingdom of Saudi Arabia,0,1,0,1,2000
Aigars Fadejevs,Latvia,0,1,0,1,2000
Hicham El Guerrouj,Morocco,0,1,0,1,2000
Violeta Beclea-Szekely,Romania,0,1,0,1,2000
Lidia Șimon,Romania,0,1,0,1,2000
Susanthika Jayasinghe,Sri Lanka,0,1,0,1,2000
Alvin Harrison,United States,0,1,0,1,2000
Lawrence Johnson,United States,0,1,0,1,2000
Hendrawan,Indonesia,0,1,0,1,2000
Thierry Gadou,France,0,1,0,1,2000
Cyril Julian,France,0,1,0,1,2000
Crawford Palmer,France,0,1,0,1,2000
Antoine Rigaudeau,France,0,1,0,1,2000
Stéphane Risacher,France,0,1,0,1,2000
Laurent Sciarra,France,0,1,0,1,2000
Moustapha Sonko,France,0,1,0,1,2000
Frédéric Weis,France,0,1,0,1,2000
Kristi Harrower,Australia,0,1,0,1,2000
Jo Hill,Australia,0,1,0,1,2000
Lauren Jackson,Australia,0,1,0,1,2000
Annie La Fleur,Australia,0,1,0,1,2000
Nataliya Burdeina,Ukraine,0,1,0,1,2000
Kateryna Serdiuk,Ukraine,0,1,0,1,2000
Ali Saïdi-Sief,Algeria,0,1,0,1,2000
Tatiana Grigorieva,Australia,0,1,0,1,2000
Jai Taurima,Australia,0,1,0,1,2000
Steffi Graf,Austria,0,1,0,1,2000
Vicente Lenílson,Brazil,0,1,0,1,2000
Cláudio Sousa,Brazil,0,1,0,1,2000
Roman Šebrle,Czech Republic,0,1,0,1,2000
Wilson Kipketer,Denmark,0,1,0,1,2000
Nicola Vizzoni,Italy,0,1,0,1,2000
Sanjay Ayre,Jamaica,0,1,0,1,2000
Michael Blackwood,Jamaica,0,1,0,1,2000
Michelle Burgher,Jamaica,0,1,0,1,2000
Veronica Campbell-Brown,Jamaica,0,1,0,1,2000
Charmaine Howell,Jamaica,0,1,0,1,2000
Danny McFarlane,Jamaica,0,1,0,1,2000
Chris Williams,Jamaica,0,1,0,1,2000
Wilson Boit Kipketer,Kenya,0,1,0,1,2000
Noé Hernández,Mexico,0,1,0,1,2000
Glory Alozie,Nigeria,0,1,0,1,2000
Kjersti Tysse-Plätzer,Norway,0,1,0,1,2000
Hestrie Storbeck-Cloete,South Africa,0,1,0,1,2000
Olga Kuzenkova,Russian Federation,0,1,0,1,2000
Tatyana Lebedeva,Russian Federation,0,1,0,1,2000
Larisa Peleshenko,Russian Federation,0,1,0,1,2000
Yelena Prokhorova,Russian Federation,0,1,0,1,2000
Beatrix Balogh,Hungary,0,1,0,1,2000
Rita Deli,Hungary,0,1,0,1,2000
Ágnes Farkas,Hungary,0,1,0,1,2000
Anita Kulcsár,Hungary,0,1,0,1,2000
Dóra Lőwy,Hungary,0,1,0,1,2000
Katalin Pálinger,Hungary,0,1,0,1,2000
Krisztina Pigniczki-Sepsi,Hungary,0,1,0,1,2000
Bojana Radulovics,Hungary,0,1,0,1,2000
Judit Simics-Zsemberi,Hungary,0,1,0,1,2000
Christian Ryan,Australia,0,1,0,1,2000
Rachael Taylor,Australia,0,1,0,1,2000
Stuart Welch,Australia,0,1,0,1,2000
Adam Nelson,United States,0,1,0,1,2000
Terrence Trammell,United States,0,1,0,1,2000
Huang Nanyan,People's Republic of China,0,1,0,1,2000
Yang Wei,People's Republic of China,0,1,0,1,2000
Lee Dong-Su,Republic of Korea,0,1,0,1,2000
Yovany Aragón,Cuba,0,1,0,1,2000
Danel Castro,Cuba,0,1,0,1,2000
Yobal Dueñas,Cuba,0,1,0,1,2000
Yasser Gómez,Cuba,0,1,0,1,2000
José Ibar,Cuba,0,1,0,1,2000
Óscar Macías,Cuba,0,1,0,1,2000
Javier Méndez,Cuba,0,1,0,1,2000
Rolando Meriño,Cuba,0,1,0,1,2000
Emily deRiel,United States,0,1,0,1,2000
Darren Balmforth,Australia,0,1,0,1,2000
Dan Burke,Australia,0,1,0,1,2000
Alastair Gordon,Australia,0,1,0,1,2000
Robert Richards,Australia,0,1,0,1,2000
Yumiko Fujii,Japan,0,1,0,1,2000
Taeko Ishikawa,Japan,0,1,0,1,2000
Kazue Ito,Japan,0,1,0,1,2000
Yoshimi Kobayashi,Japan,0,1,0,1,2000
Shiori Koseki,Japan,0,1,0,1,2000
Mariko Masubuchi,Japan,0,1,0,1,2000
Emi Naito,Japan,0,1,0,1,2000
Hiroko Tamoto,Japan,0,1,0,1,2000
Reika Utsugi,Japan,0,1,0,1,2000
Miyo Yamada,Japan,0,1,0,1,2000
Ariel Pestano,Cuba,0,1,0,1,2000
Gabriel Pierre,Cuba,0,1,0,1,2000
Maels Rodríguez,Cuba,0,1,0,1,2000
Lázaro Valle,Cuba,0,1,0,1,2000
Norge Luis Vera,Cuba,0,1,0,1,2000
Jim Bilba,France,0,1,0,1,2000
Yann Bonato,France,0,1,0,1,2000
Makan Dioumassi,France,0,1,0,1,2000
Laurent Foirest,France,0,1,0,1,2000
Rudi Kraj,Czech Republic,0,1,0,1,2000
Mukhtarkhan Dildabekov,Kazakhstan,0,1,0,1,2000
Gaydarbek Gaydarbekov,Russian Federation,0,1,0,1,2000
Sultan Ibragimov,Russian Federation,0,1,0,1,2000
Serhiy Dotsenko,Ukraine,0,1,0,1,2000
Andriy Kotelnyk,Ukraine,0,1,0,1,2000
Rocky Juárez,United States,0,1,0,1,2000
"Ricardo Williams, Jr.",United States,0,1,0,1,2000
Ledys Balceiro,Cuba,0,1,0,1,2000
Leobaldo Pereira,Cuba,0,1,0,1,2000
Ibrahim Rojas,Cuba,0,1,0,1,2000
Brigitte Guibal,France,0,1,0,1,2000
Björn Bach,Germany,0,1,0,1,2000
Jan Schäfer,Germany,0,1,0,1,2000
Stefan Ulm,Germany,0,1,0,1,2000
Erzsébet Viski,Hungary,0,1,0,1,2000
Daniel Jędraszko,Poland,0,1,0,1,2000
Maksim Opalev,Russian Federation,0,1,0,1,2000
Matthew Gilmore,Belgium,0,1,0,1,2000
Filip Meirhaeghe,Belgium,0,1,0,1,2000
Chris Hoy,Great Britain,0,1,0,1,2000
Craig MacLean,Great Britain,0,1,0,1,2000
Hanka Kupfernagel,Germany,0,1,0,1,2000
Stefan Nimke,Germany,0,1,0,1,2000
Barbara Blatter,Switzerland,0,1,0,1,2000
Serhiy Cherniavskyi,Ukraine,0,1,0,1,2000
Mari Holden,United States,0,1,0,1,2000
Emilie Heymans,Canada,0,1,0,1,2000
Aleksandr Dobroskok,Russian Federation,0,1,0,1,2000
Jeanette Brakewell,Great Britain,0,1,0,1,2000
Pippa Funnell,Great Britain,0,1,0,1,2000
Leslie Law,Great Britain,0,1,0,1,2000
Arjen Teeuwissen,Netherlands,0,1,0,1,2000
Coby van Baalen,Netherlands,0,1,0,1,2000
Albert Voorn,Netherlands,0,1,0,1,2000
Julien Pillet,France,0,1,0,1,2000
Ralf Bißdorf,Germany,0,1,0,1,2000
Sylwia Gruchała,Poland,0,1,0,1,2000
Magdalena Mroczkiewicz,Poland,0,1,0,1,2000
Sophie Lamon,Switzerland,0,1,0,1,2000
Diana Romagnoli,Switzerland,0,1,0,1,2000
Lorrie Fair,United States,0,1,0,1,2000
Siri Mullinix,United States,0,1,0,1,2000
Christie Pearce-Rampone,United States,0,1,0,1,2000
Nikki Serlenga,United States,0,1,0,1,2000
Kate Sobrero-Markgraf,United States,0,1,0,1,2000
David Albelda,Spain,0,1,0,1,2000
Iván Amaya,Spain,0,1,0,1,2000
Miguel Ángel Angulo,Spain,0,1,0,1,2000
Daniel Aranzubia,Spain,0,1,0,1,2000
Capdevila,Spain,0,1,0,1,2000
Jordi Ferrón,Spain,0,1,0,1,2000
Gabri,Spain,0,1,0,1,2000
Ismael Ruiz,Spain,0,1,0,1,2000
José Mari,Spain,0,1,0,1,2000
Lacruz,Spain,0,1,0,1,2000
Albert Luque,Spain,0,1,0,1,2000
Marchena,Spain,0,1,0,1,2000
Puyol,Spain,0,1,0,1,2000
Tamudo,Spain,0,1,0,1,2000
Unai,Spain,0,1,0,1,2000
Toni,Spain,0,1,0,1,2000
Xavi,Spain,0,1,0,1,2000
Ji Wallace,Australia,0,1,0,1,2000
Tatsiana Ananka,Belarus,0,1,0,1,2000
Tatsiana Belan,Belarus,0,1,0,1,2000
Hanna Hlazkova,Belarus,0,1,0,1,2000
Iryna Ilienkava,Belarus,0,1,0,1,2000
Maryia Lazuk,Belarus,0,1,0,1,2000
Volha Puzhevich,Belarus,0,1,0,1,2000
Yuliya Raskina,Belarus,0,1,0,1,2000
Ling Jie,People's Republic of China,0,1,0,1,2000
Benjamin Varonian,France,0,1,0,1,2000
Dimosthenis Tambakos,Greece,0,1,0,1,2000
Martin Boquist,Sweden,0,1,0,1,2000
Mathias Franzén,Sweden,0,1,0,1,2000
Peter Gentzel,Sweden,0,1,0,1,2000
Ljubomir Vranjes,Sweden,0,1,0,1,2000
Anastasiya Kolesnikova,Russian Federation,0,1,0,1,2000
Anna Chepeleva,Russian Federation,0,1,0,1,2000
Valeriy Honcharov,Ukraine,0,1,0,1,2000
Ruslan Mezentsev,Ukraine,0,1,0,1,2000
Valeriy Pereshkura,Ukraine,0,1,0,1,2000
Roman Zozulia,Ukraine,0,1,0,1,2000
Oksana Tsyhulova,Ukraine,0,1,0,1,2000
Han Hyeong-Bae,Republic of Korea,0,1,0,1,2000
Hwang Jong-Hyeon,Republic of Korea,0,1,0,1,2000
Jeon Jong-Gwon,Republic of Korea,0,1,0,1,2000
Ji Seong-Hwan,Republic of Korea,0,1,0,1,2000
Kim Cheong-Hwan,Republic of Korea,0,1,0,1,2000
Kim Jeong-Cheol,Republic of Korea,0,1,0,1,2000
Kim Gyeong-Seok,Republic of Korea,0,1,0,1,2000
Im Jong-Cheon,Republic of Korea,0,1,0,1,2000
Im Jeong-U,Republic of Korea,0,1,0,1,2000
Seo Jong-Ho,Republic of Korea,0,1,0,1,2000
Yeo Un-Gon,Republic of Korea,0,1,0,1,2000
Mariela Antoniska,Argentina,0,1,0,1,2000
Inés Arrondo,Argentina,0,1,0,1,2000
Lucha Aymar,Argentina,0,1,0,1,2000
María Paz Ferrari,Argentina,0,1,0,1,2000
Sole García,Argentina,0,1,0,1,2000
Maripi Hernández,Argentina,0,1,0,1,2000
Laura Maiztegui,Argentina,0,1,0,1,2000
Mechi Margalot,Argentina,0,1,0,1,2000
Paola Vukojicic,Argentina,0,1,0,1,2000
Tiago Camilo,Brazil,0,1,0,1,2000
Carlos Honorato,Brazil,0,1,0,1,2000
Li Shufang,People's Republic of China,0,1,0,1,2000
Daima Beltrán,Cuba,0,1,0,1,2000
Céline Lebrun,France,0,1,0,1,2000
Shinichi Shinohara,Japan,0,1,0,1,2000
Jeong Bu-Gyeong,Republic of Korea,0,1,0,1,2000
Lyubov Bruletova,Russian Federation,0,1,0,1,2000
Gábor Balogh,Hungary,0,1,0,1,2000
Katherine Grainger,Great Britain,0,1,0,1,2000
Claudia Blasberg,Germany,0,1,0,1,2000
Valerie Viehoff,Germany,0,1,0,1,2000
Elia Luini,Italy,0,1,0,1,2000
Carin ter Beek,Netherlands,0,1,0,1,2000
Dirk Lippits,Netherlands,0,1,0,1,2000
Martijntje Quik,Netherlands,0,1,0,1,2000
Jochem Verberne,Netherlands,0,1,0,1,2000
Sebastian Bea,United States,0,1,0,1,2000
Darren Bundock,Australia,0,1,0,1,2000
Ian Barker,Great Britain,0,1,0,1,2000
Mark Covell,Great Britain,0,1,0,1,2000
Simon Hiscocks,Great Britain,0,1,0,1,2000
Amelie Lux,Germany,0,1,0,1,2000
Gunnar Bahr,Germany,0,1,0,1,2000
Ingo Borkowski,Germany,0,1,0,1,2000
Bob Merrick,United States,0,1,0,1,2000
Pease Glaser,United States,0,1,0,1,2000
Delphine Racinet-Réau,France,0,1,0,1,2000
Gang Cho-Hyeon,Republic of Korea,0,1,0,1,2000
Tatyana Goldobina,Russian Federation,0,1,0,1,2000
Dyana Calub,Australia,0,1,0,1,2000
Elka Graham,Australia,0,1,0,1,2000
Regan Harrison,Australia,0,1,0,1,2000
Kirsten Thomson,Australia,0,1,0,1,2000
Jacinta Van Lint,Australia,0,1,0,1,2000
Josh Watson,Australia,0,1,0,1,2000
Tarnee White,Australia,0,1,0,1,2000
Roxana Maracineanu,France,0,1,0,1,2000
Yasuko Tajima,Japan,0,1,0,1,2000
Chantal Groot,Netherlands,0,1,0,1,2000
Thamar Henneken,Netherlands,0,1,0,1,2000
Manon van Rooijen,Netherlands,0,1,0,1,2000
Terence Parkin,South Africa,0,1,0,1,2000
Chad Carvin,United States,0,1,0,1,2000
Nate Dusing,United States,0,1,0,1,2000
Scott Goldblatt,United States,0,1,0,1,2000
Aaron Peirsol,United States,0,1,0,1,2000
Jamie Rauch,United States,0,1,0,1,2000
Erik Vendt,United States,0,1,0,1,2000
Kristy Kowal,United States,0,1,0,1,2000
Yoko Isoda,Japan,0,1,0,1,2000
Juri Tatsumi,Japan,0,1,0,1,2000
Yuko Yoneda,Japan,0,1,0,1,2000
Yoko Yoneda,Japan,0,1,0,1,2000
Sun Jin,People's Republic of China,0,1,0,1,2000
Yang Ying,People's Republic of China,0,1,0,1,2000
Daniel Trenton,Australia,0,1,0,1,2000
Urbia Meléndez,Cuba,0,1,0,1,2000
Gabriel Esparza,Spain,0,1,0,1,2000
Faissal Ebnoutalib,Germany,0,1,0,1,2000
Sin Jun-Sik,Republic of Korea,0,1,0,1,2000
Trude Gundersen,Norway,0,1,0,1,2000
Nataliya Ivanova,Russian Federation,0,1,0,1,2000
Trần Hiếu Ngân,Vietnam,0,1,0,1,2000
Tommy Haas,Germany,0,1,0,1,2000
Kristie Boogert,Netherlands,0,1,0,1,2000
Miriam Oremans,Netherlands,0,1,0,1,2000
Yelena Dementyeva,Russian Federation,0,1,0,1,2000
Stephan Vuckovic,Germany,0,1,0,1,2000
Ricardo,Brazil,0,1,0,1,2000
Shelda,Brazil,0,1,0,1,2000
Adriana Behar,Brazil,0,1,0,1,2000
Michellie Jones,Australia,0,1,0,1,2000
Anastasiya Belikova,Russian Federation,0,1,0,1,2000
Yekaterina Gamova,Russian Federation,0,1,0,1,2000
Olga Potashova,Russian Federation,0,1,0,1,2000
Inessa Sargsyan,Russian Federation,0,1,0,1,2000
Yelena Vasilevskaya,Russian Federation,0,1,0,1,2000
Alan Tsagaev,Bulgaria,0,1,0,1,2000
Wu Wenxiong,People's Republic of China,0,1,0,1,2000
Erzsébet Márkus-Peresztegi,Hungary,0,1,0,1,2000
Raema Lisa Rumbewas,Indonesia,0,1,0,1,2000
Szymon Kołecki,Poland,0,1,0,1,2000
Agata Wróbel,Poland,0,1,0,1,2000
Ri Song-Hui,Democratic People's Republic of Korea,0,1,0,1,2000
Valentina Popova,Russian Federation,0,1,0,1,2000
Li Feng-Ying,Chinese Taipei,0,1,0,1,2000
Aleksandr Gerasimov,Russian Federation,0,1,0,1,2000
Roman Yakovlev,Russian Federation,0,1,0,1,2000
Aleksey Kuleshov,Russian Federation,0,1,0,1,2000
Yevgeny Mitkov,Russian Federation,0,1,0,1,2000
Ilya Savelyev,Russian Federation,0,1,0,1,2000
Roman Balashov,Russian Federation,0,1,0,1,2000
Yury Yatsev,Russian Federation,0,1,0,1,2000
Revaz Chomakhidze,Russian Federation,0,1,0,1,2000
Marat Zakirov,Russian Federation,0,1,0,1,2000
Irek Zinnurov,Russian Federation,0,1,0,1,2000
Robin Beauregard,United States,0,1,0,1,2000
Ellen Estes,United States,0,1,0,1,2000
Courtney Johnson,United States,0,1,0,1,2000
Ericka Lorenz,United States,0,1,0,1,2000
Heather Moody,United States,0,1,0,1,2000
Mo O'Toole,United States,0,1,0,1,2000
Bernice Orwig,United States,0,1,0,1,2000
Nicolle Payne,United States,0,1,0,1,2000
Heather Petri,United States,0,1,0,1,2000
Kathy Sheehy,United States,0,1,0,1,2000
Coralie Simmons,United States,0,1,0,1,2000
Julie Swail-Ertel,United States,0,1,0,1,2000
Brenda Villa,United States,0,1,0,1,2000
Georgi Markov,Bulgaria,0,1,0,1,2000
Ruth Ogbeifo,Nigeria,0,1,0,1,2000
Yoel Romero,Cuba,0,1,0,1,2000
Sándor István Bárdosi,Hungary,0,1,0,1,2000
Arsen Gitinov,Kyrgyzstan,0,1,0,1,2000
Yevhen Buslovych,Ukraine,0,1,0,1,2000
David Saldadze,Ukraine,0,1,0,1,2000
Katsuhiko Nagata,Japan,0,1,0,1,2000
Kim In-Seop,Republic of Korea,0,1,0,1,2000
Mun Ui-Je,Republic of Korea,0,1,0,1,2000
Sammie Henson,United States,0,1,0,1,2000
Matt Lindland,United States,0,1,0,1,2000
Artur Taymazov,Uzbekistan,0,1,0,1,2000
Cédric Séguin,France,0,1,0,1,2000
Michael Phelps,United States,6,0,2,8,2004
Petria Thomas,Australia,3,1,0,4,2004
Aaron Peirsol,United States,3,0,0,3,2004
Jodie Henry,Australia,3,0,0,3,2004
Cătălina Ponor,Romania,3,0,0,3,2004
Natalie Coughlin,United States,2,2,1,5,2004
Ian Thorpe,Australia,2,1,1,4,2004
Veronica Campbell-Brown,Jamaica,2,0,1,3,2004
Kosuke Kitajima,Japan,2,0,1,3,2004
Viorica Susanu,Romania,2,0,0,2,2004
Guo Jingjing,People's Republic of China,2,0,0,2,2004
Kelly Holmes,Great Britain,2,0,0,2,2004
Hicham El Guerrouj,Morocco,2,0,0,2,2004
Natasa Dusev-Janics,Hungary,2,0,0,2,2004
Graeme Brown,Australia,2,0,0,2,2004
Georgeta Damian-Andrunache,Romania,2,0,0,2,2004
Yana Klochkova,Ukraine,2,0,0,2,2004
Nicolás Massú,Chile,2,0,0,2,2004
Park Seong-Hyeon,Republic of Korea,2,0,0,2,2004
Alice Mills,Australia,2,0,0,2,2004
Jeremy Wariner,United States,2,0,0,2,2004
Ryan Bayley,Australia,2,0,0,2,2004
Monica Roșu,Romania,2,0,0,2,2004
Zhang Yining,People's Republic of China,2,0,0,2,2004
Anastasiya Davydova,Russian Federation,2,0,0,2,2004
Anastasiya Yermakova,Russian Federation,2,0,0,2,2004
Pieter van den Hoogenband,Netherlands,1,2,0,3,2004
Amanda Beard,United States,1,2,0,3,2004
Paul Hamm,United States,1,2,0,3,2004
Grant Hackett,Australia,1,2,0,3,2004
Otylia Jędrzejczak,Poland,1,2,0,3,2004
Carly Patterson,United States,1,2,0,3,2004
Inge de Bruijn,Netherlands,1,1,2,4,2004
Bradley Wiggins,Great Britain,1,1,1,3,2004
Leisel Jones,Australia,1,1,1,3,2004
Roland Schoeman,South Africa,1,1,1,3,2004
Ian Crocker,United States,1,1,1,3,2004
Kaitlin Sandeno,United States,1,1,1,3,2004
Kirsty Coventry,Zimbabwe,1,1,1,3,2004
Brendan Hansen,United States,1,1,1,3,2004
Laure Manaudou,France,1,1,1,3,2004
Justin Gatlin,United States,1,1,1,3,2004
Birgit Fischer-Schmidt,East Germany,1,1,0,2,2004
Andreas Dittmer,Germany,1,1,0,2,2004
Brad McGee,Australia,1,1,0,2,2004
Gao Ling,People's Republic of China,1,1,0,2,2004
Katalin Kovács,Hungary,1,1,0,2,2004
Leslie Law,Great Britain,1,1,0,2,2004
Ulla Salzgeber,Germany,1,1,0,2,2004
Salvatore Sanzo,Italy,1,1,0,2,2004
Lyubov Galkina,Russian Federation,1,1,0,2,2004
Mikhail Nestruyev,Russian Federation,1,1,0,2,2004
Lindsay Benko,United States,1,1,0,2,2004
Lee Seong-Jin,Republic of Korea,1,1,0,2,2004
Rachel Komisarz,United States,1,1,0,2,2004
Brooke Hanson,Australia,1,1,0,2,2004
Ryan Lochte,United States,1,1,0,2,2004
Carolin Leonhardt,Germany,1,1,0,2,2004
David Cal,Spain,1,1,0,2,2004
Shawn Crawford,United States,1,1,0,2,2004
Otis Harris,United States,1,1,0,2,2004
Kenenisa Bekele,Ethiopia,1,1,0,2,2004
Aldo Montano,Italy,1,1,0,2,2004
Chris Kappler,United States,1,1,0,2,2004
Dana Șofronie,Romania,1,1,0,2,2004
Hiroyuki Tomita,Japan,1,1,0,2,2004
Wu Minxia,People's Republic of China,1,1,0,2,2004
Lao Lishi,People's Republic of China,1,1,0,2,2004
Leontien Zijlaard-van Moorsel,Netherlands,1,0,1,2,2004
Mariya Grozdeva,Bulgaria,1,0,1,2,2004
Tian Liang,People's Republic of China,1,0,1,2,2004
"Gary Hall, Jr.",United States,1,0,1,2,2004
Chantelle Michell-Newbery,Australia,1,0,1,2,2004
Tatyana Lebedeva,Russian Federation,1,0,1,2,2004
Eirik Verås Larsen,Norway,1,0,1,2,2004
Stefan Nimke,Germany,1,0,1,2,2004
Olga Slyusareva,Russian Federation,1,0,1,2,2004
Klete Keller,United States,1,0,1,2,2004
Jason Lezak,United States,1,0,1,2,2004
Neil Walker,United States,1,0,1,2,2004
Libby Lenton-Trickett,Australia,1,0,1,2,2004
Adam Van Koeverden,Canada,1,0,1,2,2004
Derrick Brew,United States,1,0,1,2,2004
Andrea Cassarà,Italy,1,0,1,2,2004
Anna Meares,Australia,1,0,1,2,2004
René Wolff,Germany,1,0,1,2,2004
Alexandra Eremia,Romania,1,0,1,2,2004
Takehiro Kashima,Japan,1,0,1,2,2004
Isao Yoneda,Japan,1,0,1,2,2004
Fernando González,Chile,1,0,1,2,2004
Ha Tae-Gwon,Republic of Korea,1,0,0,1,2004
Kim Dong-Mun,Republic of Korea,1,0,0,1,2004
Laura Berg,United States,1,0,0,1,2004
Lisa Fernandez,United States,1,0,0,1,2004
Lori Harrigan,United States,1,0,0,1,2004
Leah O'Brien-Amico,United States,1,0,0,1,2004
Pedro Luis Lazo,Cuba,1,0,0,1,2004
Eduardo Paret,Cuba,1,0,0,1,2004
Antonio Scull,Cuba,1,0,0,1,2004
Jang Yong-Ho,Republic of Korea,1,0,0,1,2004
Lisa Leslie,United States,1,0,0,1,2004
Dawn Staley,United States,1,0,0,1,2004
Sheryl Swoopes,United States,1,0,0,1,2004
Fabricio Oberto,Argentina,1,0,0,1,2004
Rubén Wolkowyski,Argentina,1,0,0,1,2004
Zoltán Kammerer,Hungary,1,0,0,1,2004
Elena Kaliská,Slovakia,1,0,0,1,2004
Henrik Nilsson,Sweden,1,0,0,1,2004
Markus Oscarsson,Sweden,1,0,0,1,2004
Anky van Grunsven,Netherlands,1,0,0,1,2004
Rodrigo Pessoa,Brazil,1,0,0,1,2004
Martin Schaudt,Germany,1,0,0,1,2004
Jean Teulère,France,1,0,0,1,2004
Gunn Rita Dahle-Flesjå,Norway,1,0,0,1,2004
Sarah Ulmer,New Zealand,1,0,0,1,2004
Jens Fiedler,Germany,1,0,0,1,2004
Vyacheslav Yekimov,Russian Federation,1,0,0,1,2004
Stuart O'Grady,Australia,1,0,0,1,2004
Nadine Ernsting-Krienke,Germany,1,0,0,1,2004
Natascha Keller,Germany,1,0,0,1,2004
Heike Lätzsch,Germany,1,0,0,1,2004
Oksana Yermakova,Estonia,1,0,0,1,2004
Tímea Nagy,Hungary,1,0,0,1,2004
Valentina Vezzali,Italy,1,0,0,1,2004
Karina Aznavuryan,Russian Federation,1,0,0,1,2004
Damien Touya,France,1,0,0,1,2004
Roberto Ayala,Argentina,1,0,0,1,2004
Brandi Chastain,United States,1,0,0,1,2004
Joy Fawcett,United States,1,0,0,1,2004
Julie Foudy,United States,1,0,0,1,2004
Mia Hamm,United States,1,0,0,1,2004
Kristine Lilly,United States,1,0,0,1,2004
Cindy Parlow,United States,1,0,0,1,2004
Briana Scurry,United States,1,0,0,1,2004
Naoya Tsukahara,Japan,1,0,0,1,2004
Slavko Goluža,Croatia,1,0,0,1,2004
Venio Losert,Croatia,1,0,0,1,2004
Valter Matošević,Croatia,1,0,0,1,2004
Noriko Anno,Japan,1,0,0,1,2004
Ryoko Tamura-Tani,Japan,1,0,0,1,2004
Tadahiro Nomura,Japan,1,0,0,1,2004
Drew Ginn,Australia,1,0,0,1,2004
James Tomkins,Australia,1,0,0,1,2004
Eskild Ebbesen,Denmark,1,0,0,1,2004
Sébastien Vieilledent,France,1,0,0,1,2004
James Cracknell,Great Britain,1,0,0,1,2004
Matthew Pinsent,Great Britain,1,0,0,1,2004
Kathrin Boron,Germany,1,0,0,1,2004
Meike Evers,Germany,1,0,0,1,2004
Manuela Lutze,Germany,1,0,0,1,2004
Katrin Rutschow-Stomporowski,Germany,1,0,0,1,2004
Olaf Tufte,Norway,1,0,0,1,2004
Robert Sycz,Poland,1,0,0,1,2004
Constanța Pipotă-Burcică,Romania,1,0,0,1,2004
Liliana Gafencu,Romania,1,0,0,1,2004
Elena Georgescu,Romania,1,0,0,1,2004
Doina Ignat,Romania,1,0,0,1,2004
Elisabeta Oleniuc-Lipă,Romania,1,0,0,1,2004
Angela Tamaș-Alupei,Romania,1,0,0,1,2004
Igor Kravtsov,Russian Federation,1,0,0,1,2004
Nikolay Spinev,Russian Federation,1,0,0,1,2004
Wang Yifu,People's Republic of China,1,0,0,1,2004
Ralf Schumann,East Germany,1,0,0,1,2004
Diána Igaly,Hungary,1,0,0,1,2004
Andrea Benelli,Italy,1,0,0,1,2004
Kim Rhode,United States,1,0,0,1,2004
Sarah Ryan,Australia,1,0,0,1,2004
Nikolaos Siranidis,Greece,1,0,0,1,2004
Ryk Neethling,South Africa,1,0,0,1,2004
Yelena Azarova,Russian Federation,1,0,0,1,2004
Olga Brusnikina,Russian Federation,1,0,0,1,2004
Mariya Kiselyova,Russian Federation,1,0,0,1,2004
Olga Novokshchenova,Russian Federation,1,0,0,1,2004
Emanuel,Brazil,1,0,0,1,2004
Nalbert,Brazil,1,0,0,1,2004
Giovane,Brazil,1,0,0,1,2004
Maurício,Brazil,1,0,0,1,2004
Wang Lina,People's Republic of China,1,0,0,1,2004
Tibor Benedek,Hungary,1,0,0,1,2004
Rajmund Fodor,Hungary,1,0,0,1,2004
Tamás Kásás,Hungary,1,0,0,1,2004
Halil Mutlu,Turkey,1,0,0,1,2004
Buvaysar Saytiyev,Russian Federation,1,0,0,1,2004
Elbrus Tedieiev,Ukraine,1,0,0,1,2004
Shirley Robertson,Great Britain,1,0,0,1,2004
Aimilia Tsoulfa,Greece,1,0,0,1,2004
Ben Ainslie,Great Britain,1,0,0,1,2004
Kevin Burnham,United States,1,0,0,1,2004
Marcelo Ferreira,Brazil,1,0,0,1,2004
Paul Foerster,United States,1,0,0,1,2004
Gal Fridman,Israel,1,0,0,1,2004
Torben Grael,Brazil,1,0,0,1,2004
Roman Hagara,Austria,1,0,0,1,2004
Robert Scheidt,Brazil,1,0,0,1,2004
Yumileidi Cumbá,Cuba,1,0,0,1,2004
Darren Campbell,Great Britain,1,0,0,1,2004
Stefano Baldini,Italy,1,0,0,1,2004
Beverly McDonald,Jamaica,1,0,0,1,2004
Virgilijus Alekna,Lithuania,1,0,0,1,2004
Robert Korzeniowski,Poland,1,0,0,1,2004
Nataliya Sadova,Russian Federation,1,0,0,1,2004
Zhang Jun,People's Republic of China,1,0,0,1,2004
Taufik Hidayat,Indonesia,1,0,0,1,2004
Yun Mi-Jin,Republic of Korea,1,0,0,1,2004
Tonique Williams-Darling,The Bahamas,1,0,0,1,2004
Françoise Mbango,Cameroon,1,0,0,1,2004
Osleidys Menéndez,Cuba,1,0,0,1,2004
Roman Šebrle,Czech Republic,1,0,0,1,2004
Félix Sánchez,Dominican Republic,1,0,0,1,2004
Marlon Devonish,Great Britain,1,0,0,1,2004
Jason Gardener,Great Britain,1,0,0,1,2004
Ivano Brugnetti,Italy,1,0,0,1,2004
Tayna Lawrence,Jamaica,1,0,0,1,2004
Koji Murofushi,Japan,1,0,0,1,2004
Yury Borzakovsky,Russian Federation,1,0,0,1,2004
Yelena Isinbayeva,Russian Federation,1,0,0,1,2004
Olga Kuzenkova,Russian Federation,1,0,0,1,2004
Karen Brødsgaard,Denmark,1,0,0,1,2004
Katrine Fruelund,Denmark,1,0,0,1,2004
Lotte Kiærskou,Denmark,1,0,0,1,2004
Karin Mortensen,Denmark,1,0,0,1,2004
Rikke Petersen Schmidt,Denmark,1,0,0,1,2004
Mette Vestergaard,Denmark,1,0,0,1,2004
Stefan Holm,Sweden,1,0,0,1,2004
Christian Olsson,Sweden,1,0,0,1,2004
Monique Hennagan,United States,1,0,0,1,2004
Adam Nelson,United States,1,0,0,1,2004
Dwight Phillips,United States,1,0,0,1,2004
Yang Wei,People's Republic of China,1,0,0,1,2004
Ariel Pestano,Cuba,1,0,0,1,2004
Norge Luis Vera,Cuba,1,0,0,1,2004
Mario Kindelán,Cuba,1,0,0,1,2004
Guillermo Rigondeaux,Cuba,1,0,0,1,2004
Gaydarbek Gaydarbekov,Russian Federation,1,0,0,1,2004
Yolanda Griffith,United States,1,0,0,1,2004
Katie Smith,United States,1,0,0,1,2004
Tony Estanguet,France,1,0,0,1,2004
Christian Gille,Germany,1,0,0,1,2004
Ronny Rauhe,Germany,1,0,0,1,2004
Katrin Wagner-Augustin,Germany,1,0,0,1,2004
Tim Wieskötter,Germany,1,0,0,1,2004
Gábor Horváth,Hungary,1,0,0,1,2004
Botond Storcz,Hungary,1,0,0,1,2004
Ákos Vereckei,Hungary,1,0,0,1,2004
Pavol Hochschorner,Slovakia,1,0,0,1,2004
Peter Hochschorner,Slovakia,1,0,0,1,2004
Brett Lancaster,Australia,1,0,0,1,2004
Luke Roberts,Australia,1,0,0,1,2004
Lori-Ann Muenzer,Canada,1,0,0,1,2004
Chris Hoy,Great Britain,1,0,0,1,2004
Paolo Bettini,Italy,1,0,0,1,2004
Hu Jia,People's Republic of China,1,0,0,1,2004
Thomas Bimis,Greece,1,0,0,1,2004
Nicolas Touzaint,France,1,0,0,1,2004
Brice Guyart,France,1,0,0,1,2004
Hugues Obry,France,1,0,0,1,2004
Julien Pillet,France,1,0,0,1,2004
Tatyana Logunova,Russian Federation,1,0,0,1,2004
Marcel Fischer,Switzerland,1,0,0,1,2004
Christie Pearce-Rampone,United States,1,0,0,1,2004
Kate Sobrero-Markgraf,United States,1,0,0,1,2004
Kyle Shewfelt,Canada,1,0,0,1,2004
Gervasio Deferr,Spain,1,0,0,1,2004
Anna Dogonadze-Lilkendey,Germany,1,0,0,1,2004
Dimosthenis Tambakos,Greece,1,0,0,1,2004
Igor Cassina,Italy,1,0,0,1,2004
Alina Kabayeva,Russian Federation,1,0,0,1,2004
Nataliya Lavrova,Russian Federation,1,0,0,1,2004
Valeriy Honcharov,Ukraine,1,0,0,1,2004
Michael Brennan,Australia,1,0,0,1,2004
Troy Elder,Australia,1,0,0,1,2004
Brent Livermore,Australia,1,0,0,1,2004
Matt Wells,Australia,1,0,0,1,2004
Caroline Casaretto,Germany,1,0,0,1,2004
Franziska Gude,Germany,1,0,0,1,2004
Denise Klecker,Germany,1,0,0,1,2004
Fanny Rinne,Germany,1,0,0,1,2004
Marion Rodewald,Germany,1,0,0,1,2004
Julia Zwehl,Germany,1,0,0,1,2004
Masae Ueno,Japan,1,0,0,1,2004
Zsuzsa Vőrős,Hungary,1,0,0,1,2004
Thomas Ebert,Denmark,1,0,0,1,2004
Adrien Hardy,France,1,0,0,1,2004
Ed Coode,Great Britain,1,0,0,1,2004
Kerstin Kowalski-El-Qalqili,Germany,1,0,0,1,2004
Tomasz Kucharski,Poland,1,0,0,1,2004
Aurica Chiriță-Bărăscu,Romania,1,0,0,1,2004
Chris Ahrens,United States,1,0,0,1,2004
Pete Cipollone,United States,1,0,0,1,2004
Bryan Volpenhein,United States,1,0,0,1,2004
Hans-Peter Steinacher,Austria,1,0,0,1,2004
Sofia Bekatorou,Greece,1,0,0,1,2004
Siren Sundby,Norway,1,0,0,1,2004
Manfred Kurzer,Germany,1,0,0,1,2004
Aleksey Alipov,Russian Federation,1,0,0,1,2004
Ahmed Al-Maktoum,United Arab Emirates,1,0,0,1,2004
Crystl Bustos,United States,1,0,0,1,2004
Stacey Nuveman,United States,1,0,0,1,2004
Giaan Rooney,Australia,1,0,0,1,2004
Luo Xuejuan,People's Republic of China,1,0,0,1,2004
Camelia Potec,Romania,1,0,0,1,2004
Scott Goldblatt,United States,1,0,0,1,2004
Lenny Krayzelburg,United States,1,0,0,1,2004
Wang Nan,People's Republic of China,1,0,0,1,2004
Yu Seung-Min,Republic of Korea,1,0,0,1,2004
Chen Zhong,People's Republic of China,1,0,0,1,2004
Hadi Saei,Islamic Republic of Iran,1,0,0,1,2004
Steven Lopez,United States,1,0,0,1,2004
Li Ting,People's Republic of China,1,0,0,1,2004
Hamish Carter,New Zealand,1,0,0,1,2004
Ricardo,Brazil,1,0,0,1,2004
Misty May-Treanor,United States,1,0,0,1,2004
Dante,Brazil,1,0,0,1,2004
Gustavo,Brazil,1,0,0,1,2004
Giba,Brazil,1,0,0,1,2004
André Heller,Brazil,1,0,0,1,2004
Chen Jing,People's Republic of China,1,0,0,1,2004
Li Shan,People's Republic of China,1,0,0,1,2004
Kerri Walsh Jennings,United States,1,0,0,1,2004
Péter Biros,Hungary,1,0,0,1,2004
Gergő Kiss,Hungary,1,0,0,1,2004
Tamás Molnár,Hungary,1,0,0,1,2004
Barnabás Steinmetz,Hungary,1,0,0,1,2004
Zoltán Szécsi,Hungary,1,0,0,1,2004
Attila Vári,Hungary,1,0,0,1,2004
Zhang Guozheng,People's Republic of China,1,0,0,1,2004
Giorgi Asanidze,Georgia,1,0,0,1,2004
Pawina Thongsuk,Thailand,1,0,0,1,2004
István Gergely,Hungary,1,0,0,1,2004
Hossein Reza Zadeh,Islamic Republic of Iran,1,0,0,1,2004
Nataliya Skakun,Ukraine,1,0,0,1,2004
István Majoros,Hungary,1,0,0,1,2004
Artur Taymazov,Uzbekistan,1,0,0,1,2004
Cat Reddick,United States,1,0,0,1,2004
Shannon Boxx,United States,1,0,0,1,2004
Aly Wagner,United States,1,0,0,1,2004
Abby Wambach,United States,1,0,0,1,2004
Angela Hucles,United States,1,0,0,1,2004
Lindsay Tarpley,United States,1,0,0,1,2004
Germán Lux,Argentina,1,0,0,1,2004
Fabricio Coloccini,Argentina,1,0,0,1,2004
Javier Mascherano,Argentina,1,0,0,1,2004
Gabriel Heinze,Argentina,1,0,0,1,2004
César Delgado,Argentina,1,0,0,1,2004
Carlos Tévez,Argentina,1,0,0,1,2004
Kily González,Argentina,1,0,0,1,2004
Mauro Rosales,Argentina,1,0,0,1,2004
Andrés D'Alessandro,Argentina,1,0,0,1,2004
Luis González,Argentina,1,0,0,1,2004
Javier Saviola,Argentina,1,0,0,1,2004
Nicolás Medina,Argentina,1,0,0,1,2004
Clemente Rodríguez,Argentina,1,0,0,1,2004
Marco Galiazzo,Italy,1,0,0,1,2004
Im Dong-Hyeon,Republic of Korea,1,0,0,1,2004
Park Gyeong-Mo,Republic of Korea,1,0,0,1,2004
Heather Mitts,United States,1,0,0,1,2004
Heather O'Reilly,United States,1,0,0,1,2004
Nicolás Burdisso,Argentina,1,0,0,1,2004
Mariano González,Argentina,1,0,0,1,2004
Shannon Johnson,United States,1,0,0,1,2004
Sue Bird,United States,1,0,0,1,2004
Ruth Riley,United States,1,0,0,1,2004
Tamika Catchings,United States,1,0,0,1,2004
Tina Thompson,United States,1,0,0,1,2004
Diana Taurasi,United States,1,0,0,1,2004
Swin Cash,United States,1,0,0,1,2004
Mark Gangloff,United States,1,0,0,1,2004
Jess Schipper,Australia,1,0,0,1,2004
Ai Shibata,Japan,1,0,0,1,2004
Lyndon Ferns,South Africa,1,0,0,1,2004
Darian Townsend,South Africa,1,0,0,1,2004
Dana Vollmer,United States,1,0,0,1,2004
Nurcan Taylan,Turkey,1,0,0,1,2004
Udomporn Polsak,Thailand,1,0,0,1,2004
Chen Yanqing,People's Republic of China,1,0,0,1,2004
Shi Zhiyong,People's Republic of China,1,0,0,1,2004
Dan Ketchum,United States,1,0,0,1,2004
Peter Vanderkaay,United States,1,0,0,1,2004
Sara Carrigan,Australia,1,0,0,1,2004
Rhi Jeffrey,United States,1,0,0,1,2004
Carly Piper,United States,1,0,0,1,2004
Faustine Merret,France,1,0,0,1,2004
Sarah Webb,Great Britain,1,0,0,1,2004
Sarah Ayton,Great Britain,1,0,0,1,2004
Iker Martínez,Spain,1,0,0,1,2004
Xabier Fernández,Spain,1,0,0,1,2004
Georgina Evers-Swindell,New Zealand,1,0,0,1,2004
Caroline Evers-Swindell,New Zealand,1,0,0,1,2004
Rodica Florea-Șerban,Romania,1,0,0,1,2004
Ioana Papuc-Rotaru,Romania,1,0,0,1,2004
Steve Williams,Great Britain,1,0,0,1,2004
Thor Kristensen,Denmark,1,0,0,1,2004
Stephan Mølvig,Denmark,1,0,0,1,2004
Sergey Fedorovtsev,Russian Federation,1,0,0,1,2004
Aleksey Svirin,Russian Federation,1,0,0,1,2004
Jason Read,United States,1,0,0,1,2004
Wyatt Allen,United States,1,0,0,1,2004
Joey Hansen,United States,1,0,0,1,2004
Matt Deakin,United States,1,0,0,1,2004
Dan Beery,United States,1,0,0,1,2004
Beau Hoopman,United States,1,0,0,1,2004
Taner Sağır,Turkey,1,0,0,1,2004
Tang Gonghong,People's Republic of China,1,0,0,1,2004
Liu Chunhong,People's Republic of China,1,0,0,1,2004
Milen Dobrev,Bulgaria,1,0,0,1,2004
Dmitry Berestov,Russian Federation,1,0,0,1,2004
Du Li,People's Republic of China,1,0,0,1,2004
Olena Kostevych,Ukraine,1,0,0,1,2004
Suzy Balogh,Australia,1,0,0,1,2004
Zhu Qinan,People's Republic of China,1,0,0,1,2004
Matt Emmons,United States,1,0,0,1,2004
Jia Zhanbo,People's Republic of China,1,0,0,1,2004
Carolina Klüft,Sweden,1,0,0,1,2004
Aleen Bailey,Jamaica,1,0,0,1,2004
Yuliya Nestsiarenka,Belarus,1,0,0,1,2004
Sherone Simpson,Jamaica,1,0,0,1,2004
Meseret Defar,Ethiopia,1,0,0,1,2004
Xing Huina,People's Republic of China,1,0,0,1,2004
Fani Khalkia,Greece,1,0,0,1,2004
DeeDee Trotter,United States,1,0,0,1,2004
Sanya Richards-Ross,United States,1,0,0,1,2004
Benoît Peschier,France,1,0,0,1,2004
Maike Nollen,Germany,1,0,0,1,2004
Meng Guanliang,People's Republic of China,1,0,0,1,2004
Yang Wenjun,People's Republic of China,1,0,0,1,2004
Tomasz Wylenzek,Germany,1,0,0,1,2004
Joanna Hayes,United States,1,0,0,1,2004
Athanasia Tsoumeleka,Greece,1,0,0,1,2004
Mizuki Noguchi,Japan,1,0,0,1,2004
Mark Lewis-Francis,Great Britain,1,0,0,1,2004
Ezekiel Kemboi,Kenya,1,0,0,1,2004
Liu Xiang,People's Republic of China,1,0,0,1,2004
Zhang Ning,People's Republic of China,1,0,0,1,2004
Zhang Jiewen,People's Republic of China,1,0,0,1,2004
Anna Sivkova,Russian Federation,1,0,0,1,2004
Mariel Zagunis,United States,1,0,0,1,2004
Gaël Touya,France,1,0,0,1,2004
Simone Vanni,Italy,1,0,0,1,2004
Éric Boisse,France,1,0,0,1,2004
Fabrice Jeannet,France,1,0,0,1,2004
Jérôme Jeannet,France,1,0,0,1,2004
Kate Allen,Austria,1,0,0,1,2004
Yan Barthelemí,Cuba,1,0,0,1,2004
Yuriorkis Gamboa,Cuba,1,0,0,1,2004
Aleksey Tishchenko,Russian Federation,1,0,0,1,2004
Manut Boonjumnong,Thailand,1,0,0,1,2004
Bakhtiyar Artayev,Kazakhstan,1,0,0,1,2004
Andre Ward,United States,1,0,0,1,2004
Odlanier Solís,Cuba,1,0,0,1,2004
Aleksandr Povetkin,Russian Federation,1,0,0,1,2004
Xian Dongmei,People's Republic of China,1,0,0,1,2004
Yvonne Bönisch,Germany,1,0,0,1,2004
Ayumi Tanimoto,Japan,1,0,0,1,2004
Maki Tsukada,Japan,1,0,0,1,2004
Tim Mack,United States,1,0,0,1,2004
Masato Uchishiba,Japan,1,0,0,1,2004
Lee Won-Hui,Republic of Korea,1,0,0,1,2004
Ilias Iliadis,Greece,1,0,0,1,2004
Zurab Zviadauri,Georgia,1,0,0,1,2004
Ihar Makarau,Belarus,1,0,0,1,2004
Keiji Suzuki,Japan,1,0,0,1,2004
Peter Dawson,Australia,1,0,0,1,2004
Stephen Wooldridge,Australia,1,0,0,1,2004
Didier Courrèges,France,1,0,0,1,2004
Arnaud Boiteau,France,1,0,0,1,2004
Cédric Lyard,France,1,0,0,1,2004
Hubertus Schmidt,Germany,1,0,0,1,2004
Heike Kemmer,Germany,1,0,0,1,2004
Peter Wylde,United States,1,0,0,1,2004
Beezie Madden,United States,1,0,0,1,2004
McLain Ward,United States,1,0,0,1,2004
Andreas Thorkildsen,Norway,1,0,0,1,2004
Yelena Slesarenko,Russian Federation,1,0,0,1,2004
Oana Ban,Romania,1,0,0,1,2004
Silvia Stroescu,Romania,1,0,0,1,2004
Émilie Le Pennec,France,1,0,0,1,2004
Hisashi Mizutori,Japan,1,0,0,1,2004
Daisuke Nakano,Japan,1,0,0,1,2004
Teng Haibin,People's Republic of China,1,0,0,1,2004
Justine Henin-Hardenne,Belgium,1,0,0,1,2004
Sun Tiantian,People's Republic of China,1,0,0,1,2004
Andrey Moiseyev,Russian Federation,1,0,0,1,2004
Ma Lin,People's Republic of China,1,0,0,1,2004
Iryna Merleni-Mykulchyn,Ukraine,1,0,0,1,2004
Saori Yoshida,Japan,1,0,0,1,2004
Kaori Icho,Japan,1,0,0,1,2004
Wang Xu,People's Republic of China,1,0,0,1,2004
Fərid Mənsurov,Azerbaijan,1,0,0,1,2004
Khasan Baroyev,Russian Federation,1,0,0,1,2004
Aleksey Mishin,Russian Federation,1,0,0,1,2004
Aleksandr Dokturishvili,Uzbekistan,1,0,0,1,2004
Jeong Ji-Hyeon,Republic of Korea,1,0,0,1,2004
Karam Gaber,Egypt,1,0,0,1,2004
Mariya Gromova,Russian Federation,1,0,0,1,2004
Anna Shorina,Russian Federation,1,0,0,1,2004
Moushaumi Robinson,United States,1,0,0,1,2004
Monique Henderson,United States,1,0,0,1,2004
Kelly Willie,United States,1,0,0,1,2004
Andrew Rock,United States,1,0,0,1,2004
Darold Williamson,United States,1,0,0,1,2004
Olesya Belugina,Russian Federation,1,0,0,1,2004
Olga Glatskikh,Russian Federation,1,0,0,1,2004
Tatyana Kurbakova,Russian Federation,1,0,0,1,2004
Yelena Murzina,Russian Federation,1,0,0,1,2004
Yelena Posevina,Russian Federation,1,0,0,1,2004
Li Ting,People's Republic of China,1,0,0,1,2004
Yang Jinghui,People's Republic of China,1,0,0,1,2004
Peng Bo,People's Republic of China,1,0,0,1,2004
Julien Absalon,France,1,0,0,1,2004
Yandro Quintana,Cuba,1,0,0,1,2004
Khadzhimurat Gatsalov,Russian Federation,1,0,0,1,2004
Mavlet Batyrov,Russian Federation,1,0,0,1,2004
Cael Sanderson,United States,1,0,0,1,2004
Chen Shih-Hsien,Chinese Taipei,1,0,0,1,2004
Jang Ji-Won,Republic of Korea,1,0,0,1,2004
Luo Wei,People's Republic of China,1,0,0,1,2004
Chu Mu-Yen,Chinese Taipei,1,0,0,1,2004
Mun Dae-Seong,Republic of Korea,1,0,0,1,2004
Danny Betancourt,Cuba,1,0,0,1,2004
Luis Borroto,Cuba,1,0,0,1,2004
Frederich Cepeda,Cuba,1,0,0,1,2004
Yorelvis Charles,Cuba,1,0,0,1,2004
Michel Enríquez,Cuba,1,0,0,1,2004
Norberto González,Cuba,1,0,0,1,2004
Yulieski Gourriel,Cuba,1,0,0,1,2004
Roger Machado,Cuba,1,0,0,1,2004
Jonder Martínez,Cuba,1,0,0,1,2004
Danny Miranda,Cuba,1,0,0,1,2004
Frank Montieth,Cuba,1,0,0,1,2004
Vicyohandri Odelín,Cuba,1,0,0,1,2004
Adiel Palma,Cuba,1,0,0,1,2004
Alexei Ramírez,Cuba,1,0,0,1,2004
Eriel Sánchez,Cuba,1,0,0,1,2004
Carlos Tabares,Cuba,1,0,0,1,2004
Yoandri Urgellés,Cuba,1,0,0,1,2004
Osmani Urrutia,Cuba,1,0,0,1,2004
Manuel Vega,Cuba,1,0,0,1,2004
Carlos Delfino,Argentina,1,0,0,1,2004
Gabriel Fernández,Argentina,1,0,0,1,2004
Manu Ginóbili,Argentina,1,0,0,1,2004
Leonardo Gutiérrez,Argentina,1,0,0,1,2004
Walter Herrmann,Argentina,1,0,0,1,2004
Alejandro Ariel Montecchia,Argentina,1,0,0,1,2004
Andrés Nocioni,Argentina,1,0,0,1,2004
Pepe Sánchez,Argentina,1,0,0,1,2004
Luis Scola,Argentina,1,0,0,1,2004
Hugo Ariel Sconochini,Argentina,1,0,0,1,2004
Yuriy Nikitin,Ukraine,1,0,0,1,2004
Ivano Balić,Croatia,1,0,0,1,2004
Davor Dominiković,Croatia,1,0,0,1,2004
Mirza Džomba,Croatia,1,0,0,1,2004
Nikša Kaleb,Croatia,1,0,0,1,2004
Blaženko Lacković,Croatia,1,0,0,1,2004
Petar Metličić,Croatia,1,0,0,1,2004
Vlado Šola,Croatia,1,0,0,1,2004
Denis Špoljarić,Croatia,1,0,0,1,2004
Goran Šprem,Croatia,1,0,0,1,2004
Igor Vori,Croatia,1,0,0,1,2004
Drago Vuković,Croatia,1,0,0,1,2004
Vedran Zrnić,Croatia,1,0,0,1,2004
Kristine Andersen,Denmark,1,0,0,1,2004
Line Daugaard,Denmark,1,0,0,1,2004
Trine Jensen,Denmark,1,0,0,1,2004
Rikke Hørlykke,Denmark,1,0,0,1,2004
Henriette Mikkelsen,Denmark,1,0,0,1,2004
Louise Bager Nørgaard,Denmark,1,0,0,1,2004
Rikke Skov,Denmark,1,0,0,1,2004
Camilla Thomsen,Denmark,1,0,0,1,2004
Josephine Touray,Denmark,1,0,0,1,2004
Tina Bachmann,Germany,1,0,0,1,2004
Mandy Haase,Germany,1,0,0,1,2004
Anke Kühn,Germany,1,0,0,1,2004
Badri Latif,Germany,1,0,0,1,2004
Sonja Lehmann,Germany,1,0,0,1,2004
Silke Müller,Germany,1,0,0,1,2004
Louisa Walter,Germany,1,0,0,1,2004
Travis Brooks,Australia,1,0,0,1,2004
Dean Butler,Australia,1,0,0,1,2004
Jamie Dwyer,Australia,1,0,0,1,2004
Nathan Eglington,Australia,1,0,0,1,2004
Bevan George,Australia,1,0,0,1,2004
Rob Hammond,Australia,1,0,0,1,2004
Mark Hickman,Australia,1,0,0,1,2004
Mark Knowles,Australia,1,0,0,1,2004
Stephen Mowlam,Australia,1,0,0,1,2004
Michael McCann,Australia,1,0,0,1,2004
Grant Schubert,Australia,1,0,0,1,2004
Liam De Young,Australia,1,0,0,1,2004
Jennie Finch,United States,1,0,0,1,2004
Tairia Flowers,United States,1,0,0,1,2004
Amanda Freed,United States,1,0,0,1,2004
Lovie Jung,United States,1,0,0,1,2004
Kelly Kretschman,United States,1,0,0,1,2004
Jessica Mendoza,United States,1,0,0,1,2004
Cat Osterman,United States,1,0,0,1,2004
Jenny Topping,United States,1,0,0,1,2004
Natasha Watley,United States,1,0,0,1,2004
Feng Kun,People's Republic of China,1,0,0,1,2004
Liu Yanan,People's Republic of China,1,0,0,1,2004
Song Nina,People's Republic of China,1,0,0,1,2004
Yang Hao,People's Republic of China,1,0,0,1,2004
Zhang Na,People's Republic of China,1,0,0,1,2004
Zhang Ping,People's Republic of China,1,0,0,1,2004
Zhang Yuehong,People's Republic of China,1,0,0,1,2004
Zhao Ruirui,People's Republic of China,1,0,0,1,2004
Zhou Suhong,People's Republic of China,1,0,0,1,2004
Ricardinho,Brazil,1,0,0,1,2004
André Nascimento,Brazil,1,0,0,1,2004
Anderson,Brazil,1,0,0,1,2004
Rodrigão,Brazil,1,0,0,1,2004
Serginho,Brazil,1,0,0,1,2004
Carmela Allucci,Italy,1,0,0,1,2004
Alexandra Araujo,Italy,1,0,0,1,2004
Silvia Bosurgi,Italy,1,0,0,1,2004
Francesca Conti,Italy,1,0,0,1,2004
Elena Gigli,Italy,1,0,0,1,2004
Melania Grego,Italy,1,0,0,1,2004
Giusi Malato,Italy,1,0,0,1,2004
Martina Miceli,Italy,1,0,0,1,2004
Maddalena Musumeci,Italy,1,0,0,1,2004
Cinzia Ragusa,Italy,1,0,0,1,2004
Noémi Tóth,Italy,1,0,0,1,2004
Emanuela Zanchi,Italy,1,0,0,1,2004
Tania Di Mario,Italy,1,0,0,1,2004
Ádám Steinmetz,Hungary,1,0,0,1,2004
Tamás Varga,Hungary,1,0,0,1,2004
Norbert Madaras,Hungary,1,0,0,1,2004
Mikhail Ignatyev,Russian Federation,1,0,0,1,2004
Elvira Khasyanova,Russian Federation,1,0,0,1,2004
Chen Qi,People's Republic of China,1,0,0,1,2004
Miya Tachibana,Japan,0,2,0,2,2004
Miho Takeda,Japan,0,2,0,2,2004
Jenny Thompson,United States,0,2,0,2,2004
Nathan Baggaley,Australia,0,2,0,2,2004
Markus Rogan,Austria,0,2,0,2,2004
Amanda Weir,United States,0,2,0,2,2004
Kara Lynn Joyce,United States,0,2,0,2,2004
Annia Hatch,United States,0,2,0,2,2004
Terin Humphrey,United States,0,2,0,2,2004
Marian Drăgulescu,Romania,0,1,2,3,2004
Aleksandr Kostoglod,Russian Federation,0,1,1,2,2004
Beatriz Ferrer-Salat Serra,Spain,0,1,1,2,2004
Rob Hayles,Great Britain,0,1,1,2,2004
Laura Flessel-Colovic,France,0,1,1,2,2004
Mathew Helm,Australia,0,1,1,2,2004
Svetlana Khorkina,Russian Federation,0,1,1,2,2004
Yordan Yovchev,Bulgaria,0,1,1,2,2004
Marius Urzică,Romania,0,1,1,2,2004
Takashi Yamamoto,Japan,0,1,1,2,2004
Maurice Greene,United States,0,1,1,2,2004
Aleksandr Kovalyov,Russian Federation,0,1,1,2,2004
Arnaud Tournant,France,0,1,1,2,2004
Yuliya Pakhalina,Russian Federation,0,1,1,2,2004
Pippa Funnell,Great Britain,0,1,1,2,2004
Lee Bo-Na,Republic of Korea,0,1,1,2,2004
Nataliya Antyukh,Russian Federation,0,1,1,2,2004
Kim Severson,United States,0,1,1,2,2004
Courtney Kupets,United States,0,1,1,2,2004
Mia Audina,Indonesia,0,1,0,1,2004
He Ying,People's Republic of China,0,1,0,1,2004
Yu Yong-Seong,Republic of Korea,0,1,0,1,2004
Peta Edebone,Australia,0,1,0,1,2004
Tanya Harding,Australia,0,1,0,1,2004
Melanie Roche,Australia,0,1,0,1,2004
Natalie Ward,Australia,0,1,0,1,2004
Brooke Wilkins,Australia,0,1,0,1,2004
Jeff Williams,Australia,0,1,0,1,2004
Lorenzo Aragón,Cuba,0,1,0,1,2004
Hiroshi Yamamoto,Japan,0,1,0,1,2004
Conchita Martínez,Spain,0,1,0,1,2004
Vivi Ruano,Spain,0,1,0,1,2004
Kim Hyang-Mi,Democratic People's Republic of Korea,0,1,0,1,2004
Sandy Brondello,Australia,0,1,0,1,2004
Allison Cook-Tranquilli,Australia,0,1,0,1,2004
Trish Fallon,Australia,0,1,0,1,2004
Rachael Sporn,Australia,0,1,0,1,2004
Clint Robinson,Australia,0,1,0,1,2004
Mark Zabel,Germany,0,1,0,1,2004
Josefa Idem-Guerrini,Italy,0,1,0,1,2004
Beniamino Bonomi,Italy,0,1,0,1,2004
Antonio Rossi,Italy,0,1,0,1,2004
Michal Martikán,Slovakia,0,1,0,1,2004
Malin Baryard-Johnsson,Sweden,0,1,0,1,2004
Mary Thomson-King,Great Britain,0,1,0,1,2004
Rolf-Göran Bengtsson,Sweden,0,1,0,1,2004
Peter Eriksson,Sweden,0,1,0,1,2004
William Fox-Pitt,Great Britain,0,1,0,1,2004
Peder Fredricson,Sweden,0,1,0,1,2004
Ignacio Rambla,Spain,0,1,0,1,2004
Rafael Soto,Spain,0,1,0,1,2004
Judith Arndt,Germany,0,1,0,1,2004
Belem Guerrero,Mexico,0,1,0,1,2004
José Antonio Escuredo,Spain,0,1,0,1,2004
Joan Llaneras,Spain,0,1,0,1,2004
Chris Newton,Great Britain,0,1,0,1,2004
Bruno Risi,Switzerland,0,1,0,1,2004
Bryan Steel,Great Britain,0,1,0,1,2004
Mijntje Donners,Netherlands,0,1,0,1,2004
Teun de Nooijer,Netherlands,0,1,0,1,2004
Jeroen Delmeé,Netherlands,0,1,0,1,2004
Erik Jazet,Netherlands,0,1,0,1,2004
Guus Vogels,Netherlands,0,1,0,1,2004
Claudia Bokel,Germany,0,1,0,1,2004
Giovanna Trillini,Italy,0,1,0,1,2004
Dong Zhaozhi,People's Republic of China,0,1,0,1,2004
Wang Haibin,People's Republic of China,0,1,0,1,2004
Ye Chong,People's Republic of China,0,1,0,1,2004
Géza Imre,Hungary,0,1,0,1,2004
Iván Kovács,Hungary,0,1,0,1,2004
Krisztián Kulcsár,Hungary,0,1,0,1,2004
Luigi Tarantino,Italy,0,1,0,1,2004
Pretinha,Brazil,0,1,0,1,2004
Formiga,Brazil,0,1,0,1,2004
Tânia Maranhão,Brazil,0,1,0,1,2004
Carlos Gamarra,Paraguay,0,1,0,1,2004
Blaine Wilson,United States,0,1,0,1,2004
Markus Baur,Germany,0,1,0,1,2004
Stefan Kretzschmar,Germany,0,1,0,1,2004
Klaus-Dieter Petersen,Germany,0,1,0,1,2004
Christian Schwarzer,Germany,0,1,0,1,2004
Daniel Stephan,Germany,0,1,0,1,2004
Volker Zerbe,Germany,0,1,0,1,2004
Heo Sun-Yeong,Republic of Korea,0,1,0,1,2004
Lee Sang-Eun,Republic of Korea,0,1,0,1,2004
Im Oh-Gyeong,Republic of Korea,0,1,0,1,2004
Oh Seong-Ok,Republic of Korea,0,1,0,1,2004
Oh Yeong-Ran,Republic of Korea,0,1,0,1,2004
Kye Sun-Hui,Democratic People's Republic of Korea,0,1,0,1,2004
Andrejus Zadneprovskis,Lithuania,0,1,0,1,2004
Simon Burgess,Australia,0,1,0,1,2004
Anthony Edwards,Australia,0,1,0,1,2004
Katsiaryna Khadatovich-Karsten,Belarus,0,1,0,1,2004
Siniša Skelin,Croatia,0,1,0,1,2004
Jüri Jaanson,Estonia,0,1,0,1,2004
Cath Bishop,Great Britain,0,1,0,1,2004
Michiel Bartman,Netherlands,0,1,0,1,2004
Diederik Simon,Netherlands,0,1,0,1,2004
Iztok Čop,Slovenia,0,1,0,1,2004
Luka Špik,Slovenia,0,1,0,1,2004
Laurel Korholz,United States,0,1,0,1,2004
María Quintanal,Spain,0,1,0,1,2004
Giovanni Pellielo,Italy,0,1,0,1,2004
Mike Anti,United States,0,1,0,1,2004
Jasna Šekarić,Individual Olympic Athletes,0,1,0,1,2004
Michael Klim,Australia,0,1,0,1,2004
Leon Taylor,Great Britain,0,1,0,1,2004
Andreas Wels,Germany,0,1,0,1,2004
Mark Veens,Netherlands,0,1,0,1,2004
Vera Ilyina,Russian Federation,0,1,0,1,2004
Javier Bosma,Spain,0,1,0,1,2004
Andrea Giani,Italy,0,1,0,1,2004
Samuele Papi,Italy,0,1,0,1,2004
Andrea Sartoretti,Italy,0,1,0,1,2004
Paolo Tofoli,Italy,0,1,0,1,2004
Yevgeniya Artamonova-Estes,Russian Federation,0,1,0,1,2004
Yelena Batukhtina-Tyurina,Russian Federation,0,1,0,1,2004
Lyubov Sokolova-Shashkova,Russian Federation,0,1,0,1,2004
Yelizaveta Tishchenko,Russian Federation,0,1,0,1,2004
Viktor Jelenić,Serbia,0,1,0,1,2004
Aleksandar Šapić,Serbia,0,1,0,1,2004
Dejan Savić,Serbia,0,1,0,1,2004
Petar Trbojević,Serbia,0,1,0,1,2004
Vlada Vujasinović,Serbia,0,1,0,1,2004
Viktors Ščerbatihs,Latvia,0,1,0,1,2004
Sergey Filimonov,Kazakhstan,0,1,0,1,2004
Ihor Razoronov,Ukraine,0,1,0,1,2004
Marko Yli-Hannuksela,Finland,0,1,0,1,2004
Şeref Eroğlu,Turkey,0,1,0,1,2004
Ruslana Taran,Ukraine,0,1,0,1,2004
Natalia Vía Dufresne,Spain,0,1,0,1,2004
Nikos Kaklamanakis,Greece,0,1,0,1,2004
John Lovell,United States,0,1,0,1,2004
Rodion Luka,Ukraine,0,1,0,1,2004
Ross MacDonald,Canada,0,1,0,1,2004
Charlie Ogletree,United States,0,1,0,1,2004
Steffi Nerius,Germany,0,1,0,1,2004
Anastasia Kelesidou,Greece,0,1,0,1,2004
Francis Obikwelu,Nigeria,0,1,0,1,2004
Ionela Târlea-Manolache,Romania,0,1,0,1,2004
Olena Ovcharova-Krasovska,Ukraine,0,1,0,1,2004
Nadine Kleinert-Schmitt,Germany,0,1,0,1,2004
Craig Anderson,Australia,0,1,0,1,2004
Paul Gonzalez,Australia,0,1,0,1,2004
Dave Nilsson,Australia,0,1,0,1,2004
Brett Roneberg,Australia,0,1,0,1,2004
Rodney Van Buizen,Australia,0,1,0,1,2004
Glenn Williams,Australia,0,1,0,1,2004
Nathan Robertson,Great Britain,0,1,0,1,2004
Gianluca Basile,Italy,0,1,0,1,2004
Roberto Chiacig,Italy,0,1,0,1,2004
Jack Galanda,Italy,0,1,0,1,2004
Denis Marconato,Italy,0,1,0,1,2004
Michele Mian,Italy,0,1,0,1,2004
Kristi Harrower,Australia,0,1,0,1,2004
Lauren Jackson,Australia,0,1,0,1,2004
Pat Dwyer,Australia,0,1,0,1,2004
Yipsi Moreno,Cuba,0,1,0,1,2004
Joachim Olsen,Denmark,0,1,0,1,2004
Francisco Javier Fernández,Spain,0,1,0,1,2004
Zoltán Kővágó,Hungary,0,1,0,1,2004
Danny McFarlane,Jamaica,0,1,0,1,2004
Bernard Lagat,Kenya,0,1,0,1,2004
Austra Skujytė,Lithuania,0,1,0,1,2004
Hasna Benhassi,Morocco,0,1,0,1,2004
Ana Guevara,Mexico,0,1,0,1,2004
Hestrie Storbeck-Cloete,South Africa,0,1,0,1,2004
Svetlana Feofanova,Russian Federation,0,1,0,1,2004
Irina Khabarova,Russian Federation,0,1,0,1,2004
Nataliya Nazarova,Russian Federation,0,1,0,1,2004
Heo Yeong-Suk,Republic of Korea,0,1,0,1,2004
Kim Hyeon-Ok,Republic of Korea,0,1,0,1,2004
Tom Herschmiller,Canada,0,1,0,1,2004
Tatyana Tomashova,Russian Federation,0,1,0,1,2004
Olesya Zykina,Russian Federation,0,1,0,1,2004
Meb Keflezighi,United States,0,1,0,1,2004
Coby Miller,United States,0,1,0,1,2004
Terrence Trammell,United States,0,1,0,1,2004
"Bernard Williams, III",United States,0,1,0,1,2004
Lee Dong-Su,Republic of Korea,0,1,0,1,2004
Son Seung-Mo,Republic of Korea,0,1,0,1,2004
Jérôme Thomas,France,0,1,0,1,2004
Mahamed Aryphadzhyeu,Azerbaijan,0,1,0,1,2004
Ledys Balceiro,Cuba,0,1,0,1,2004
Ibrahim Rojas,Cuba,0,1,0,1,2004
Björn Bach,Germany,0,1,0,1,2004
Andreas Ihle,Germany,0,1,0,1,2004
Stefan Ulm,Germany,0,1,0,1,2004
Szilvia Szabó,Hungary,0,1,0,1,2004
Erzsébet Viski,Hungary,0,1,0,1,2004
Rebecca Giddens,United States,0,1,0,1,2004
José Antonio Hermida,Spain,0,1,0,1,2004
Paul Manning,Great Britain,0,1,0,1,2004
Tomohiro Nagatsuka,Japan,0,1,0,1,2004
Franco Marvulli,Switzerland,0,1,0,1,2004
Alexandre Despatie,Canada,0,1,0,1,2004
Peter Waterfield,Great Britain,0,1,0,1,2004
Juan Antonio Jiménez,Spain,0,1,0,1,2004
Jeanette Brakewell,Great Britain,0,1,0,1,2004
Imke Duplitzer,Germany,0,1,0,1,2004
Zsolt Nemcsik,Hungary,0,1,0,1,2004
Giampiero Pastore,Italy,0,1,0,1,2004
Andréia,Brazil,0,1,0,1,2004
Daniela,Brazil,0,1,0,1,2004
Juliana,Brazil,0,1,0,1,2004
Maycon,Brazil,0,1,0,1,2004
Mônica,Brazil,0,1,0,1,2004
Rosana,Brazil,0,1,0,1,2004
Roseli,Brazil,0,1,0,1,2004
Karen Cockburn,Canada,0,1,0,1,2004
Mun Gyeong-Ha,Republic of Korea,0,1,0,1,2004
Henning Fritz,Germany,0,1,0,1,2004
Florian Kehrmann,Germany,0,1,0,1,2004
Frank von Behren,Germany,0,1,0,1,2004
Aleksandr Moskalenko,Russian Federation,0,1,0,1,2004
Morgan Hamm,United States,0,1,0,1,2004
Marten Eikelboom,Netherlands,0,1,0,1,2004
Sander van der Weide,Netherlands,0,1,0,1,2004
Minke Booij,Netherlands,0,1,0,1,2004
Ageeth Boomgaardt,Netherlands,0,1,0,1,2004
Fátima Moreira de Melo,Netherlands,0,1,0,1,2004
Clarinda Sinnige,Netherlands,0,1,0,1,2004
Minke Smabers,Netherlands,0,1,0,1,2004
Macha van der Vaart,Netherlands,0,1,0,1,2004
Daima Beltrán,Cuba,0,1,0,1,2004
Nest'or Khergiani,Georgia,0,1,0,1,2004
Jang Seong-Ho,Republic of Korea,0,1,0,1,2004
Edith Bosch,Netherlands,0,1,0,1,2004
Vitaly Makarov,Russian Federation,0,1,0,1,2004
Tamerlan Tmenov,Russian Federation,0,1,0,1,2004
Jeļena Rubļevska,Latvia,0,1,0,1,2004
Nikša Skelin,Croatia,0,1,0,1,2004
Pascal Touron,France,0,1,0,1,2004
Katherine Grainger,Great Britain,0,1,0,1,2004
Frances Houghton,Great Britain,0,1,0,1,2004
Alison Mowbray,Great Britain,0,1,0,1,2004
Claudia Blasberg,Germany,0,1,0,1,2004
Geert-Jan Derksen,Netherlands,0,1,0,1,2004
Gerritjan Eggenkamp,Netherlands,0,1,0,1,2004
Lianne Nelson,United States,0,1,0,1,2004
Jake Wetzel,Canada,0,1,0,1,2004
Andreas Geritzer,Austria,0,1,0,1,2004
Lenka Šmídová,Czech Republic,0,1,0,1,2004
Sandra Azón,Spain,0,1,0,1,2004
Rafael Trujillo,Spain,0,1,0,1,2004
Nick Rogers,Great Britain,0,1,0,1,2004
Joe Glanfield,Great Britain,0,1,0,1,2004
Heorhiy Leonchuk,Ukraine,0,1,0,1,2004
Sandy Allen-Lewis,Australia,0,1,0,1,2004
Fiona Hanes-Crawford,Australia,0,1,0,1,2004
Simmone Morrow,Australia,0,1,0,1,2004
Natalie Titcume,Australia,0,1,0,1,2004
Todd Pearson,Australia,0,1,0,1,2004
Yang Yu,People's Republic of China,0,1,0,1,2004
Duje Draganja,Croatia,0,1,0,1,2004
Lars Conrad,Germany,0,1,0,1,2004
Steffen Driesen,Germany,0,1,0,1,2004
Jens Kruppa,Germany,0,1,0,1,2004
Thomas Rupprath,Germany,0,1,0,1,2004
Johan Kenkhuis,Netherlands,0,1,0,1,2004
Klaas-Erik Zwering,Netherlands,0,1,0,1,2004
Erik Vendt,United States,0,1,0,1,2004
Juri Tatsumi,Japan,0,1,0,1,2004
Yoko Yoneda,Japan,0,1,0,1,2004
Lee Eun-Sil,Republic of Korea,0,1,0,1,2004
Seok Eun-Mi,Republic of Korea,0,1,0,1,2004
Myriam Baverel,France,0,1,0,1,2004
Alexandros Nikolaidis,Greece,0,1,0,1,2004
Huang Chih-Hsiung,Chinese Taipei,0,1,0,1,2004
Amélie Mauresmo,France,0,1,0,1,2004
Nicolas Kiefer,Germany,0,1,0,1,2004
Rainer Schüttler,Germany,0,1,0,1,2004
Shelda,Brazil,0,1,0,1,2004
Adriana Behar,Brazil,0,1,0,1,2004
Loretta Harrop,Australia,0,1,0,1,2004
Yekaterina Gamova,Russian Federation,0,1,0,1,2004
Le Maosheng,People's Republic of China,0,1,0,1,2004
Raema Lisa Rumbewas,Indonesia,0,1,0,1,2004
Ri Song-Hui,Democratic People's Republic of Korea,0,1,0,1,2004
Alessandro Fei,Italy,0,1,0,1,2004
Luigi Mastrangelo,Italy,0,1,0,1,2004
Aleksandar Ćirić,Serbia,0,1,0,1,2004
Danilo Ikodinović,Serbia,0,1,0,1,2004
Hanna Batsiushka,Belarus,0,1,0,1,2004
Lee Bae-Yeong,Republic of Korea,0,1,0,1,2004
Ara Abrahamian,Sweden,0,1,0,1,2004
Gennady Laliyev,Kazakhstan,0,1,0,1,2004
Mun Ui-Je,Republic of Korea,0,1,0,1,2004
Kóki,Brazil,0,1,0,1,2004
Marta,Brazil,0,1,0,1,2004
Grazielle,Brazil,0,1,0,1,2004
Elaine,Brazil,0,1,0,1,2004
Cristiane,Brazil,0,1,0,1,2004
Zhang Juanjuan,People's Republic of China,0,1,0,1,2004
Lin Sang,People's Republic of China,0,1,0,1,2004
Chen Szu-Yuan,Chinese Taipei,0,1,0,1,2004
Liu Ming-Huang,Chinese Taipei,0,1,0,1,2004
Wang Cheng-Pang,Chinese Taipei,0,1,0,1,2004
Diego Barreto,Paraguay,0,1,0,1,2004
Julio Manzur,Paraguay,0,1,0,1,2004
José Devaca,Paraguay,0,1,0,1,2004
Celso Esquivel,Paraguay,0,1,0,1,2004
Pablo Giménez,Paraguay,0,1,0,1,2004
Édgar Barreto,Paraguay,0,1,0,1,2004
Diego Figueredo,Paraguay,0,1,0,1,2004
Aureliano Torres,Paraguay,0,1,0,1,2004
Ernesto Cristaldo,Paraguay,0,1,0,1,2004
José Cardozo,Paraguay,0,1,0,1,2004
Emilio Martínez,Paraguay,0,1,0,1,2004
Fredy Bareiro,Paraguay,0,1,0,1,2004
Osvaldo Díaz,Paraguay,0,1,0,1,2004
Julio César Enciso,Paraguay,0,1,0,1,2004
Julio González,Paraguay,0,1,0,1,2004
Alicia Poto,Australia,0,1,0,1,2004
Penny Taylor,Australia,0,1,0,1,2004
Suzy Batkovic,Australia,0,1,0,1,2004
Belinda Snell,Australia,0,1,0,1,2004
Natalie Porter,Australia,0,1,0,1,2004
Larsen Jensen,United States,0,1,0,1,2004
Malia Metella,France,0,1,0,1,2004
Xu Yanwei,People's Republic of China,0,1,0,1,2004
Zhu Yingwen,People's Republic of China,0,1,0,1,2004
Federica Pellegrini,Italy,0,1,0,1,2004
Colleen Lanné,United States,0,1,0,1,2004
Ritz Correia,United States,0,1,0,1,2004
Stanislava Komarova,Russian Federation,0,1,0,1,2004
Haley Cope,United States,0,1,0,1,2004
Tara Kirk,United States,0,1,0,1,2004
Mitja Zastrow,Netherlands,0,1,0,1,2004
Helge Meeuw,Germany,0,1,0,1,2004
Pang Jiaying,People's Republic of China,0,1,0,1,2004
Li Zhuo,People's Republic of China,0,1,0,1,2004
Wu Meijin,People's Republic of China,0,1,0,1,2004
Dániel Gyurta,Hungary,0,1,0,1,2004
Antony Matkovich,Australia,0,1,0,1,2004
Nicholas Sprenger,Australia,0,1,0,1,2004
Craig Stevens,Australia,0,1,0,1,2004
Sérgio Paulinho,Portugal,0,1,0,1,2004
Bobby Julich,United States,0,1,0,1,2004
Dede Demet-Barry,United States,0,1,0,1,2004
Li Ji,People's Republic of China,0,1,0,1,2004
Yin Jian,People's Republic of China,0,1,0,1,2004
Hanna Kalinina,Ukraine,0,1,0,1,2004
Svitlana Matevusheva,Ukraine,0,1,0,1,2004
Peggy Waleska,Germany,0,1,0,1,2004
Britta Oppelt,Germany,0,1,0,1,2004
Daniela Reimer,Germany,0,1,0,1,2004
Debbie Flood,Great Britain,0,1,0,1,2004
Rebecca Romero,Great Britain,0,1,0,1,2004
Kate Johnson,United States,0,1,0,1,2004
Sam Magee,United States,0,1,0,1,2004
Megan Dirkmaat,United States,0,1,0,1,2004
Alison Cox,United States,0,1,0,1,2004
Caryn Davies,United States,0,1,0,1,2004
Anna Mickelson-Cummins,United States,0,1,0,1,2004
Mary Whipple,United States,0,1,0,1,2004
Cam Baerg,Canada,0,1,0,1,2004
Barney Williams,Canada,0,1,0,1,2004
Frédéric Dufour,France,0,1,0,1,2004
Glen Loftus,Australia,0,1,0,1,2004
Ben Cureton,Australia,0,1,0,1,2004
David Kopřiva,Czech Republic,0,1,0,1,2004
Tomáš Karas,Czech Republic,0,1,0,1,2004
Jakub Hanák,Czech Republic,0,1,0,1,2004
David Jirka,Czech Republic,0,1,0,1,2004
Matthijs Vellenga,Netherlands,0,1,0,1,2004
Gijs Vermeulen,Netherlands,0,1,0,1,2004
Jan-Willem Gabriëls,Netherlands,0,1,0,1,2004
Daniël Mensch,Netherlands,0,1,0,1,2004
Chun Wei Cheung,Netherlands,0,1,0,1,2004
Mike Wolfs,Canada,0,1,0,1,2004
Andrei Rybakou,Belarus,0,1,0,1,2004
Jang Mi-Ran,Republic of Korea,0,1,0,1,2004
Nataliya Zabolotnaya,Russian Federation,0,1,0,1,2004
Eszter Krutzler,Hungary,0,1,0,1,2004
Khadzhimurat Akkayev,Russian Federation,0,1,0,1,2004
Valentina Turisini,Italy,0,1,0,1,2004
Lenka Hyková-Marušková,Czech Republic,0,1,0,1,2004
Wei Ning,People's Republic of China,0,1,0,1,2004
Jin Jong-O,Republic of Korea,0,1,0,1,2004
Li Jie,People's Republic of China,0,1,0,1,2004
Rajyavardhan Rathore,India,0,1,0,1,2004
Marko Kemppainen,Finland,0,1,0,1,2004
Aleksandr Blinov,Russian Federation,0,1,0,1,2004
Sergey Polyakov,Russian Federation,0,1,0,1,2004
Christian Lusch,Germany,0,1,0,1,2004
Larisa Kruglova,Russian Federation,0,1,0,1,2004
Lauryn Williams,United States,0,1,0,1,2004
Yuliya Tabakova,Russian Federation,0,1,0,1,2004
Isabella Ochichi,Kenya,0,1,0,1,2004
Pigi Devetzi,Greece,0,1,0,1,2004
Marcus Becker,Germany,0,1,0,1,2004
Stefan Henze,Germany,0,1,0,1,2004
Campbell Walsh,Great Britain,0,1,0,1,2004
Kinga Bóta,Hungary,0,1,0,1,2004
Ben Fouhy,New Zealand,0,1,0,1,2004
Allyson Felix,United States,0,1,0,1,2004
Olimpiada Ivanova,Russian Federation,0,1,0,1,2004
Catherine Ndereba,Kenya,0,1,0,1,2004
Marian Oprea,Romania,0,1,0,1,2004
Matt Hemingway,United States,0,1,0,1,2004
Clinton Hill,Australia,0,1,0,1,2004
Sileshi Sihine,Ethiopia,0,1,0,1,2004
Brimin Kipruto,Kenya,0,1,0,1,2004
Bryan Clay,United States,0,1,0,1,2004
Gail Emms,Great Britain,0,1,0,1,2004
Huang Sui,People's Republic of China,0,1,0,1,2004
Britta Heidemann,Germany,0,1,0,1,2004
Tan Xue,People's Republic of China,0,1,0,1,2004
Wu Hanxiong,People's Republic of China,0,1,0,1,2004
Wang Lei,People's Republic of China,0,1,0,1,2004
Gábor Boczkó,Hungary,0,1,0,1,2004
Atagün Yalçınkaya,Turkey,0,1,0,1,2004
Worapoj Petchkoom,Thailand,0,1,0,1,2004
Kim Song-Guk,Democratic People's Republic of Korea,0,1,0,1,2004
Amir Khan,Great Britain,0,1,0,1,2004
Yudel Johnson,Cuba,0,1,0,1,2004
Gennady Golovkin,Kazakhstan,0,1,0,1,2004
Viktar Zuyeu,Belarus,0,1,0,1,2004
Mohamed Aly,Egypt,0,1,0,1,2004
Frédérique Jossinet,France,0,1,0,1,2004
Yuki Yokosawa,Japan,0,1,0,1,2004
Claudia Heill,Austria,0,1,0,1,2004
Liu Xia,People's Republic of China,0,1,0,1,2004
Bevan Docherty,New Zealand,0,1,0,1,2004
Irina Simagina,Russian Federation,0,1,0,1,2004
Toby Stevenson,United States,0,1,0,1,2004
Mbulaeni Mulaudzi,South Africa,0,1,0,1,2004
DoDo Krnáč,Slovakia,0,1,0,1,2004
Roman Hontiuk,Ukraine,0,1,0,1,2004
Hiroshi Izumi,Japan,0,1,0,1,2004
Pablo Herrera,Spain,0,1,0,1,2004
Jiang Yonghua,People's Republic of China,0,1,0,1,2004
Tamila Abasova,Russian Federation,0,1,0,1,2004
Katie Mactier,Australia,0,1,0,1,2004
Theo Bos,Netherlands,0,1,0,1,2004
Toshiaki Fushimi,Japan,0,1,0,1,2004
Steve Cummings,Great Britain,0,1,0,1,2004
Masaki Inoue,Japan,0,1,0,1,2004
Vadims Vasiļevskis,Latvia,0,1,0,1,2004
Olga Fyodorova-Stulneva,Russian Federation,0,1,0,1,2004
Mohini Bhardwaj,United States,0,1,0,1,2004
Courtney McCool,United States,0,1,0,1,2004
Jason Gatson,United States,0,1,0,1,2004
Brett McClure,United States,0,1,0,1,2004
Guard Young,United States,0,1,0,1,2004
Kim Dae-Eun,Republic of Korea,0,1,0,1,2004
Jevgēņijs Saproņenko,Latvia,0,1,0,1,2004
Mardy Fish,United States,0,1,0,1,2004
Denis Nizhegorodov,Russian Federation,0,1,0,1,2004
Ko Lai Chak,"Hong Kong, China",0,1,0,1,2004
Wang Hao,People's Republic of China,0,1,0,1,2004
Li Ching,"Hong Kong, China",0,1,0,1,2004
Chiharu Icho,Japan,0,1,0,1,2004
Tonya Verbeek,Canada,0,1,0,1,2004
Sara McMann,United States,0,1,0,1,2004
Gyuzel Manyurova,Kazakhstan,0,1,0,1,2004
Georgy Tsurtsumia,Kazakhstan,0,1,0,1,2004
Geydar Mamedaliyev,Russian Federation,0,1,0,1,2004
Roberto Monzón,Cuba,0,1,0,1,2004
Ramaz Nozadze,Georgia,0,1,0,1,2004
Michiyo Fujimaru,Japan,0,1,0,1,2004
Saho Harada,Japan,0,1,0,1,2004
Naoko Kawashima,Japan,0,1,0,1,2004
Emiko Suzuki,Japan,0,1,0,1,2004
Ejegayehu Dibaba,Ethiopia,0,1,0,1,2004
Olesya Krasnomovets,Russian Federation,0,1,0,1,2004
Nataliya Ivanova,Russian Federation,0,1,0,1,2004
Tatyana Firova,Russian Federation,0,1,0,1,2004
Darvis Patton,United States,0,1,0,1,2004
John Steffensen,Australia,0,1,0,1,2004
Mark Ormrod,Australia,0,1,0,1,2004
Irina Chashchina,Russian Federation,0,1,0,1,2004
Elisa Blanchi,Italy,0,1,0,1,2004
Fabrizia D'Ottavio,Italy,0,1,0,1,2004
Marinella Falca,Italy,0,1,0,1,2004
Daniela Masseroni,Italy,0,1,0,1,2004
Elisa Santoni,Italy,0,1,0,1,2004
Laura Vernizzi,Italy,0,1,0,1,2004
Nataliya Goncharova,Russian Federation,0,1,0,1,2004
Yuliya Koltunova,Russian Federation,0,1,0,1,2004
Tobias Schellenberg,Germany,0,1,0,1,2004
Marie-Hélène Prémont,Canada,0,1,0,1,2004
Masoud Mostafa Jokar,Islamic Republic of Iran,0,1,0,1,2004
Magomed Ibragimov,Uzbekistan,0,1,0,1,2004
Ali Reza Rezaei,Islamic Republic of Iran,0,1,0,1,2004
Jamill Kelly,United States,0,1,0,1,2004
Stephen Abas,United States,0,1,0,1,2004
Yanely Labrada,Cuba,0,1,0,1,2004
Nia Abdallah,United States,0,1,0,1,2004
Elli Mystakidou,Greece,0,1,0,1,2004
Óscar Salazar,Mexico,0,1,0,1,2004
Bahri Tanrıkulu,Turkey,0,1,0,1,2004
Tom Brice,Australia,0,1,0,1,2004
Adrian Burnside,Australia,0,1,0,1,2004
Gavin Fingleson,Australia,0,1,0,1,2004
Nick Kimpton,Australia,0,1,0,1,2004
Brendan Kingman,Australia,0,1,0,1,2004
Craig Lewis,Australia,0,1,0,1,2004
Graeme Lloyd,Australia,0,1,0,1,2004
Trent Oeltjen,Australia,0,1,0,1,2004
Wayne Ough,Australia,0,1,0,1,2004
Chris Oxspring,Australia,0,1,0,1,2004
Ryan Rowland Smith,Australia,0,1,0,1,2004
John Stephens,Australia,0,1,0,1,2004
Phil Stockman,Australia,0,1,0,1,2004
Brett Tamburrino,Australia,0,1,0,1,2004
Richard Thompson,Australia,0,1,0,1,2004
Andrew Utting,Australia,0,1,0,1,2004
Ben Wigmore,Australia,0,1,0,1,2004
Massimo Bulleri,Italy,0,1,0,1,2004
Luca Garri,Italy,0,1,0,1,2004
Gianmarco Pozzecco,Italy,0,1,0,1,2004
Nikola Radulovic,Italy,0,1,0,1,2004
Alex Righetti,Italy,0,1,0,1,2004
Rodolfo Rombaldoni,Italy,0,1,0,1,2004
Matteo Soragna,Italy,0,1,0,1,2004
Laura Summerton-Hodges,Australia,0,1,0,1,2004
Kelly Cristina,Brazil,0,1,0,1,2004
Pedro Benítez,Paraguay,0,1,0,1,2004
Mark Dragunski,Germany,0,1,0,1,2004
Pascal Hens,Germany,0,1,0,1,2004
Jan-Olaf Immel,Germany,0,1,0,1,2004
Torsten Jansen,Germany,0,1,0,1,2004
Christian Ramota,Germany,0,1,0,1,2004
Christian Zeitz,Germany,0,1,0,1,2004
Choi Im-Jeong,Republic of Korea,0,1,0,1,2004
Jang So-Hui,Republic of Korea,0,1,0,1,2004
Kim Cha-Yeon,Republic of Korea,0,1,0,1,2004
Lee Gong-Ju,Republic of Korea,0,1,0,1,2004
Mun Pil-Hui,Republic of Korea,0,1,0,1,2004
Myeom Bok-Hui,Republic of Korea,0,1,0,1,2004
U Seon-Hui,Republic of Korea,0,1,0,1,2004
Sylvia Karres,Netherlands,0,1,0,1,2004
Eefke Mulder,Netherlands,0,1,0,1,2004
Maartje Scheepstra,Netherlands,0,1,0,1,2004
Janneke Schopman,Netherlands,0,1,0,1,2004
Jiske Snoeks,Netherlands,0,1,0,1,2004
Chantal de Bruijn,Netherlands,0,1,0,1,2004
Lisanne de Roever,Netherlands,0,1,0,1,2004
Miek van Geenhuizen,Netherlands,0,1,0,1,2004
Lieve van Kessel,Netherlands,0,1,0,1,2004
Matthijs Brouwer,Netherlands,0,1,0,1,2004
Ronald Brouwer,Netherlands,0,1,0,1,2004
Geert-Jan Derikx,Netherlands,0,1,0,1,2004
Rob Derikx,Netherlands,0,1,0,1,2004
Floris Evers,Netherlands,0,1,0,1,2004
Karel Klaver,Netherlands,0,1,0,1,2004
Jesse Mahieu,Netherlands,0,1,0,1,2004
Rob Reckers,Netherlands,0,1,0,1,2004
Taeke Taekema,Netherlands,0,1,0,1,2004
Klaas Veering,Netherlands,0,1,0,1,2004
Marissa Carpadios,Australia,0,1,0,1,2004
Amanda Doman,Australia,0,1,0,1,2004
Natalie Hodgskin,Australia,0,1,0,1,2004
Tracey Mosley,Australia,0,1,0,1,2004
Stacey Porter,Australia,0,1,0,1,2004
Kerry Wyborn,Australia,0,1,0,1,2004
Olga Chukanova,Russian Federation,0,1,0,1,2004
Olga Nikolayeva,Russian Federation,0,1,0,1,2004
Yelena Plotnikova,Russian Federation,0,1,0,1,2004
Marina Sheshenina,Russian Federation,0,1,0,1,2004
Irina Tebenikhina,Russian Federation,0,1,0,1,2004
Matej Cernic,Italy,0,1,0,1,2004
Alberto Cisolla,Italy,0,1,0,1,2004
Paolo Cozzi,Italy,0,1,0,1,2004
Damiano Pippi,Italy,0,1,0,1,2004
Ventzislav Simeonov,Italy,0,1,0,1,2004
Valerio Vermiglio,Italy,0,1,0,1,2004
Dimitra Asilian,Greece,0,1,0,1,2004
Georgia Ellinaki,Greece,0,1,0,1,2004
Eftykhia Karagianni,Greece,0,1,0,1,2004
Angeliki Karapataki,Greece,0,1,0,1,2004
Voula Kozomboli,Greece,0,1,0,1,2004
Georgia Lara,Greece,0,1,0,1,2004
Kiki Liosi,Greece,0,1,0,1,2004
Antiopi Melidoni,Greece,0,1,0,1,2004
Tonia Moraiti,Greece,0,1,0,1,2004
Evi Moraitidou,Greece,0,1,0,1,2004
Anthi Mylonaki,Greece,0,1,0,1,2004
Katerina Oikonomopoulou,Greece,0,1,0,1,2004
Antigoni Roumbesi,Greece,0,1,0,1,2004
Vladimir Gojković,Montenegro,0,1,0,1,2004
Predrag Jokić,Montenegro,0,1,0,1,2004
Slobodan Nikić,Serbia,0,1,0,1,2004
Denis Šefik,Montenegro,0,1,0,1,2004
Vanja Udovičić,Serbia,0,1,0,1,2004
John Moffitt,United States,0,1,0,1,2004
Aline,Brazil,0,1,0,1,2004
Kanako Kitao,Japan,0,1,0,1,2004
Michael Phelps,United States,8,0,0,8,2008
Chris Hoy,Great Britain,3,0,0,3,2008
Zou Kai,People's Republic of China,3,0,0,3,2008
Steph Rice,Australia,3,0,0,3,2008
Libby Lenton-Trickett,Australia,2,1,1,4,2008
Yang Wei,People's Republic of China,2,1,0,3,2008
Leisel Jones,Australia,2,1,0,3,2008
Aaron Peirsol,United States,2,1,0,3,2008
Matt Grevers,United States,2,1,0,3,2008
Ryan Lochte,United States,2,0,2,4,2008
Kosuke Kitajima,Japan,2,0,1,3,2008
Jason Lezak,United States,2,0,1,3,2008
Guo Jingjing,People's Republic of China,2,0,0,2,2008
Angelo Taylor,United States,2,0,0,2,2008
Bradley Wiggins,Great Britain,2,0,0,2,2008
Li Xiaopeng,People's Republic of China,2,0,0,2,2008
Britta Steffen,Germany,2,0,0,2,2008
Felicity Galvez,Australia,2,0,0,2,2008
Tirunesh Dibaba,Ethiopia,2,0,0,2,2008
Usain Bolt,Jamaica,2,0,0,2,2008
Kenenisa Bekele,Ethiopia,2,0,0,2,2008
Hinrich Romeike,Germany,2,0,0,2,2008
Xiao Qin,People's Republic of China,2,0,0,2,2008
Zhang Yining,People's Republic of China,2,0,0,2,2008
Ma Lin,People's Republic of China,2,0,0,2,2008
Anastasiya Davydova,Russian Federation,2,0,0,2,2008
Anastasiya Yermakova,Russian Federation,2,0,0,2,2008
Chen Yibing,People's Republic of China,2,0,0,2,2008
LaShawn Merritt,United States,2,0,0,2,2008
Becky Adlington,Great Britain,2,0,0,2,2008
Garrett Weber-Gale,United States,2,0,0,2,2008
Chen Ruolin,People's Republic of China,2,0,0,2,2008
He Kexin,People's Republic of China,2,0,0,2,2008
Nastia Liukin,United States,1,3,1,5,2008
Kirsty Coventry,Zimbabwe,1,3,0,4,2008
Shawn Johnson,United States,1,3,0,4,2008
Natalie Coughlin,United States,1,2,3,6,2008
Rebecca Soni,United States,1,2,0,3,2008
Alain Bernard,France,1,1,1,3,2008
Anky van Grunsven,Netherlands,1,1,0,2,2008
Isabell Werth,Germany,1,1,0,2,2008
Joan Llaneras,Spain,1,1,0,2,2008
Lee Hyo-Jeong,Republic of Korea,1,1,0,2,2008
Katalin Kovács,Hungary,1,1,0,2,2008
Natasa Dusev-Janics,Hungary,1,1,0,2,2008
Wang Nan,People's Republic of China,1,1,0,2,2008
Park Seong-Hyeon,Republic of Korea,1,1,0,2,2008
Zhang Juanjuan,People's Republic of China,1,1,0,2,2008
Park Gyeong-Mo,Republic of Korea,1,1,0,2,2008
Park Tae-Hwan,Republic of Korea,1,1,0,2,2008
Fabian Cancellara,Switzerland,1,1,0,2,2008
Kateřina Kůrková-Emmons,Czech Republic,1,1,0,2,2008
Jin Jong-O,Republic of Korea,1,1,0,2,2008
Allyson Felix,United States,1,1,0,2,2008
Jeremy Wariner,United States,1,1,0,2,2008
Fabrice Jeannet,France,1,1,0,2,2008
Wang Hao,People's Republic of China,1,1,0,2,2008
Jason Kenny,Great Britain,1,1,0,2,2008
Richard Thompson,Trinidad and Tobago,1,1,0,2,2008
Kerron Clement,United States,1,1,0,2,2008
Eric Lamaze,Canada,1,1,0,2,2008
Nicolas Lopez,France,1,1,0,2,2008
Jess Schipper,Australia,1,0,2,3,2008
Cheng Fei,People's Republic of China,1,0,2,3,2008
Yang Yilin,People's Republic of China,1,0,2,3,2008
Valentina Vezzali,Italy,1,0,1,2,2008
Viorica Susanu,Romania,1,0,1,2,2008
Tim Brabants,Great Britain,1,0,1,2,2008
Katrin Wagner-Augustin,Germany,1,0,1,2,2008
Georgeta Damian-Andrunache,Romania,1,0,1,2,2008
Wang Liqin,People's Republic of China,1,0,1,2,2008
Peter Vanderkaay,United States,1,0,1,2,2008
Shayne Reese,Australia,1,0,1,2,2008
Sanya Richards-Ross,United States,1,0,1,2,2008
Christine Ohuruogu,Great Britain,1,0,1,2,2008
Raman Piatrushenka,Belarus,1,0,1,2,2008
Vadzim Makhneu,Belarus,1,0,1,2,2008
Mariel Zagunis,United States,1,0,1,2,2008
Heike Kemmer,Germany,1,0,1,2,2008
Beezie Madden,United States,1,0,1,2,2008
Wu Minxia,People's Republic of China,1,0,1,2,2008
Guo Yue,People's Republic of China,1,0,1,2,2008
Yun Ok-Hui,Republic of Korea,1,0,1,2,2008
Mel Schlanger,Australia,1,0,1,2,2008
Yu Yang,People's Republic of China,1,0,1,2,2008
David Neville,United States,1,0,1,2,2008
César Cielo Filho,Brazil,1,0,1,2,2008
Wang Xin,People's Republic of China,1,0,1,2,2008
Qin Kai,People's Republic of China,1,0,1,2,2008
Ken Wallace,Australia,1,0,1,2,2008
Sandra Izbașa,Romania,1,0,1,2,2008
Matteo Tagliariol,Italy,1,0,1,2,2008
Jin Gap-Yong,Republic of Korea,1,0,0,1,2008
Lisa Leslie,United States,1,0,0,1,2008
Elena Kaliská,Slovakia,1,0,0,1,2008
Michal Martikán,Slovakia,1,0,0,1,2008
Peter Thomsen,Germany,1,0,0,1,2008
Juan Esteban Curuchet,Argentina,1,0,0,1,2008
Walter Pérez,Argentina,1,0,0,1,2008
Svetlana Boyko,Russian Federation,1,0,0,1,2008
Tonje Larsen,Norway,1,0,0,1,2008
Duncan Free,Australia,1,0,0,1,2008
Drew Ginn,Australia,1,0,0,1,2008
Rumyana Dzhadzharova-Neykova,Bulgaria,1,0,0,1,2008
Eskild Ebbesen,Denmark,1,0,0,1,2008
Olaf Tufte,Norway,1,0,0,1,2008
Marek Kolbowicz,Poland,1,0,0,1,2008
Adam Korol,Poland,1,0,0,1,2008
David Kostelecký,Czech Republic,1,0,0,1,2008
Fofão,Brazil,1,0,0,1,2008
Lloy Ball,United States,1,0,0,1,2008
Tibor Benedek,Hungary,1,0,0,1,2008
Tamás Kásás,Hungary,1,0,0,1,2008
Buvaysar Saytiyev,Russian Federation,1,0,0,1,2008
Ben Ainslie,Great Britain,1,0,0,1,2008
Jeong Dae-Hyeon,Republic of Korea,1,0,0,1,2008
Kim Dong-Ju,Republic of Korea,1,0,0,1,2008
Lee Seung-Yeop,Republic of Korea,1,0,0,1,2008
Park Jin-Man,Republic of Korea,1,0,0,1,2008
Jason Kidd,United States,1,0,0,1,2008
Maurren Maggi,Brazil,1,0,0,1,2008
Françoise Mbango,Cameroon,1,0,0,1,2008
Yipsi Moreno,Cuba,1,0,0,1,2008
Veronica Campbell-Brown,Jamaica,1,0,0,1,2008
Yelena Isinbayeva,Russian Federation,1,0,0,1,2008
Dominic Seiterle,Canada,1,0,0,1,2008
Primož Kozmus,Slovenia,1,0,0,1,2008
Marc Burns,Trinidad and Tobago,1,0,0,1,2008
DeLisha Milton-Jones,United States,1,0,0,1,2008
Katie Smith,United States,1,0,0,1,2008
Andreas Ihle,Germany,1,0,0,1,2008
Maksim Opalev,Russian Federation,1,0,0,1,2008
Pavol Hochschorner,Slovakia,1,0,0,1,2008
Peter Hochschorner,Slovakia,1,0,0,1,2008
İnna Osipenko-Radomska,Azerbaijan,1,0,0,1,2008
Paul Manning,Great Britain,1,0,0,1,2008
Sabine Spitz,Germany,1,0,0,1,2008
Nadine Capellmann,Germany,1,0,0,1,2008
Andreas Dibowski,Germany,1,0,0,1,2008
Ingrid Klimke,Germany,1,0,0,1,2008
Laura Kraut,United States,1,0,0,1,2008
Julien Pillet,France,1,0,0,1,2008
Christie Pearce-Rampone,United States,1,0,0,1,2008
Kate Sobrero-Markgraf,United States,1,0,0,1,2008
Huang Xu,People's Republic of China,1,0,0,1,2008
Else-Marthe Sørlie Lybekk,Norway,1,0,0,1,2008
Cédric Burdet,France,1,0,0,1,2008
Didier Dinart,France,1,0,0,1,2008
Jérôme Fernandez,France,1,0,0,1,2008
Bertrand Gille,France,1,0,0,1,2008
Guillaume Gille,France,1,0,0,1,2008
Olivier Girault,France,1,0,0,1,2008
Leszek Blanik,Poland,1,0,0,1,2008
Tibor Weißenborn,Germany,1,0,0,1,2008
Matthias Witthaus,Germany,1,0,0,1,2008
Minke Booij,Netherlands,1,0,0,1,2008
Fátima Moreira de Melo,Netherlands,1,0,0,1,2008
Minke Smabers,Netherlands,1,0,0,1,2008
Marilyn Agliotti,Netherlands,1,0,0,1,2008
Masae Ueno,Japan,1,0,0,1,2008
Thomas Ebert,Denmark,1,0,0,1,2008
Kirsten van der Kolk,Netherlands,1,0,0,1,2008
Marit van Eupen,Netherlands,1,0,0,1,2008
Jake Wetzel,Canada,1,0,0,1,2008
Iain Percy,Great Britain,1,0,0,1,2008
Abhinav Bindra,India,1,0,0,1,2008
Artur Aivazian,Ukraine,1,0,0,1,2008
Glenn Eller,United States,1,0,0,1,2008
Tarnee White,Australia,1,0,0,1,2008
Manon van Rooijen,Netherlands,1,0,0,1,2008
Oussama Mellouli,Tunisia,1,0,0,1,2008
Ian Crocker,United States,1,0,0,1,2008
Klete Keller,United States,1,0,0,1,2008
Erik Vendt,United States,1,0,0,1,2008
Hadi Saei,Islamic Republic of Iran,1,0,0,1,2008
Yelena Dementyeva,Russian Federation,1,0,0,1,2008
Roger Federer,Switzerland,1,0,0,1,2008
Misty May-Treanor,United States,1,0,0,1,2008
Serena Williams,United States,1,0,0,1,2008
Venus Williams,United States,1,0,0,1,2008
Walewska,Brazil,1,0,0,1,2008
Kerri Walsh Jennings,United States,1,0,0,1,2008
Péter Biros,Hungary,1,0,0,1,2008
Gergő Kiss,Hungary,1,0,0,1,2008
Tamás Molnár,Hungary,1,0,0,1,2008
Zoltán Szécsi,Hungary,1,0,0,1,2008
Daniëlle de Bruijn,Netherlands,1,0,0,1,2008
Gillian van den Berg,Netherlands,1,0,0,1,2008
Zhang Xiangxiang,People's Republic of China,1,0,0,1,2008
Szymon Kołecki,Poland,1,0,0,1,2008
Tom Hoff,United States,1,0,0,1,2008
Ryan Millar,United States,1,0,0,1,2008
István Gergely,Hungary,1,0,0,1,2008
Shannon Boxx,United States,1,0,0,1,2008
Aly Wagner,United States,1,0,0,1,2008
Angela Hucles,United States,1,0,0,1,2008
Lindsay Tarpley,United States,1,0,0,1,2008
Javier Mascherano,Argentina,1,0,0,1,2008
Im Dong-Hyeon,Republic of Korea,1,0,0,1,2008
Viktor Ruban,Ukraine,1,0,0,1,2008
Heather Mitts,United States,1,0,0,1,2008
Heather O'Reilly,United States,1,0,0,1,2008
Sue Bird,United States,1,0,0,1,2008
Tamika Catchings,United States,1,0,0,1,2008
Tina Thompson,United States,1,0,0,1,2008
Diana Taurasi,United States,1,0,0,1,2008
Mark Gangloff,United States,1,0,0,1,2008
Brendan Hansen,United States,1,0,0,1,2008
Federica Pellegrini,Italy,1,0,0,1,2008
Inge Dekker,Netherlands,1,0,0,1,2008
Marleen Veldhuis,Netherlands,1,0,0,1,2008
Linda MacKenzie,Australia,1,0,0,1,2008
Chen Wei-Ling,Chinese Taipei,1,0,0,1,2008
Chen Yanqing,People's Republic of China,1,0,0,1,2008
Pak Hyon-Suk,Democratic People's Republic of Korea,1,0,0,1,2008
Nicole Cooke,Great Britain,1,0,0,1,2008
Kristin Armstrong,United States,1,0,0,1,2008
Tomasz Majewski,Poland,1,0,0,1,2008
Valerie Adams-Vili,New Zealand,1,0,0,1,2008
Yin Jian,People's Republic of China,1,0,0,1,2008
Sarah Webb,Great Britain,1,0,0,1,2008
Sarah Ayton,Great Britain,1,0,0,1,2008
Tom Ashley,New Zealand,1,0,0,1,2008
Nathan Wilmot,Australia,1,0,0,1,2008
Malcolm Page,Australia,1,0,0,1,2008
Paul Goodison,Great Britain,1,0,0,1,2008
Georgina Evers-Swindell,New Zealand,1,0,0,1,2008
Caroline Evers-Swindell,New Zealand,1,0,0,1,2008
Rebecca Romero,Great Britain,1,0,0,1,2008
Caryn Davies,United States,1,0,0,1,2008
Anna Mickelson-Cummins,United States,1,0,0,1,2008
Mary Whipple,United States,1,0,0,1,2008
Jin Ziwei,People's Republic of China,1,0,0,1,2008
Michał Jeliński,Poland,1,0,0,1,2008
Steve Williams,Great Britain,1,0,0,1,2008
Mark Hunter,Great Britain,1,0,0,1,2008
Scott Brennan,Australia,1,0,0,1,2008
David Crawshay,Australia,1,0,0,1,2008
Kevin Light,Canada,1,0,0,1,2008
Ben Rutledge,Canada,1,0,0,1,2008
Kyle Hamilton,Canada,1,0,0,1,2008
Adam Kreek,Canada,1,0,0,1,2008
Brian Price,Canada,1,0,0,1,2008
Andy Triggs Hodge,Great Britain,1,0,0,1,2008
Fernando Echavarri,Spain,1,0,0,1,2008
Antón Paz,Spain,1,0,0,1,2008
Jang Mi-Ran,Republic of Korea,1,0,0,1,2008
Matthias Steiner,Austria,1,0,0,1,2008
Du Li,People's Republic of China,1,0,0,1,2008
Chen Ying,People's Republic of China,1,0,0,1,2008
Chiara Càinero,Italy,1,0,0,1,2008
Nataliya Dobrynska,Ukraine,1,0,0,1,2008
Kim Gevaert,Belgium,1,0,0,1,2008
Stephanie Brown-Trafton,United States,1,0,0,1,2008
Gulnara Samitova-Galkina,Russian Federation,1,0,0,1,2008
Aliaksei Abalmasau,Belarus,1,0,0,1,2008
Carlos Pérez,Spain,1,0,0,1,2008
Attila Vajda,Hungary,1,0,0,1,2008
Meng Guanliang,People's Republic of China,1,0,0,1,2008
Yang Wenjun,People's Republic of China,1,0,0,1,2008
Aliaksandr Bahdanovich,Belarus,1,0,0,1,2008
Constantina Diță-Tomescu,Romania,1,0,0,1,2008
Nelson Évora,Portugal,1,0,0,1,2008
Gerd Kanter,Estonia,1,0,0,1,2008
Brimin Kipruto,Kenya,1,0,0,1,2008
Bryan Clay,United States,1,0,0,1,2008
Lin Dan,People's Republic of China,1,0,0,1,2008
Zhang Ning,People's Republic of China,1,0,0,1,2008
Britta Heidemann,Germany,1,0,0,1,2008
Jérôme Jeannet,France,1,0,0,1,2008
Zou Shiming,People's Republic of China,1,0,0,1,2008
Somjit Jongjohor,Thailand,1,0,0,1,2008
Aleksey Tishchenko,Russian Federation,1,0,0,1,2008
Félix Díaz,Dominican Republic,1,0,0,1,2008
Roberto Cammarelle,Italy,1,0,0,1,2008
Alina Dumitru,Romania,1,0,0,1,2008
Xian Dongmei,People's Republic of China,1,0,0,1,2008
Ayumi Tanimoto,Japan,1,0,0,1,2008
Barbora Špotáková,Czech Republic,1,0,0,1,2008
Steve Hooker,Australia,1,0,0,1,2008
Wilfred Bungei,Kenya,1,0,0,1,2008
Choi Min-Ho,Republic of Korea,1,0,0,1,2008
Masato Uchishiba,Japan,1,0,0,1,2008
Vicki Pendleton,Great Britain,1,0,0,1,2008
Jamie Staff,Great Britain,1,0,0,1,2008
Frank Ostholt,Germany,1,0,0,1,2008
McLain Ward,United States,1,0,0,1,2008
Andreas Thorkildsen,Norway,1,0,0,1,2008
Tia Hellebaut,Belgium,1,0,0,1,2008
Élodie Ouédraogo,Belgium,1,0,0,1,2008
Rafael Nadal,Spain,1,0,0,1,2008
Andrey Moiseyev,Russian Federation,1,0,0,1,2008
Saori Yoshida,Japan,1,0,0,1,2008
Kaori Icho,Japan,1,0,0,1,2008
Manuchar K'virk'velia,Georgia,1,0,0,1,2008
Mijaín López,Cuba,1,0,0,1,2008
Andrea Minguzzi,Italy,1,0,0,1,2008
Mariya Gromova,Russian Federation,1,0,0,1,2008
Anna Shorina,Russian Federation,1,0,0,1,2008
Monique Henderson,United States,1,0,0,1,2008
Yelena Posevina,Russian Federation,1,0,0,1,2008
Wang Feng,People's Republic of China,1,0,0,1,2008
Julien Absalon,France,1,0,0,1,2008
Mavlet Batyrov,Russian Federation,1,0,0,1,2008
Revaz Mindorashvili,Georgia,1,0,0,1,2008
Hwang Gyeong-Seon,Republic of Korea,1,0,0,1,2008
Tom James,Great Britain,1,0,0,1,2008
Carmelo Anthony,United States,1,0,0,1,2008
Carlos Boozer,United States,1,0,0,1,2008
LeBron James,United States,1,0,0,1,2008
"Dwyane Wade, Jr.",United States,1,0,0,1,2008
Joël Abati,France,1,0,0,1,2008
Michaël Guigou,France,1,0,0,1,2008
Nikola Karabatic,France,1,0,0,1,2008
Daniel Narcisse,France,1,0,0,1,2008
Thierry Omeyer,France,1,0,0,1,2008
Eefke Mulder,Netherlands,1,0,0,1,2008
Janneke Schopman,Netherlands,1,0,0,1,2008
Lisanne de Roever,Netherlands,1,0,0,1,2008
Miek van Geenhuizen,Netherlands,1,0,0,1,2008
Sebastian Biederlack,Germany,1,0,0,1,2008
Timo Weß,Germany,1,0,0,1,2008
Christopher Zeller,Germany,1,0,0,1,2008
Masumi Mishina,Japan,1,0,0,1,2008
Hiroko Sakai,Japan,1,0,0,1,2008
Rie Sato,Japan,1,0,0,1,2008
Yukiko Ueno,Japan,1,0,0,1,2008
Eri Yamada,Japan,1,0,0,1,2008
Fabiana,Brazil,1,0,0,1,2008
Sassá,Brazil,1,0,0,1,2008
Valeskinha,Brazil,1,0,0,1,2008
Mari,Brazil,1,0,0,1,2008
Gabe Gardner,United States,1,0,0,1,2008
Reid Priddy,United States,1,0,0,1,2008
Riley Salmon,United States,1,0,0,1,2008
Clay Stanley,United States,1,0,0,1,2008
Tamás Varga,Hungary,1,0,0,1,2008
Norbert Madaras,Hungary,1,0,0,1,2008
Nancy Langat,Kenya,1,0,0,1,2008
Irving Saladino,Panama,1,0,0,1,2008
Elvira Khasyanova,Russian Federation,1,0,0,1,2008
Hope Solo,United States,1,0,0,1,2008
Tasha Kai,United States,1,0,0,1,2008
Carli Lloyd,United States,1,0,0,1,2008
Lori Chalupny,United States,1,0,0,1,2008
Stephanie Cox,United States,1,0,0,1,2008
Tobin Heath,United States,1,0,0,1,2008
Amy Rodriguez,United States,1,0,0,1,2008
Óscar Ustari,Argentina,1,0,0,1,2008
Ezequiel Garay,Argentina,1,0,0,1,2008
Fabián Monzón,Argentina,1,0,0,1,2008
Pablo Zabaleta,Argentina,1,0,0,1,2008
Nicolás Pareja,Argentina,1,0,0,1,2008
Fernando Gago,Argentina,1,0,0,1,2008
Juan Riquelme,Argentina,1,0,0,1,2008
Ezequiel Lavezzi,Argentina,1,0,0,1,2008
Lionel Messi,Argentina,1,0,0,1,2008
Sergio Agüero,Argentina,1,0,0,1,2008
José Sosa,Argentina,1,0,0,1,2008
Ángel Di María,Argentina,1,0,0,1,2008
Lautaro Acosta,Argentina,1,0,0,1,2008
Ju Hyeon-Jeong,Republic of Korea,1,0,0,1,2008
Lee Chang-Hwan,Republic of Korea,1,0,0,1,2008
Rachel Buehler,United States,1,0,0,1,2008
Samuel Sánchez,Spain,1,0,0,1,2008
Pippa Wilson,Great Britain,1,0,0,1,2008
Pang Wei,People's Republic of China,1,0,0,1,2008
Sylvia Fowles,United States,1,0,0,1,2008
Cappie Pondexter,United States,1,0,0,1,2008
Seimone Augustus,United States,1,0,0,1,2008
Candace Parker,United States,1,0,0,1,2008
Kara Lawson,United States,1,0,0,1,2008
Kari Aalvik Grimsbø,Norway,1,0,0,1,2008
Katrine Lunde-Haraldsen,Norway,1,0,0,1,2008
Katja Nyberg,Norway,1,0,0,1,2008
Ragnhild Aamodt,Norway,1,0,0,1,2008
Gøril Snorroeggen,Norway,1,0,0,1,2008
Tonje Nøstvold,Norway,1,0,0,1,2008
Karoline Dyhre Breivang,Norway,1,0,0,1,2008
Kristine Lunde-Borgersen,Norway,1,0,0,1,2008
Gro Hammerseng,Norway,1,0,0,1,2008
Kari Mette Johansen,Norway,1,0,0,1,2008
Marit Malm Frafjord,Norway,1,0,0,1,2008
Linn-Kristin Riegelhuth Koren,Norway,1,0,0,1,2008
Paula,Brazil,1,0,0,1,2008
Thaísa,Brazil,1,0,0,1,2008
Jaque,Brazil,1,0,0,1,2008
Sheilla,Brazil,1,0,0,1,2008
Fabi,Brazil,1,0,0,1,2008
James DeGale,Great Britain,1,0,0,1,2008
Zhang Xiaoping,People's Republic of China,1,0,0,1,2008
Ranomi Kromowidjojo,Netherlands,1,0,0,1,2008
Hinkelien Schreuder,Netherlands,1,0,0,1,2008
Femke Heemskerk,Netherlands,1,0,0,1,2008
Pete Reed,Great Britain,1,0,0,1,2008
Phil Dalhausser,United States,1,0,0,1,2008
Todd Rogers,United States,1,0,0,1,2008
Olena Khomrova,Ukraine,1,0,0,1,2008
Olha Kharlan,Ukraine,1,0,0,1,2008
Halyna Pundyk,Ukraine,1,0,0,1,2008
Yang Xiuli,People's Republic of China,1,0,0,1,2008
Tong Wen,People's Republic of China,1,0,0,1,2008
Giulia Quintavalle,Italy,1,0,0,1,2008
Elnur Məmmədli,Azerbaijan,1,0,0,1,2008
Irakli Tsirekidze,Georgia,1,0,0,1,2008
Ole Bischof,Germany,1,0,0,1,2008
Satoshi Ishii,Japan,1,0,0,1,2008
Naidangiin Tüvshinbayar,Mongolia,1,0,0,1,2008
Du Jing,People's Republic of China,1,0,0,1,2008
Markis Kido,Indonesia,1,0,0,1,2008
Hendra Setiawan,Indonesia,1,0,0,1,2008
Lee Yong-Dae,Republic of Korea,1,0,0,1,2008
Bakhyt Sarsekbayev,Kazakhstan,1,0,0,1,2008
Vasyl Lomachenko,Ukraine,1,0,0,1,2008
Enkhbatyn Badar-Uugan,Mongolia,1,0,0,1,2008
Rakhim Chakhkiyev,Russian Federation,1,0,0,1,2008
Marianne Vos,Netherlands,1,0,0,1,2008
Anne-Caroline Chausson,France,1,0,0,1,2008
Ed Clancy,Great Britain,1,0,0,1,2008
Geraint Thomas,Great Britain,1,0,0,1,2008
Māris Štrombergs,Latvia,1,0,0,1,2008
Bong Jung-Geun,Republic of Korea,1,0,0,1,2008
Han Gi-Ju,Republic of Korea,1,0,0,1,2008
Jang Won-Sam,Republic of Korea,1,0,0,1,2008
Jeong Geun-U,Republic of Korea,1,0,0,1,2008
Gang Min-Ho,Republic of Korea,1,0,0,1,2008
Kim Hyeon-Su,Republic of Korea,1,0,0,1,2008
Kim Gwang-Hyeon,Republic of Korea,1,0,0,1,2008
Kim Min-Jae,Republic of Korea,1,0,0,1,2008
Go Yeong-Min,Republic of Korea,1,0,0,1,2008
Gwon Hyeok,Republic of Korea,1,0,0,1,2008
Lee Dae-Ho,Republic of Korea,1,0,0,1,2008
Lee Jong-Uk,Republic of Korea,1,0,0,1,2008
Lee Jin-Yeong,Republic of Korea,1,0,0,1,2008
Lee Taek-Geun,Republic of Korea,1,0,0,1,2008
Lee Yong-Gyu,Republic of Korea,1,0,0,1,2008
Oh Seung-Hwan,Republic of Korea,1,0,0,1,2008
Ryu Hyeon-Jin,Republic of Korea,1,0,0,1,2008
Song Seung-Jun,Republic of Korea,1,0,0,1,2008
Yun Seok-Min,Republic of Korea,1,0,0,1,2008
Naho Emoto,Japan,1,0,0,1,2008
Motoko Fujimoto,Japan,1,0,0,1,2008
Megu Hirose,Japan,1,0,0,1,2008
Emi Inui,Japan,1,0,0,1,2008
Sachiko Ito,Japan,1,0,0,1,2008
Ayumi Karino,Japan,1,0,0,1,2008
Satoko Mabuchi,Japan,1,0,0,1,2008
Yukiyo Mine,Japan,1,0,0,1,2008
Rei Nishiyama,Japan,1,0,0,1,2008
Mika Someya,Japan,1,0,0,1,2008
Kobe Bryant,United States,1,0,0,1,2008
Dwight Howard,United States,1,0,0,1,2008
Chris Bosh,United States,1,0,0,1,2008
Chris Paul,United States,1,0,0,1,2008
Deron Williams,United States,1,0,0,1,2008
Tayshaun Prince,United States,1,0,0,1,2008
Michael Redd,United States,1,0,0,1,2008
Federico Fazio,Argentina,1,0,0,1,2008
Éver Banega,Argentina,1,0,0,1,2008
Diego Buonanotte,Argentina,1,0,0,1,2008
Sergio Romero,Argentina,1,0,0,1,2008
Lauren Cheney,United States,1,0,0,1,2008
Cédric Paty,France,1,0,0,1,2008
Luc Abalo,France,1,0,0,1,2008
Daouda Karaboué,France,1,0,0,1,2008
Christophe Kempé,France,1,0,0,1,2008
Max Weinhold,Germany,1,0,0,1,2008
Tobias Hauke,Germany,1,0,0,1,2008
Max Müller,Germany,1,0,0,1,2008
Niklas Meinert,Germany,1,0,0,1,2008
Carlos Nevado,Germany,1,0,0,1,2008
Florian Keller,Germany,1,0,0,1,2008
Benjamin Weß,Germany,1,0,0,1,2008
Philipp Zeller,Germany,1,0,0,1,2008
Philip Witte,Germany,1,0,0,1,2008
Moritz Fürste,Germany,1,0,0,1,2008
Jan-Marco Montag,Germany,1,0,0,1,2008
Oliver Korn,Germany,1,0,0,1,2008
Maartje Goderie,Netherlands,1,0,0,1,2008
Maartje Paumen,Netherlands,1,0,0,1,2008
Naomi van As,Netherlands,1,0,0,1,2008
Wieke Dijkstra,Netherlands,1,0,0,1,2008
Sophie Polkamp,Netherlands,1,0,0,1,2008
Ellen Hoog,Netherlands,1,0,0,1,2008
Lidewij Welten,Netherlands,1,0,0,1,2008
Eva de Goede,Netherlands,1,0,0,1,2008
Rianne Guichelaar,Netherlands,1,0,0,1,2008
Simone Koot,Netherlands,1,0,0,1,2008
Iefke van Belkum,Netherlands,1,0,0,1,2008
Mieke Cabout,Netherlands,1,0,0,1,2008
Yasemin Smit,Netherlands,1,0,0,1,2008
Noeki Klein,Netherlands,1,0,0,1,2008
Biurakn Hakhverdian,Netherlands,1,0,0,1,2008
Ilse van der Meijden,Netherlands,1,0,0,1,2008
Alette Sijbring,Netherlands,1,0,0,1,2008
Marieke van den Ham,Netherlands,1,0,0,1,2008
Dániel Varga,Hungary,1,0,0,1,2008
Gábor Kis,Hungary,1,0,0,1,2008
Norbert Hosnyánszky,Hungary,1,0,0,1,2008
Dénes Varga,Hungary,1,0,0,1,2008
Carol,Brazil,1,0,0,1,2008
Kevin Hansen,United States,1,0,0,1,2008
David Lee,United States,1,0,0,1,2008
Sean Rooney,United States,1,0,0,1,2008
Scott Touzinsky,United States,1,0,0,1,2008
Rich Lambourne,United States,1,0,0,1,2008
Pamela Jelimo,Kenya,1,0,0,1,2008
Asbel Kiprop,Kenya,1,0,0,1,2008
Valery Borchin,Russian Federation,1,0,0,1,2008
Shelly-Ann Fraser-Pryce,Jamaica,1,0,0,1,2008
Mary Wineberg,United States,1,0,0,1,2008
Dawn Harper,United States,1,0,0,1,2008
Melaine Walker,Jamaica,1,0,0,1,2008
Andrey Silnov,Russian Federation,1,0,0,1,2008
Aaron Armstrong,Trinidad and Tobago,1,0,0,1,2008
Dayron Robles,Cuba,1,0,0,1,2008
Olivia Borlée,Belgium,1,0,0,1,2008
Hanna Mariën,Belgium,1,0,0,1,2008
Natasha Hastings,United States,1,0,0,1,2008
Alex Schwazer,Italy,1,0,0,1,2008
Sammy Wanjiru,Kenya,1,0,0,1,2008
Keston Bledman,Trinidad and Tobago,1,0,0,1,2008
Regi Witherspoon,United States,1,0,0,1,2008
Emmanuel Callender,Trinidad and Tobago,1,0,0,1,2008
Nathan Adrian,United States,1,0,0,1,2008
Cullen Jones,United States,1,0,0,1,2008
Ben Wildman-Tobriner,United States,1,0,0,1,2008
Emily Seebohm,Australia,1,0,0,1,2008
Bronte Barratt,Australia,1,0,0,1,2008
Liu Zige,People's Republic of China,1,0,0,1,2008
Dave Walters,United States,1,0,0,1,2008
Ricky Berens,United States,1,0,0,1,2008
Maarten van der Weijden,Netherlands,1,0,0,1,2008
Kylie Palmer,Australia,1,0,0,1,2008
Lara Ilchenko,Russian Federation,1,0,0,1,2008
Lin Yue,People's Republic of China,1,0,0,1,2008
Huo Liang,People's Republic of China,1,0,0,1,2008
He Chong,People's Republic of China,1,0,0,1,2008
Matt Mitcham,Australia,1,0,0,1,2008
Nataliya Ishchenko,Russian Federation,1,0,0,1,2008
Olga Kuzhela,Russian Federation,1,0,0,1,2008
Yelena Ovchinnikova,Russian Federation,1,0,0,1,2008
Svetlana Romashina,Russian Federation,1,0,0,1,2008
Emma Snowsill,Australia,1,0,0,1,2008
Jan Frodeno,Germany,1,0,0,1,2008
Prapawadee Jaroenrattanatarakoon,Thailand,1,0,0,1,2008
Oksana Slivenko,Russian Federation,1,0,0,1,2008
Alla Vazhenina,Kazakhstan,1,0,0,1,2008
Long Qingquan,People's Republic of China,1,0,0,1,2008
Liao Hui,People's Republic of China,1,0,0,1,2008
Sa Jae-Hyeok,Republic of Korea,1,0,0,1,2008
Lu Yong,People's Republic of China,1,0,0,1,2008
Andrei Aramnau,Belarus,1,0,0,1,2008
Lena Schöneborn,Germany,1,0,0,1,2008
Alexander Grimm,Germany,1,0,0,1,2008
Andrei Bahdanovich,Belarus,1,0,0,1,2008
Martin Hollstein,Germany,1,0,0,1,2008
Artur Litvinchuk,Belarus,1,0,0,1,2008
Saúl Craviotto,Spain,1,0,0,1,2008
Fanny Fischer,Germany,1,0,0,1,2008
Nicole Reinhardt,Germany,1,0,0,1,2008
Conny Waßmuth,Germany,1,0,0,1,2008
Will Simpson,United States,1,0,0,1,2008
Angie Bainbridge,Australia,1,0,0,1,2008
Lara Davenport,Australia,1,0,0,1,2008
He Wenna,People's Republic of China,1,0,0,1,2008
Lu Chunlong,People's Republic of China,1,0,0,1,2008
Yevgeniya Kanayeva,Russian Federation,1,0,0,1,2008
Margarita Aliychuk,Russian Federation,1,0,0,1,2008
Anna Gavrilenko,Russian Federation,1,0,0,1,2008
Tatyana Gorbunova,Russian Federation,1,0,0,1,2008
Darya Shkurikhina,Russian Federation,1,0,0,1,2008
Nataliya Zuyeva,Russian Federation,1,0,0,1,2008
Olga Kaniskina,Russian Federation,1,0,0,1,2008
Carol Huynh,Canada,1,0,0,1,2008
Wang Jiao,People's Republic of China,1,0,0,1,2008
Henry Cejudo,United States,1,0,0,1,2008
Ramazan Şahin,Turkey,1,0,0,1,2008
Shirvani Muradov,Russian Federation,1,0,0,1,2008
Bakhtiyar Akhmedov,Russian Federation,1,0,0,1,2008
Nazyr Mankiyev,Russian Federation,1,0,0,1,2008
Islam-Beka Albiyev,Russian Federation,1,0,0,1,2008
Steeve Guénot,France,1,0,0,1,2008
Aslanbek Khushtov,Russian Federation,1,0,0,1,2008
Guo Wenjun,People's Republic of China,1,0,0,1,2008
Satu Mäkelä-Nummela,Finland,1,0,0,1,2008
Qiu Jian,People's Republic of China,1,0,0,1,2008
Vincent Hancock,United States,1,0,0,1,2008
Oleksandr Petriv,Ukraine,1,0,0,1,2008
Wu Jingyu,People's Republic of China,1,0,0,1,2008
Im Su-Jeong,Republic of Korea,1,0,0,1,2008
María Espinoza,Mexico,1,0,0,1,2008
Guillermo Pérez,Mexico,1,0,0,1,2008
Son Tae-Jin,Republic of Korea,1,0,0,1,2008
Cha Dong-Min,Republic of Korea,1,0,0,1,2008
Stanislas Wawrinka,Switzerland,1,0,0,1,2008
Jiang Yuyuan,People's Republic of China,1,0,0,1,2008
Li Shanshan,People's Republic of China,1,0,0,1,2008
Deng Linlin,People's Republic of China,1,0,0,1,2008
Hong Un-Jong,Democratic People's Republic of Korea,1,0,0,1,2008
Elise Rechichi,Australia,1,0,0,1,2008
Tessa Parkinson,Australia,1,0,0,1,2008
Anna Tunnicliffe,United States,1,0,0,1,2008
Jonas Warrer,Denmark,1,0,0,1,2008
Martin Kirketerp,Denmark,1,0,0,1,2008
Andrew Simpson,Great Britain,1,0,0,1,2008
Tang Bin,People's Republic of China,1,0,0,1,2008
Xi Aihua,People's Republic of China,1,0,0,1,2008
Zhang Yangyang,People's Republic of China,1,0,0,1,2008
Erin Cafaro,United States,1,0,0,1,2008
Lindsay Shoop,United States,1,0,0,1,2008
Anna Goodale,United States,1,0,0,1,2008
Elle Logan,United States,1,0,0,1,2008
Susan Francia,United States,1,0,0,1,2008
Caroline Lind,United States,1,0,0,1,2008
Zac Purchase,Great Britain,1,0,0,1,2008
Konrad Wasielewski,Poland,1,0,0,1,2008
Morten Jørgensen,Denmark,1,0,0,1,2008
Mads Andersen,Denmark,1,0,0,1,2008
Andrew Byrnes,Canada,1,0,0,1,2008
Malcolm Howard,Canada,1,0,0,1,2008
Olha Zhovnir,Ukraine,1,0,0,1,2008
Yevgeniya Lamonova,Russian Federation,1,0,0,1,2008
Aida Shanayeva,Russian Federation,1,0,0,1,2008
Viktoriya Nikishina,Russian Federation,1,0,0,1,2008
Benjamin Kleibrink,Germany,1,0,0,1,2008
Ulrich Robeiri,France,1,0,0,1,2008
Zhong Man,People's Republic of China,1,0,0,1,2008
Boris Sanson,France,1,0,0,1,2008
Dara Torres,United States,0,3,0,3,2008
László Cseh,Hungary,0,3,0,3,2008
Eamon Sullivan,Australia,0,2,1,3,2008
Margaret Hoelzer,United States,0,2,1,3,2008
Yuliya Pakhalina,Russian Federation,0,2,0,2,2008
Gemma Mengual,Spain,0,2,0,2,2008
Kara Lynn Joyce,United States,0,2,0,2,2008
Amaury Leveaux,France,0,2,0,2,2008
David Cal,Spain,0,2,0,2,2008
Andrea Fuentes,Spain,0,2,0,2,2008
Kohei Uchimura,Japan,0,2,0,2,2008
Brenton Rickard,Australia,0,2,0,2,2008
Christine Magnuson,United States,0,2,0,2,2008
Shericka Williams,Jamaica,0,2,0,2,2008
Katie Hoff,United States,0,1,2,3,2008
Pang Jiaying,People's Republic of China,0,1,2,3,2008
Andrew Lauterstein,Australia,0,1,2,3,2008
Christian Gille,Germany,0,1,1,2,2008
Grant Hackett,Australia,0,1,1,2,2008
Tomasz Wylenzek,Germany,0,1,1,2,2008
Sada Jacobson,United States,0,1,1,2,2008
Mickaël Bourgain,France,0,1,1,2,2008
Hayden Roulston,New Zealand,0,1,1,2,2008
Jonathan Horton,United States,0,1,1,2,2008
Julia Smit,United States,0,1,1,2,2008
Jared Tallent,Australia,0,1,1,2,2008
Kerron Stewart,Jamaica,0,1,1,2,2008
Hayden Stoeckel,Australia,0,1,1,2,2008
Matt Targett,Australia,0,1,1,2,2008
Laura Berg,United States,0,1,0,1,2008
Pedro Luis Lazo,Cuba,0,1,0,1,2008
Eduardo Paret,Cuba,0,1,0,1,2008
Ilario Di Buò,Italy,0,1,0,1,2008
Vivi Ruano,Spain,0,1,0,1,2008
Josefa Idem-Guerrini,Italy,0,1,0,1,2008
Aneta Pastuszka-Konieczna,Poland,0,1,0,1,2008
Aleksandr Kostoglod,Russian Federation,0,1,0,1,2008
Rolf-Göran Bengtsson,Sweden,0,1,0,1,2008
Mac Cone,Canada,0,1,0,1,2008
Ian Millar,Canada,0,1,0,1,2008
Pol Amat,Spain,0,1,0,1,2008
Pretinha,Brazil,0,1,0,1,2008
Formiga,Brazil,0,1,0,1,2008
Tânia Maranhão,Brazil,0,1,0,1,2008
Oksana Chusovitina,Germany,0,1,0,1,2008
Jüri Jaanson,Estonia,0,1,0,1,2008
Vasilios Polymeros,Greece,0,1,0,1,2008
Rossano Galtarossa,Italy,0,1,0,1,2008
Tan Zongliang,People's Republic of China,0,1,0,1,2008
Ralf Schumann,East Germany,0,1,0,1,2008
Giovanni Pellielo,Italy,0,1,0,1,2008
Otryadyn Gündegmaa,Mongolia,0,1,0,1,2008
Kim Rhode,United States,0,1,0,1,2008
Dmitry Sautin,Russian Federation,0,1,0,1,2008
Danielle Scott-Arruda,United States,0,1,0,1,2008
Alessandra Sensini,Italy,0,1,0,1,2008
Robert Scheidt,Brazil,0,1,0,1,2008
Jefferson Pérez,Ecuador,0,1,0,1,2008
Nobuharu Asahara,Japan,0,1,0,1,2008
Olena Antonova,Ukraine,0,1,0,1,2008
Kristi Harrower,Australia,0,1,0,1,2008
Lauren Jackson,Australia,0,1,0,1,2008
Chris Brown,The Bahamas,0,1,0,1,2008
Avard Moncur,The Bahamas,0,1,0,1,2008
Blanka Vlašić,Croatia,0,1,0,1,2008
Phillips Idowu,Great Britain,0,1,0,1,2008
Shingo Suetsugu,Japan,0,1,0,1,2008
Kjersti Tysse-Plätzer,Norway,0,1,0,1,2008
Dave Calder,Canada,0,1,0,1,2008
Lee Gyeong-Won,Republic of Korea,0,1,0,1,2008
Rolando Meriño,Cuba,0,1,0,1,2008
Ariel Pestano,Cuba,0,1,0,1,2008
Norge Luis Vera,Cuba,0,1,0,1,2008
Jorge Garbajosa,Spain,0,1,0,1,2008
Carlos Jiménez,Spain,0,1,0,1,2008
Raúl López,Spain,0,1,0,1,2008
Juan Carlos Navarro,Spain,0,1,0,1,2008
Ondřej Štěpánek,Czech Republic,0,1,0,1,2008
Jaroslav Volf,Czech Republic,0,1,0,1,2008
Ronny Rauhe,Germany,0,1,0,1,2008
Tim Wieskötter,Germany,0,1,0,1,2008
Eirik Verås Larsen,Norway,0,1,0,1,2008
Michal Riszdorfer,Slovakia,0,1,0,1,2008
Richard Riszdorfer,Slovakia,0,1,0,1,2008
Juraj Tarr,Slovakia,0,1,0,1,2008
Erik Vlček,Slovakia,0,1,0,1,2008
Yoanka González,Cuba,0,1,0,1,2008
Toni Tauler,Spain,0,1,0,1,2008
Arnaud Tournant,France,0,1,0,1,2008
Alexandre Despatie,Canada,0,1,0,1,2008
Emilie Heymans,Canada,0,1,0,1,2008
Keeth Smart,United States,0,1,0,1,2008
Andréia,Brazil,0,1,0,1,2008
Daniela,Brazil,0,1,0,1,2008
Maycon,Brazil,0,1,0,1,2008
Rosana,Brazil,0,1,0,1,2008
Simone,Brazil,0,1,0,1,2008
Karen Cockburn,Canada,0,1,0,1,2008
Gervasio Deferr,Spain,0,1,0,1,2008
Kiko Fábregas,Spain,0,1,0,1,2008
Rodrigo Garza,Spain,0,1,0,1,2008
Xavier Ribas,Spain,0,1,0,1,2008
Eddie Tubau,Spain,0,1,0,1,2008
Chen Zhaoxia,People's Republic of China,0,1,0,1,2008
Cheng Hui,People's Republic of China,0,1,0,1,2008
Huang Junxia,People's Republic of China,0,1,0,1,2008
Tang Chunling,People's Republic of China,0,1,0,1,2008
Zhou Wanfeng,People's Republic of China,0,1,0,1,2008
Askhat Zhitkeyev,Kazakhstan,0,1,0,1,2008
Deborah Gravenstijn,Netherlands,0,1,0,1,2008
Abdullo Tangriyev,Uzbekistan,0,1,0,1,2008
Katherine Grainger,Great Britain,0,1,0,1,2008
Frances Houghton,Great Britain,0,1,0,1,2008
Simone Raineri,Italy,0,1,0,1,2008
Femke Dekker,Netherlands,0,1,0,1,2008
Darren Bundock,Australia,0,1,0,1,2008
Nick Rogers,Great Britain,0,1,0,1,2008
Joe Glanfield,Great Britain,0,1,0,1,2008
Vasilij Žbogar,Slovenia,0,1,0,1,2008
Lyubov Galkina,Russian Federation,0,1,0,1,2008
Crystl Bustos,United States,0,1,0,1,2008
Stacey Nuveman,United States,0,1,0,1,2008
Adam Pine,Australia,0,1,0,1,2008
Yang Yu,People's Republic of China,0,1,0,1,2008
Fréd Bousquet,France,0,1,0,1,2008
Megan Quann-Jendrick,United States,0,1,0,1,2008
Paola Tirados,Spain,0,1,0,1,2008
Timo Boll,Germany,0,1,0,1,2008
Li Jia Wei,Singapore,0,1,0,1,2008
Milorad Čavić,Serbia,0,1,0,1,2008
Alexandros Nikolaidis,Greece,0,1,0,1,2008
Tian Jia,People's Republic of China,0,1,0,1,2008
Thomas Johansson,Sweden,0,1,0,1,2008
Simon Whitfield,Canada,0,1,0,1,2008
Dante,Brazil,0,1,0,1,2008
Marcelinho,Brazil,0,1,0,1,2008
Gustavo,Brazil,0,1,0,1,2008
Giba,Brazil,0,1,0,1,2008
André Heller,Brazil,0,1,0,1,2008
Robyn Ah Mow-Santos,United States,0,1,0,1,2008
Heather Bown,United States,0,1,0,1,2008
Stacy Sykora,United States,0,1,0,1,2008
Logan Tom,United States,0,1,0,1,2008
Yevgeny Chigishev,Russian Federation,0,1,0,1,2008
Tony Azevedo,United States,0,1,0,1,2008
Ryan Bailey,United States,0,1,0,1,2008
Heather Petri,United States,0,1,0,1,2008
Brenda Villa,United States,0,1,0,1,2008
David Musuľbes,Russian Federation,0,1,0,1,2008
Kóki,Brazil,0,1,0,1,2008
Marta,Brazil,0,1,0,1,2008
Cristiane,Brazil,0,1,0,1,2008
Marco Galiazzo,Italy,0,1,0,1,2008
Penny Taylor,Australia,0,1,0,1,2008
Suzy Batkovic,Australia,0,1,0,1,2008
Belinda Snell,Australia,0,1,0,1,2008
Zhang Lin,People's Republic of China,0,1,0,1,2008
Alexander Dale Oen,Norway,0,1,0,1,2008
Alessia Filippi,Italy,0,1,0,1,2008
Yevgeny Lagunov,Russian Federation,0,1,0,1,2008
Fabien Gilot,France,0,1,0,1,2008
Sara Isakovič,Slovenia,0,1,0,1,2008
Diego Fernando Salazar,Colombia,0,1,0,1,2008
Gustav Larsson,Sweden,0,1,0,1,2008
Vencelas Dabaya,Cameroon,0,1,0,1,2008
Misleydis González,Cuba,0,1,0,1,2008
Annemieke Bes,Netherlands,0,1,0,1,2008
Julien Bontemps,France,0,1,0,1,2008
Iker Martínez,Spain,0,1,0,1,2008
Xabier Fernández,Spain,0,1,0,1,2008
Dave Davies,Great Britain,0,1,0,1,2008
Debbie Flood,Great Britain,0,1,0,1,2008
Michelle Guerette,United States,0,1,0,1,2008
Marlies Smulders,Netherlands,0,1,0,1,2008
Annemarieke van Rumpt,Netherlands,0,1,0,1,2008
Annemiek de Haan,Netherlands,0,1,0,1,2008
Sarah Siegelaar,Netherlands,0,1,0,1,2008
Helen Tanger,Netherlands,0,1,0,1,2008
Ester Workel,Netherlands,0,1,0,1,2008
Wu You,People's Republic of China,0,1,0,1,2008
Ondřej Synek,Czech Republic,0,1,0,1,2008
Matt Langridge,Great Britain,0,1,0,1,2008
Tõnu Endrekson,Estonia,0,1,0,1,2008
Luca Agamennoni,Italy,0,1,0,1,2008
Simone Venier,Italy,0,1,0,1,2008
Scott Frandsen,Canada,0,1,0,1,2008
Josh West,Great Britain,0,1,0,1,2008
Tom Stallard,Great Britain,0,1,0,1,2008
Tigran V. Martirosyan,Armenia,0,1,0,1,2008
Arsen Kasabijew,Georgia,0,1,0,1,2008
Nataliya Paderina,Russian Federation,0,1,0,1,2008
Zhu Qinan,People's Republic of China,0,1,0,1,2008
Matt Emmons,United States,0,1,0,1,2008
Yuriy Sukhorukov,Ukraine,0,1,0,1,2008
Sherone Simpson,Jamaica,0,1,0,1,2008
Meseret Defar,Ethiopia,0,1,0,1,2008
Shalane Flanagan,United States,0,1,0,1,2008
Sheena Johnson-Tosta,United States,0,1,0,1,2008
Novlene Williams-Mills,Jamaica,0,1,0,1,2008
Fabien Lefèvre,France,0,1,0,1,2008
Adam Van Koeverden,Canada,0,1,0,1,2008
Zhang Wenxiu,People's Republic of China,0,1,0,1,2008
Catherine Ndereba,Kenya,0,1,0,1,2008
Shawn Crawford,United States,0,1,0,1,2008
Shinji Takahira,Japan,0,1,0,1,2008
Vadzim Dzeviatouski,Belarus,0,1,0,1,2008
Godfrey Khotso Mokoena,South Africa,0,1,0,1,2008
Nick Willis,New Zealand,0,1,0,1,2008
Sileshi Sihine,Ethiopia,0,1,0,1,2008
Lee Chong Wei,Malaysia,0,1,0,1,2008
Fu Haifeng,People's Republic of China,0,1,0,1,2008
Cai Yun,People's Republic of China,0,1,0,1,2008
Nova Widianto,Indonesia,0,1,0,1,2008
Ana Maria Brânză-Popescu,Romania,0,1,0,1,2008
Tan Xue,People's Republic of China,0,1,0,1,2008
Nam Hyeon-Hui,Republic of Korea,0,1,0,1,2008
Erinn Smart,United States,0,1,0,1,2008
Jason Rogers,United States,0,1,0,1,2008
Yuki Ota,Japan,0,1,0,1,2008
Vanessa Fernandes,Portugal,0,1,0,1,2008
Khédafi Djelkhir,France,0,1,0,1,2008
Manut Boonjumnong,Thailand,0,1,0,1,2008
Clemente Russo,Italy,0,1,0,1,2008
Lucie Décosse,France,0,1,0,1,2008
Anaisis Hernández,Cuba,0,1,0,1,2008
Maki Tsukada,Japan,0,1,0,1,2008
Christina Obergföll,Germany,0,1,0,1,2008
Eliud Kipchoge,Kenya,0,1,0,1,2008
Ismail Ahmed Ismail,Sudan,0,1,0,1,2008
Benjamin Darbelet,France,0,1,0,1,2008
Ludwig Paischer,Austria,0,1,0,1,2008
Amar Benikhlef,Algeria,0,1,0,1,2008
Márcio,Brazil,0,1,0,1,2008
Anna Meares,Australia,0,1,0,1,2008
Ross Edgar,Great Britain,0,1,0,1,2008
Imke Schellekens-Bartels,Netherlands,0,1,0,1,2008
Damola Osayomi,Nigeria,0,1,0,1,2008
Gloria Kemasuode,Nigeria,0,1,0,1,2008
Takehiro Kashima,Japan,0,1,0,1,2008
Hiroyuki Tomita,Japan,0,1,0,1,2008
Anabel Medina,Spain,0,1,0,1,2008
Fernando González,Chile,0,1,0,1,2008
Edvinas Krungolcas,Lithuania,0,1,0,1,2008
Chiharu Icho,Japan,0,1,0,1,2008
Alyona Kartashova,Russian Federation,0,1,0,1,2008
Stanka Zlateva,Bulgaria,0,1,0,1,2008
Kanat Begaliyev,Kyrgyzstan,0,1,0,1,2008
Mindaugas Mizgaitis,Lithuania,0,1,0,1,2008
Nurbakyt Tengizbayev,Kazakhstan,0,1,0,1,2008
Mirko Englich,Germany,0,1,0,1,2008
Raquel Corral,Spain,0,1,0,1,2008
Irina Rodríguez,Spain,0,1,0,1,2008
Halimat Ismaila,Nigeria,0,1,0,1,2008
Andrae Williams,The Bahamas,0,1,0,1,2008
Ina Zhukava,Belarus,0,1,0,1,2008
Lu Yuanyang,People's Republic of China,0,1,0,1,2008
Zhang Shuo,People's Republic of China,0,1,0,1,2008
Maja Włoszczowska,Poland,0,1,0,1,2008
Jean-Christophe Péraud,France,0,1,0,1,2008
Yusup Abdusalomov,Tajikistan,0,1,0,1,2008
Murad Haydarau,Belarus,0,1,0,1,2008
Nina Solheim,Norway,0,1,0,1,2008
Gabriel Mercedes,Dominican Republic,0,1,0,1,2008
Jaouad Gharib,Morocco,0,1,0,1,2008
Frederich Cepeda,Cuba,0,1,0,1,2008
Michel Enríquez,Cuba,0,1,0,1,2008
Norberto González,Cuba,0,1,0,1,2008
Yulieski Gourriel,Cuba,0,1,0,1,2008
Jonder Martínez,Cuba,0,1,0,1,2008
Vicyohandri Odelín,Cuba,0,1,0,1,2008
Adiel Palma,Cuba,0,1,0,1,2008
Eriel Sánchez,Cuba,0,1,0,1,2008
Yoandri Urgellés,Cuba,0,1,0,1,2008
José Manuel Calderón,Spain,0,1,0,1,2008
Rudy Fernández,Spain,0,1,0,1,2008
Pau Gasol,Spain,0,1,0,1,2008
Felipe Reyes,Spain,0,1,0,1,2008
Laura Summerton-Hodges,Australia,0,1,0,1,2008
Snorri Guðjónsson,Iceland,0,1,0,1,2008
Róbert Gunnarsson,Iceland,0,1,0,1,2008
Ásgeir Örn Hallgrímsson,Iceland,0,1,0,1,2008
Guðjón Valur Sigurðsson,Iceland,0,1,0,1,2008
Sigfús Sigurðsson,Iceland,0,1,0,1,2008
Ólafur Stefánsson,Iceland,0,1,0,1,2008
Chen Qiuqi,People's Republic of China,0,1,0,1,2008
Fu Baorong,People's Republic of China,0,1,0,1,2008
Gao Lihua,People's Republic of China,0,1,0,1,2008
Li Shuang,People's Republic of China,0,1,0,1,2008
Ma Yibo,People's Republic of China,0,1,0,1,2008
Zhang Yimeng,People's Republic of China,0,1,0,1,2008
David Alegre,Spain,0,1,0,1,2008
Ramón Alegre,Spain,0,1,0,1,2008
Alex Fábregas,Spain,0,1,0,1,2008
Santi Freixa,Spain,0,1,0,1,2008
Albert Sala,Spain,0,1,0,1,2008
Víctor Sojo,Spain,0,1,0,1,2008
Jennie Finch,United States,0,1,0,1,2008
Tairia Flowers,United States,0,1,0,1,2008
Lovie Jung,United States,0,1,0,1,2008
Kelly Kretschman,United States,0,1,0,1,2008
Jessica Mendoza,United States,0,1,0,1,2008
Cat Osterman,United States,0,1,0,1,2008
Natasha Watley,United States,0,1,0,1,2008
Lindsey Berg,United States,0,1,0,1,2008
Tayyiba Haneef-Park,United States,0,1,0,1,2008
Ogonna Nnamani,United States,0,1,0,1,2008
André Nascimento,Brazil,0,1,0,1,2008
Anderson,Brazil,0,1,0,1,2008
Rodrigão,Brazil,0,1,0,1,2008
Serginho,Brazil,0,1,0,1,2008
Natalie Golda,United States,0,1,0,1,2008
Layne Beaubien,United States,0,1,0,1,2008
Brandon Brooks,United States,0,1,0,1,2008
Jeff Powers,United States,0,1,0,1,2008
Jesse Smith,United States,0,1,0,1,2008
Adam Wright,United States,0,1,0,1,2008
Iryna Lishchynska,Ukraine,0,1,0,1,2008
Andréia Rosa,Brazil,0,1,0,1,2008
Ambruse Vanzekin,Nigeria,0,1,0,1,2008
Chibuzor Okonkwo,Nigeria,0,1,0,1,2008
Onyekachi Apam,Nigeria,0,1,0,1,2008
Dele Adeleye,Nigeria,0,1,0,1,2008
Olubayo Adefemi,Nigeria,0,1,0,1,2008
Sani Kaita,Nigeria,0,1,0,1,2008
Promise Isaac,Nigeria,0,1,0,1,2008
Femi Ajilore,Nigeria,0,1,0,1,2008
Victor Obinna,Nigeria,0,1,0,1,2008
Solomon Okoronkwo,Nigeria,0,1,0,1,2008
Peter Odemwingie,Nigeria,0,1,0,1,2008
Chinedu Ogbuke,Nigeria,0,1,0,1,2008
Victor Anichebe,Nigeria,0,1,0,1,2008
Emmanuel Ekpo,Nigeria,0,1,0,1,2008
Guo Dan,People's Republic of China,0,1,0,1,2008
Chen Ling,People's Republic of China,0,1,0,1,2008
Mauro Nespoli,Italy,0,1,0,1,2008
Érika,Brazil,0,1,0,1,2008
Ester,Brazil,0,1,0,1,2008
Francielle,Brazil,0,1,0,1,2008
Zach Railey,United States,0,1,0,1,2008
Mandy Mulder,Netherlands,0,1,0,1,2008
Merel Witteveen,Netherlands,0,1,0,1,2008
Rohanee Cox,Australia,0,1,0,1,2008
Tully Bevilaqua,Australia,0,1,0,1,2008
Hollie Grima,Australia,0,1,0,1,2008
Emma Randall,Australia,0,1,0,1,2008
Erin Phillips,Australia,0,1,0,1,2008
Jenni Screen,Australia,0,1,0,1,2008
Im Jeong-Hwa,Republic of Korea,0,1,0,1,2008
Clayton Fredericks,Australia,0,1,0,1,2008
Lucinda Fredericks,Australia,0,1,0,1,2008
Megan Jones,Australia,0,1,0,1,2008
Sonja Johnson,Australia,0,1,0,1,2008
Shane Rose,Australia,0,1,0,1,2008
Gina Miles,United States,0,1,0,1,2008
Koki Sakamoto,Japan,0,1,0,1,2008
Makoto Okiguchi,Japan,0,1,0,1,2008
Takuya Nakase,Japan,0,1,0,1,2008
Yu Won-Cheol,Republic of Korea,0,1,0,1,2008
Thomas Bouhail,France,0,1,0,1,2008
Filip Ude,Croatia,0,1,0,1,2008
Inna Suslina,Russian Federation,0,1,0,1,2008
Mariya Sidorova,Russian Federation,0,1,0,1,2008
Irina Poltoratskaya,Russian Federation,0,1,0,1,2008
Oksana Romenskaya,Russian Federation,0,1,0,1,2008
Lyudmila Postnova,Russian Federation,0,1,0,1,2008
Anna Kareyeva,Russian Federation,0,1,0,1,2008
Yekaterina Andryushina,Russian Federation,0,1,0,1,2008
Yana Uskova,Russian Federation,0,1,0,1,2008
Yelena Polyonova,Russian Federation,0,1,0,1,2008
Emiliya Turey,Russian Federation,0,1,0,1,2008
Nataliya Shipilova,Russian Federation,0,1,0,1,2008
Yekaterina Marennikova,Russian Federation,0,1,0,1,2008
Yelena Dmitriyeva,Russian Federation,0,1,0,1,2008
Irina Bliznova,Russian Federation,0,1,0,1,2008
Nicole Davis,United States,0,1,0,1,2008
Kim Glass,United States,0,1,0,1,2008
Kim Willoughby,United States,0,1,0,1,2008
Kenny Egan,Ireland,0,1,0,1,2008
"Emilio Correa, Jr.",Cuba,0,1,0,1,2008
Nikita Lobintsev,Russian Federation,0,1,0,1,2008
Christian Sprenger,Australia,0,1,0,1,2008
Elaine Breeden,United States,0,1,0,1,2008
Keri-Anne Payne,Great Britain,0,1,0,1,2008
Emily Silver,United States,0,1,0,1,2008
Lacey Nymeyer,United States,0,1,0,1,2008
Matt Ryan,Australia,0,1,0,1,2008
James Marburg,Australia,0,1,0,1,2008
Maxi McKenzie-McHarg,Australia,0,1,0,1,2008
Francis Hegerty,Australia,0,1,0,1,2008
Gao Yulan,People's Republic of China,0,1,0,1,2008
Annekatrin Thiele,Germany,0,1,0,1,2008
Christiane Huth,Germany,0,1,0,1,2008
Wang Jie,People's Republic of China,0,1,0,1,2008
Fábio,Brazil,0,1,0,1,2008
Bao Yingying,People's Republic of China,0,1,0,1,2008
Huang Haiyang,People's Republic of China,0,1,0,1,2008
Yanet Bermoy,Cuba,0,1,0,1,2008
Yalennis Castillo,Cuba,0,1,0,1,2008
An Kum-Ae,Democratic People's Republic of Korea,0,1,0,1,2008
Wang Gi-Chun,Republic of Korea,0,1,0,1,2008
Kim Jae-Beom,Republic of Korea,0,1,0,1,2008
Xie Xingfang,People's Republic of China,0,1,0,1,2008
Liliyana Natsir,Indonesia,0,1,0,1,2008
Carlos Banteur,Cuba,0,1,0,1,2008
Daouda Sow,France,0,1,0,1,2008
Andry Laffita,Cuba,0,1,0,1,2008
Yankiel León,Cuba,0,1,0,1,2008
Pürevdorjin Serdamba,Mongolia,0,1,0,1,2008
Zhang Zhilei,People's Republic of China,0,1,0,1,2008
Emma Pooley,Great Britain,0,1,0,1,2008
Emma Johansson,Sweden,0,1,0,1,2008
Laëtitia Le Corguillé,France,0,1,0,1,2008
Wendy Houvenaghel,Great Britain,0,1,0,1,2008
Grégory Baugé,France,0,1,0,1,2008
Kévin Sireau,France,0,1,0,1,2008
Michael Færk Christensen,Denmark,0,1,0,1,2008
Casper Jørgensen,Denmark,0,1,0,1,2008
Jens-Erik Madsen,Denmark,0,1,0,1,2008
Alex Rasmussen,Denmark,0,1,0,1,2008
Roger Kluge,Germany,0,1,0,1,2008
Michael Mørkøv,Denmark,0,1,0,1,2008
Mike Day,United States,0,1,0,1,2008
Alexei Bell,Cuba,0,1,0,1,2008
Alfredo Despaigne,Cuba,0,1,0,1,2008
Giorvis Duvergel,Cuba,0,1,0,1,2008
Miguel La Hera,Cuba,0,1,0,1,2008
Alexander Malleta,Cuba,0,1,0,1,2008
Luis Miguel Navas,Cuba,0,1,0,1,2008
Héctor Olivera,Cuba,0,1,0,1,2008
Yadier Pedroso,Cuba,0,1,0,1,2008
Luis Miguel Rodríguez,Cuba,0,1,0,1,2008
Elier Sánchez,Cuba,0,1,0,1,2008
Monica Abbott,United States,0,1,0,1,2008
Andrea Duran,United States,0,1,0,1,2008
Vicky Galindo,United States,0,1,0,1,2008
Lauren Lappin,United States,0,1,0,1,2008
Caitlin Lowe,United States,0,1,0,1,2008
Marc Gasol,Spain,0,1,0,1,2008
Álex Mumbrú,Spain,0,1,0,1,2008
Ricky Rubio,Spain,0,1,0,1,2008
Berni Rodríguez,Spain,0,1,0,1,2008
Monday James,Nigeria,0,1,0,1,2008
Efe Ambrose,Nigeria,0,1,0,1,2008
Bárbara,Brazil,0,1,0,1,2008
Fabiana,Brazil,0,1,0,1,2008
Maurine,Brazil,0,1,0,1,2008
Sverre Jakobsson,Iceland,0,1,0,1,2008
Logi Geirsson,Iceland,0,1,0,1,2008
Ingimundur Ingimundarson,Iceland,0,1,0,1,2008
Sturla Ásgeirsson,Iceland,0,1,0,1,2008
Alexander Petersson,Iceland,0,1,0,1,2008
Björgvin Gustavsson,Iceland,0,1,0,1,2008
Hreiðar Guðmundsson,Iceland,0,1,0,1,2008
Arnór Atlason,Iceland,0,1,0,1,2008
Sergi Enrique,Spain,0,1,0,1,2008
Eduard Arbós,Spain,0,1,0,1,2008
Quico Cortés,Spain,0,1,0,1,2008
Roc Oliva,Spain,0,1,0,1,2008
Juan Fernández,Spain,0,1,0,1,2008
Ren Ye,People's Republic of China,0,1,0,1,2008
Zhao Yudiao,People's Republic of China,0,1,0,1,2008
Li Hongxia,People's Republic of China,0,1,0,1,2008
Pan Fengzhen,People's Republic of China,0,1,0,1,2008
Song Qingling,People's Republic of China,0,1,0,1,2008
Lauren Wenger,United States,0,1,0,1,2008
Kami Craig,United States,0,1,0,1,2008
Moriah Van Norman,United States,0,1,0,1,2008
Jessica Steffens,United States,0,1,0,1,2008
Patty Cardenas,United States,0,1,0,1,2008
Betsey Armstrong,United States,0,1,0,1,2008
Brittany Hayes,United States,0,1,0,1,2008
Elsie Windes,United States,0,1,0,1,2008
Alison Gregorka,United States,0,1,0,1,2008
Jaime Hipp,United States,0,1,0,1,2008
Rick Merlo,United States,0,1,0,1,2008
Tim Hutten,United States,0,1,0,1,2008
Peter Varellas,United States,0,1,0,1,2008
Merrill Moses,United States,0,1,0,1,2008
Peter Hudnut,United States,0,1,0,1,2008
J. W. Krumpholz,United States,0,1,0,1,2008
Jennifer Joines,United States,0,1,0,1,2008
Murilo,Brazil,0,1,0,1,2008
Bruninho,Brazil,0,1,0,1,2008
Samuel,Brazil,0,1,0,1,2008
Hyleas Fountain,United States,0,1,0,1,2008
Janeth Jepkosgei,Kenya,0,1,0,1,2008
Eunice Jepkorir,Kenya,0,1,0,1,2008
Olga Rypakova,Kazakhstan,0,1,0,1,2008
Christian Cantwell,United States,0,1,0,1,2008
Naoki Tsukahara,Japan,0,1,0,1,2008
Mahiedine Mekhissi-Benabbad,France,0,1,0,1,2008
Piotr Małachowski,Poland,0,1,0,1,2008
Franca Idoko,Nigeria,0,1,0,1,2008
Jenn Stuczynski-Suhr,United States,0,1,0,1,2008
Rosemarie Whyte,Jamaica,0,1,0,1,2008
Sally McLellan-Pearson,Australia,0,1,0,1,2008
Germaine Mason,Great Britain,0,1,0,1,2008
Andretti Bain,The Bahamas,0,1,0,1,2008
Michael Mathieu,The Bahamas,0,1,0,1,2008
David Payne,United States,0,1,0,1,2008
Blessing Okagbare,Nigeria,0,1,0,1,2008
Agnes Osazuwa,Nigeria,0,1,0,1,2008
Shereefa Lloyd,Jamaica,0,1,0,1,2008
Bobby-Gaye Wilkins,Jamaica,0,1,0,1,2008
Yevgeny Lukyanenko,Russian Federation,0,1,0,1,2008
Andrei Krauchanka,Belarus,0,1,0,1,2008
Ainārs Kovals,Latvia,0,1,0,1,2008
Ramon Miller,The Bahamas,0,1,0,1,2008
Dan Izotov,Russian Federation,0,1,0,1,2008
Aleksandr Sukhorukov,Russian Federation,0,1,0,1,2008
Ash Delaney,Australia,0,1,0,1,2008
Grégory Mallet,France,0,1,0,1,2008
Boris Steimetz,France,0,1,0,1,2008
Tan Miao,People's Republic of China,0,1,0,1,2008
Zhu Qianwei,People's Republic of China,0,1,0,1,2008
Jiao Liuyang,People's Republic of China,0,1,0,1,2008
Mikhail Polishchuk,Russian Federation,0,1,0,1,2008
Anastasiya Pozdnyakova,Russian Federation,0,1,0,1,2008
Bree Cole,Australia,0,1,0,1,2008
Melissa Wu,Australia,0,1,0,1,2008
Patrick Hausding,Germany,0,1,0,1,2008
Sascha Klein,Germany,0,1,0,1,2008
Yury Kunakov,Russian Federation,0,1,0,1,2008
Zhou Luxin,People's Republic of China,0,1,0,1,2008
Alba Cabello,Spain,0,1,0,1,2008
Thaïs Henríquez,Spain,0,1,0,1,2008
Laura López,Spain,0,1,0,1,2008
Yun Jin-Hui,Republic of Korea,0,1,0,1,2008
O Jong-Ae,Democratic People's Republic of Korea,0,1,0,1,2008
Lu Ying-Chi,Chinese Taipei,0,1,0,1,2008
Leidy Solís,Colombia,0,1,0,1,2008
Lydia Valentín,Spain,0,1,0,1,2008
Ele Opeloge,Samoa,0,1,0,1,2008
Hoàng Anh Tuấn,Vietnam,0,1,0,1,2008
Li Hongli,People's Republic of China,0,1,0,1,2008
Dmitry Klokov,Russian Federation,0,1,0,1,2008
Heather Fell,Great Britain,0,1,0,1,2008
David Florence,Great Britain,0,1,0,1,2008
Sergey Ulegin,Russian Federation,0,1,0,1,2008
Kim Knudsen,Denmark,0,1,0,1,2008
René Poulsen,Denmark,0,1,0,1,2008
Jacqui Lawrence,Australia,0,1,0,1,2008
Beata Mikołajczyk,Poland,0,1,0,1,2008
Gabriella Szabó,Hungary,0,1,0,1,2008
Danuta Kozák,Hungary,0,1,0,1,2008
Hans Peter Minderhoud,Netherlands,0,1,0,1,2008
Jill Henselwood,Canada,0,1,0,1,2008
Tang Jingzhi,People's Republic of China,0,1,0,1,2008
Jason Burnett,Canada,0,1,0,1,2008
Cai Tongtong,People's Republic of China,0,1,0,1,2008
Chou Tao,People's Republic of China,0,1,0,1,2008
Sui Jianshuang,People's Republic of China,0,1,0,1,2008
Sun Dan,People's Republic of China,0,1,0,1,2008
Xu Li,People's Republic of China,0,1,0,1,2008
Tomohiro Matsunaga,Japan,0,1,0,1,2008
Kenichi Yumoto,Japan,0,1,0,1,2008
Andriy Stadnik,Ukraine,0,1,0,1,2008
Giorgi Gogshelidze,Georgia,0,1,0,1,2008
Rövşən Bayramov,Azerbaijan,0,1,0,1,2008
Chang Yongxiang,People's Republic of China,0,1,0,1,2008
Zoltán Fodor,Hungary,0,1,0,1,2008
Zuzana Štefečeková,Slovakia,0,1,0,1,2008
Francesco D'Aniello,Italy,0,1,0,1,2008
Tore Brovold,Norway,0,1,0,1,2008
Buttree Puedpong,Thailand,0,1,0,1,2008
Azize Tanrıkulu,Turkey,0,1,0,1,2008
Karine Sergerie,Canada,0,1,0,1,2008
Mark Lopez,United States,0,1,0,1,2008
Mauro Sarmiento,Italy,0,1,0,1,2008
Feng Tianwei,Singapore,0,1,0,1,2008
Wang Yuegu,Singapore,0,1,0,1,2008
Dimitrij Ovtcharov,Germany,0,1,0,1,2008
Christian Süß,Germany,0,1,0,1,2008
Simon Aspelin,Sweden,0,1,0,1,2008
Dinara Safina,Russian Federation,0,1,0,1,2008
Chellsie Memmel,United States,0,1,0,1,2008
Samantha Peszek,United States,0,1,0,1,2008
Alicia Sacramone,United States,0,1,0,1,2008
Bridget Sloan,United States,0,1,0,1,2008
Marcelien Bos-de Koning,Netherlands,0,1,0,1,2008
Lobke Berkhout,Netherlands,0,1,0,1,2008
Gintarė Volungevičiūtė-Scheidt,Lithuania,0,1,0,1,2008
Bruno Prada,Brazil,0,1,0,1,2008
Glenn Ashby,Australia,0,1,0,1,2008
Annie Vernon,Great Britain,0,1,0,1,2008
Sanna Stén,Finland,0,1,0,1,2008
Minna Nieminen,Finland,0,1,0,1,2008
Nienke Kingma,Netherlands,0,1,0,1,2008
Roline Repelaer van Driel,Netherlands,0,1,0,1,2008
Dimitris Mougios,Greece,0,1,0,1,2008
Łukasz Pawłowski,Poland,0,1,0,1,2008
Bartłomiej Pawełczak,Poland,0,1,0,1,2008
Miłosz Bernatajtys,Poland,0,1,0,1,2008
Paweł Rańda,Poland,0,1,0,1,2008
Alex Partridge,Great Britain,0,1,0,1,2008
Tom Lucy,Great Britain,0,1,0,1,2008
Ric Egington,Great Britain,0,1,0,1,2008
Alastair Heathcote,Great Britain,0,1,0,1,2008
Colin Smith,Great Britain,0,1,0,1,2008
Acer Nethercott,Great Britain,0,1,0,1,2008
Ni Hong,People's Republic of China,0,1,0,1,2008
Emily Cross,United States,0,1,0,1,2008
Hanna Thompson,United States,0,1,0,1,2008
Radosław Zawrotniak,Poland,0,1,0,1,2008
Tomasz Motyka,Poland,0,1,0,1,2008
Adam Wiercioch,Poland,0,1,0,1,2008
Tim Morehouse,United States,0,1,0,1,2008
Robert Andrzejuk,Poland,0,1,0,1,2008
James Williams,United States,0,1,0,1,2008
Michael Phelps,United States,4,2,0,6,2012
Missy Franklin,United States,4,0,1,5,2012
Allison Schmitt,United States,3,1,1,5,2012
Dana Vollmer,United States,3,0,0,3,2012
Allyson Felix,United States,3,0,0,3,2012
Usain Bolt,Jamaica,3,0,0,3,2012
Ryan Lochte,United States,2,2,1,5,2012
Sun Yang,People's Republic of China,2,1,1,4,2012
Ranomi Kromowidjojo,Netherlands,2,1,0,3,2012
Matt Grevers,United States,2,1,0,3,2012
Nathan Adrian,United States,2,1,0,3,2012
Rebecca Soni,United States,2,1,0,3,2012
Yannick Agnel,France,2,1,0,3,2012
Zou Kai,People's Republic of China,2,0,1,3,2012
Aly Raisman,United States,2,0,1,3,2012
Chris Hoy,Great Britain,2,0,0,2,2012
Serena Williams,United States,2,0,0,2,2012
Jin Jong-O,Republic of Korea,2,0,0,2,2012
Sanya Richards-Ross,United States,2,0,0,2,2012
Wu Minxia,People's Republic of China,2,0,0,2,2012
Jason Kenny,Great Britain,2,0,0,2,2012
Mo Farah,Great Britain,2,0,0,2,2012
Chen Ruolin,People's Republic of China,2,0,0,2,2012
Nataliya Ishchenko,Russian Federation,2,0,0,2,2012
Svetlana Romashina,Russian Federation,2,0,0,2,2012
Danuta Kozák,Hungary,2,0,0,2,2012
Zhang Jike,People's Republic of China,2,0,0,2,2012
Li Xiaoxia,People's Republic of China,2,0,0,2,2012
Zhao Yunlei,People's Republic of China,2,0,0,2,2012
Feng Zhe,People's Republic of China,2,0,0,2,2012
Ye Shiwen,People's Republic of China,2,0,0,2,2012
Elisa Di Francisca,Italy,2,0,0,2,2012
Laura Trott-Kenny,Great Britain,2,0,0,2,2012
Gi Bo-Bae,Republic of Korea,2,0,0,2,2012
Charlotte Dujardin,Great Britain,2,0,0,2,2012
Michael Jung,Germany,2,0,0,2,2012
Gabby Douglas,United States,2,0,0,2,2012
Alicia Coutts,Australia,1,3,1,5,2012
Kohei Uchimura,Japan,1,2,0,3,2012
Mel Schlanger,Australia,1,2,0,3,2012
Shelly-Ann Fraser-Pryce,Jamaica,1,2,0,3,2012
Cullen Jones,United States,1,2,0,3,2012
Emily Seebohm,Australia,1,2,0,3,2012
Yohan Blake,Jamaica,1,2,0,3,2012
Brittany Elmslie,Australia,1,2,0,3,2012
Aliya Mustafina,Russian Federation,1,1,2,4,2012
Camille Muffat,France,1,1,1,3,2012
Carmelita Jeter,United States,1,1,1,3,2012
Katalin Kovács,Hungary,1,1,0,2,2012
Amaury Leveaux,France,1,1,0,2,2012
Vicki Pendleton,Great Britain,1,1,0,2,2012
Wang Hao,People's Republic of China,1,1,0,2,2012
Chen Yibing,People's Republic of China,1,1,0,2,2012
Ricky Berens,United States,1,1,0,2,2012
Clément Lefert,France,1,1,0,2,2012
Qin Kai,People's Republic of China,1,1,0,2,2012
Niccolò Campriani,Italy,1,1,0,2,2012
Andy Murray,Great Britain,1,1,0,2,2012
Ilya Zakharov,Russian Federation,1,1,0,2,2012
Chad le Clos,South Africa,1,1,0,2,2012
Ding Ning,People's Republic of China,1,1,0,2,2012
He Zi,People's Republic of China,1,1,0,2,2012
Arianna Errigo,Italy,1,1,0,2,2012
Tina Dietze,Germany,1,1,0,2,2012
Franziska Weber,Germany,1,1,0,2,2012
Jérémy Stravius,France,1,1,0,2,2012
Nick Thoman,United States,1,1,0,2,2012
McKayla Maroney,United States,1,1,0,2,2012
Valentina Vezzali,Italy,1,0,1,2,2012
Oussama Mellouli,Tunisia,1,0,1,2,2012
Brendan Hansen,United States,1,0,1,2,2012
Tirunesh Dibaba,Ethiopia,1,0,1,2,2012
DeeDee Trotter,United States,1,0,1,2,2012
Anna Meares,Australia,1,0,1,2,2012
Mike Bryan,United States,1,0,1,2,2012
Ed Clancy,Great Britain,1,0,1,2,2012
David Boudia,United States,1,0,1,2,2012
Laura Bechtolsheimer,Great Britain,1,0,1,2,2012
Vika Azarenka,Belarus,1,0,1,2,2012
Sandra Izbașa,Romania,1,0,1,2,2012
Sun Yujie,People's Republic of China,1,0,1,2,2012
Oh Jin-Hyeok,Republic of Korea,1,0,1,2,2012
Sandra Auffarth,Germany,1,0,1,2,2012
Jessica Hardy,United States,1,0,1,2,2012
Michele Frangilli,Italy,1,0,0,1,2012
Peter Charles,Great Britain,1,0,0,1,2012
Carl Hester,Great Britain,1,0,0,1,2012
Nick Skelton,Great Britain,1,0,0,1,2012
Peter Thomsen,Germany,1,0,0,1,2012
Aleksandr Vinokurov,Kazakhstan,1,0,0,1,2012
Siarhei Martynau,Belarus,1,0,0,1,2012
Kim Rhode,United States,1,0,0,1,2012
Sergey Tetyukhin,Russian Federation,1,0,0,1,2012
Igor Hinić,Croatia,1,0,0,1,2012
Ben Ainslie,Great Britain,1,0,0,1,2012
Fredrik Lööf,Sweden,1,0,0,1,2012
Chris Brown,The Bahamas,1,0,0,1,2012
Félix Sánchez,Dominican Republic,1,0,0,1,2012
Tony Estanguet,France,1,0,0,1,2012
Roland Kökény,Hungary,1,0,0,1,2012
Eirik Verås Larsen,Norway,1,0,0,1,2012
Bradley Wiggins,Great Britain,1,0,0,1,2012
Ingrid Klimke,Germany,1,0,0,1,2012
Li Na,People's Republic of China,1,0,0,1,2012
Christie Pearce-Rampone,United States,1,0,0,1,2012
Didier Dinart,France,1,0,0,1,2012
Jérôme Fernandez,France,1,0,0,1,2012
Bertrand Gille,France,1,0,0,1,2012
Guillaume Gille,France,1,0,0,1,2012
Matthias Witthaus,Germany,1,0,0,1,2012
Marilyn Agliotti,Netherlands,1,0,0,1,2012
Katherine Grainger,Great Britain,1,0,0,1,2012
Leuris Pupo,Cuba,1,0,0,1,2012
Éva Risztov,Hungary,1,0,0,1,2012
Max Mirny,Belarus,1,0,0,1,2012
Misty May-Treanor,United States,1,0,0,1,2012
Venus Williams,United States,1,0,0,1,2012
Kerri Walsh Jennings,United States,1,0,0,1,2012
Samir Barać,Croatia,1,0,0,1,2012
Frano Vićan,Croatia,1,0,0,1,2012
Heather Petri,United States,1,0,0,1,2012
Brenda Villa,United States,1,0,0,1,2012
Shannon Boxx,United States,1,0,0,1,2012
Abby Wambach,United States,1,0,0,1,2012
José Corona,Mexico,1,0,0,1,2012
Lee Seong-Jin,Republic of Korea,1,0,0,1,2012
Marco Galiazzo,Italy,1,0,0,1,2012
Heather Mitts,United States,1,0,0,1,2012
Heather O'Reilly,United States,1,0,0,1,2012
Sue Bird,United States,1,0,0,1,2012
Tamika Catchings,United States,1,0,0,1,2012
Diana Taurasi,United States,1,0,0,1,2012
Swin Cash,United States,1,0,0,1,2012
Libby Lenton-Trickett,Australia,1,0,0,1,2012
Fabien Gilot,France,1,0,0,1,2012
Dániel Gyurta,Hungary,1,0,0,1,2012
Kristin Armstrong,United States,1,0,0,1,2012
Tomasz Majewski,Poland,1,0,0,1,2012
Valerie Adams-Vili,New Zealand,1,0,0,1,2012
Malcolm Page,Australia,1,0,0,1,2012
Mirka Topinková Knapková,Czech Republic,1,0,0,1,2012
Yana Dementieva,Ukraine,1,0,0,1,2012
Caryn Davies,United States,1,0,0,1,2012
Mary Whipple,United States,1,0,0,1,2012
Mahé Drysdale,New Zealand,1,0,0,1,2012
Eric Murray,New Zealand,1,0,0,1,2012
Mads Rasmussen,Denmark,1,0,0,1,2012
Rasmus Quist,Denmark,1,0,0,1,2012
Andy Triggs Hodge,Great Britain,1,0,0,1,2012
Lauryn Williams,United States,1,0,0,1,2012
Meseret Defar,Ethiopia,1,0,0,1,2012
Nataliya Antyukh,Russian Federation,1,0,0,1,2012
Yuriy Cheban,Ukraine,1,0,0,1,2012
Michael Frater,Jamaica,1,0,0,1,2012
Krisztián Pars,Hungary,1,0,0,1,2012
Ezekiel Kemboi,Kenya,1,0,0,1,2012
Lin Dan,People's Republic of China,1,0,0,1,2012
Fu Haifeng,People's Republic of China,1,0,0,1,2012
Cai Yun,People's Republic of China,1,0,0,1,2012
Oh Eun-Seok,Republic of Korea,1,0,0,1,2012
Andrea Cassarà,Italy,1,0,0,1,2012
Nicola Spirig Hug,Switzerland,1,0,0,1,2012
Zou Shiming,People's Republic of China,1,0,0,1,2012
Lucie Décosse,France,1,0,0,1,2012
Urška Žolnir,Slovenia,1,0,0,1,2012
Barbora Špotáková,Czech Republic,1,0,0,1,2012
Jonas Reckermann,Germany,1,0,0,1,2012
Steve Guerdat,Switzerland,1,0,0,1,2012
Anna Chicherova,Russian Federation,1,0,0,1,2012
Bob Bryan,United States,1,0,0,1,2012
Saori Yoshida,Japan,1,0,0,1,2012
Kaori Icho,Japan,1,0,0,1,2012
Mijaín López,Cuba,1,0,0,1,2012
Anastasiya Davydova,Russian Federation,1,0,0,1,2012
Mariya Gromova,Russian Federation,1,0,0,1,2012
Jaroslav Kulhavý,Czech Republic,1,0,0,1,2012
Hwang Gyeong-Seon,Republic of Korea,1,0,0,1,2012
Carlo Molfetta,Italy,1,0,0,1,2012
Tom James,Great Britain,1,0,0,1,2012
Carmelo Anthony,United States,1,0,0,1,2012
LeBron James,United States,1,0,0,1,2012
Michaël Guigou,France,1,0,0,1,2012
Nikola Karabatic,France,1,0,0,1,2012
Daniel Narcisse,France,1,0,0,1,2012
Thierry Omeyer,France,1,0,0,1,2012
Timo Weß,Germany,1,0,0,1,2012
Christopher Zeller,Germany,1,0,0,1,2012
Fabiana,Brazil,1,0,0,1,2012
Taras Khtey,Russian Federation,1,0,0,1,2012
Kelly Rulon,United States,1,0,0,1,2012
Damir Burić,Croatia,1,0,0,1,2012
Elvira Khasyanova,Russian Federation,1,0,0,1,2012
Guo Yue,People's Republic of China,1,0,0,1,2012
Hope Solo,United States,1,0,0,1,2012
Carli Lloyd,United States,1,0,0,1,2012
Tobin Heath,United States,1,0,0,1,2012
Amy Rodriguez,United States,1,0,0,1,2012
Mauro Nespoli,Italy,1,0,0,1,2012
Rachel Buehler,United States,1,0,0,1,2012
Jamie Beyerle-Gray,United States,1,0,0,1,2012
Sylvia Fowles,United States,1,0,0,1,2012
Seimone Augustus,United States,1,0,0,1,2012
Candace Parker,United States,1,0,0,1,2012
Epke Zonderland,Netherlands,1,0,0,1,2012
Kari Aalvik Grimsbø,Norway,1,0,0,1,2012
Katrine Lunde-Haraldsen,Norway,1,0,0,1,2012
Gøril Snorroeggen,Norway,1,0,0,1,2012
Tonje Nøstvold,Norway,1,0,0,1,2012
Karoline Dyhre Breivang,Norway,1,0,0,1,2012
Kristine Lunde-Borgersen,Norway,1,0,0,1,2012
Kari Mette Johansen,Norway,1,0,0,1,2012
Marit Malm Frafjord,Norway,1,0,0,1,2012
Linn-Kristin Riegelhuth Koren,Norway,1,0,0,1,2012
Paula,Brazil,1,0,0,1,2012
Thaísa,Brazil,1,0,0,1,2012
Jaque,Brazil,1,0,0,1,2012
Sheilla,Brazil,1,0,0,1,2012
Fabi,Brazil,1,0,0,1,2012
Cameron van der Burgh,South Africa,1,0,0,1,2012
Cate Campbell,Australia,1,0,0,1,2012
Nathan Cohen,New Zealand,1,0,0,1,2012
Pete Reed,Great Britain,1,0,0,1,2012
Filip Adamski,Germany,1,0,0,1,2012
Hamish Bond,New Zealand,1,0,0,1,2012
Anna Bebington-Watkins,Great Britain,1,0,0,1,2012
Kateryna Tarasenko,Ukraine,1,0,0,1,2012
Julius Brink,Germany,1,0,0,1,2012
Sarah Menezes,Brazil,1,0,0,1,2012
Idalys Ortiz,Cuba,1,0,0,1,2012
An Kum-Ae,Democratic People's Republic of Korea,1,0,0,1,2012
Teddy Riner,France,1,0,0,1,2012
Kim Jae-Beom,Republic of Korea,1,0,0,1,2012
Serik Sapiyev,Kazakhstan,1,0,0,1,2012
Roniel Iglesias,Cuba,1,0,0,1,2012
Vasyl Lomachenko,Ukraine,1,0,0,1,2012
Oleksandr Usik,Ukraine,1,0,0,1,2012
Marianne Vos,Netherlands,1,0,0,1,2012
Geraint Thomas,Great Britain,1,0,0,1,2012
Steven Burke,Great Britain,1,0,0,1,2012
Māris Štrombergs,Latvia,1,0,0,1,2012
Kobe Bryant,United States,1,0,0,1,2012
Chris Paul,United States,1,0,0,1,2012
Deron Williams,United States,1,0,0,1,2012
Lauren Cheney,United States,1,0,0,1,2012
Luc Abalo,France,1,0,0,1,2012
Daouda Karaboué,France,1,0,0,1,2012
Max Weinhold,Germany,1,0,0,1,2012
Tobias Hauke,Germany,1,0,0,1,2012
Max Müller,Germany,1,0,0,1,2012
Benjamin Weß,Germany,1,0,0,1,2012
Philipp Zeller,Germany,1,0,0,1,2012
Moritz Fürste,Germany,1,0,0,1,2012
Oliver Korn,Germany,1,0,0,1,2012
Maartje Goderie,Netherlands,1,0,0,1,2012
Maartje Paumen,Netherlands,1,0,0,1,2012
Naomi van As,Netherlands,1,0,0,1,2012
Sophie Polkamp,Netherlands,1,0,0,1,2012
Ellen Hoog,Netherlands,1,0,0,1,2012
Lidewij Welten,Netherlands,1,0,0,1,2012
Eva de Goede,Netherlands,1,0,0,1,2012
Lauren Wenger,United States,1,0,0,1,2012
Kami Craig,United States,1,0,0,1,2012
Jessica Steffens,United States,1,0,0,1,2012
Betsey Armstrong,United States,1,0,0,1,2012
Elsie Windes,United States,1,0,0,1,2012
Maro Joković,Croatia,1,0,0,1,2012
Josip Pavić,Croatia,1,0,0,1,2012
Andro Bušlje,Croatia,1,0,0,1,2012
Miho Bošković,Croatia,1,0,0,1,2012
Aleksandr Volkov,Russian Federation,1,0,0,1,2012
Yury Berezhko,Russian Federation,1,0,0,1,2012
Sergey Grankin,Russian Federation,1,0,0,1,2012
Maksim Mikhaylov,Russian Federation,1,0,0,1,2012
Habiba Ghribi,Tunisia,1,0,0,1,2012
Olga Rypakova,Kazakhstan,1,0,0,1,2012
Jared Tallent,Australia,1,0,0,1,2012
Robert Harting,Germany,1,0,0,1,2012
Jenn Stuczynski-Suhr,United States,1,0,0,1,2012
Sally McLellan-Pearson,Australia,1,0,0,1,2012
Michael Mathieu,The Bahamas,1,0,0,1,2012
Anita Włodarczyk,Poland,1,0,0,1,2012
Brittney Reese,United States,1,0,0,1,2012
Maryam Jamal,Bahrain,1,0,0,1,2012
Nesta Carter,Jamaica,1,0,0,1,2012
Ramon Miller,The Bahamas,1,0,0,1,2012
Jiao Liuyang,People's Republic of China,1,0,0,1,2012
Alain Bernard,France,1,0,0,1,2012
Eric Shanteau,United States,1,0,0,1,2012
Alistair Brownlee,Great Britain,1,0,0,1,2012
Christine Girard,Canada,1,0,0,1,2012
Lydia Valentín,Spain,1,0,0,1,2012
Laura Asadauskaitė,Lithuania,1,0,0,1,2012
David Svoboda,Czech Republic,1,0,0,1,2012
Daniele Molmenti,Italy,1,0,0,1,2012
Dave Smith,Australia,1,0,0,1,2012
Tate Smith,Australia,1,0,0,1,2012
Jacob Clear,Australia,1,0,0,1,2012
Émilie Fer,France,1,0,0,1,2012
Gabriella Szabó,Hungary,1,0,0,1,2012
Ben Maher,Great Britain,1,0,0,1,2012
Rosie MacLennan,Canada,1,0,0,1,2012
Dong Dong,People's Republic of China,1,0,0,1,2012
Yevgeniya Kanayeva,Russian Federation,1,0,0,1,2012
Greg Rutherford,Great Britain,1,0,0,1,2012
Hamid Sourian,Islamic Republic of Iran,1,0,0,1,2012
Ghasem Rezaei,Islamic Republic of Iran,1,0,0,1,2012
Guo Wenjun,People's Republic of China,1,0,0,1,2012
Alin Moldoveanu,Romania,1,0,0,1,2012
Vincent Hancock,United States,1,0,0,1,2012
Wu Jingyu,People's Republic of China,1,0,0,1,2012
Servet Tazegül,Turkey,1,0,0,1,2012
Deng Linlin,People's Republic of China,1,0,0,1,2012
Marina Alabau,Spain,1,0,0,1,2012
Jo Aleh,New Zealand,1,0,0,1,2012
Xu Lijia,People's Republic of China,1,0,0,1,2012
Nathan Outteridge,Australia,1,0,0,1,2012
Tom Slingsby,Australia,1,0,0,1,2012
Erin Cafaro,United States,1,0,0,1,2012
Elle Logan,United States,1,0,0,1,2012
Susan Francia,United States,1,0,0,1,2012
Caroline Lind,United States,1,0,0,1,2012
Florian Mennigen,Germany,1,0,0,1,2012
Kristof Wilke,Germany,1,0,0,1,2012
Richard Schmidt,Germany,1,0,0,1,2012
Yana Shemiakina,Ukraine,1,0,0,1,2012
Ilaria Salvatori,Italy,1,0,0,1,2012
Lei Sheng,People's Republic of China,1,0,0,1,2012
Rubén Limardo,Venezuela,1,0,0,1,2012
Áron Szilágyi,Hungary,1,0,0,1,2012
Raúl Jiménez,Mexico,1,0,0,1,2012
Mansur Isayev,Russian Federation,1,0,0,1,2012
Arsen Galstyan,Russian Federation,1,0,0,1,2012
Tagir Khaybulayev,Russian Federation,1,0,0,1,2012
Nataliya Vorobyova,Russian Federation,1,0,0,1,2012
Yury Postrigay,Russian Federation,1,0,0,1,2012
Bilyal Makhov,Russian Federation,1,0,0,1,2012
Dzhamal Otarsultanov,Russian Federation,1,0,0,1,2012
Roman Vlasov,Russian Federation,1,0,0,1,2012
Anastasiya Bliznyuk,Russian Federation,1,0,0,1,2012
Ulyana Donskova,Russian Federation,1,0,0,1,2012
Kseniya Dudkina,Russian Federation,1,0,0,1,2012
Nikolay Apalikov,Russian Federation,1,0,0,1,2012
Alina Makarenko,Russian Federation,1,0,0,1,2012
Aleksandr Butko,Russian Federation,1,0,0,1,2012
Anastasiya Nazarenko,Russian Federation,1,0,0,1,2012
Karolina Sevastyanova,Russian Federation,1,0,0,1,2012
Dmitry Ilyinykh,Russian Federation,1,0,0,1,2012
Dmitry Musersky,Russian Federation,1,0,0,1,2012
Aleksandr Sokolov,Russian Federation,1,0,0,1,2012
Yegor Mekhontsev,Russian Federation,1,0,0,1,2012
Darya Korobova,Russian Federation,1,0,0,1,2012
Aleksandra Patskevich,Russian Federation,1,0,0,1,2012
Anzhelika Timanina,Russian Federation,1,0,0,1,2012
Alla Shishkina,Russian Federation,1,0,0,1,2012
Yelena Lashmanova,Russian Federation,1,0,0,1,2012
Hitomi Obara,Japan,1,0,0,1,2012
Tatsuhiro Yonemitsu,Japan,1,0,0,1,2012
Ryota Murata,Japan,1,0,0,1,2012
Kirani James,Grenada,1,0,0,1,2012
Aleksandr Dyachenko,Russian Federation,1,0,0,1,2012
Kaori Matsumoto,Japan,1,0,0,1,2012
Alan Khugayev,Russian Federation,1,0,0,1,2012
Anastasiya Kozhenkova,Ukraine,1,0,0,1,2012
Nataliya Dovhodko,Ukraine,1,0,0,1,2012
Stephen Kiprotich,Uganda,1,0,0,1,2012
Katie Taylor,Ireland,1,0,0,1,2012
Adrian Zieliński,Poland,1,0,0,1,2012
Linn Jørum Sulland,Norway,1,0,0,1,2012
Amanda Kurtović,Norway,1,0,0,1,2012
Camilla Herrem,Norway,1,0,0,1,2012
Ida Alstad,Norway,1,0,0,1,2012
Heidi Løke,Norway,1,0,0,1,2012
Sandra Perković,Croatia,1,0,0,1,2012
Max Salminen,Sweden,1,0,0,1,2012
Toğrul Əsgərov,Azerbaijan,1,0,0,1,2012
Şərif Şərifov,Azerbaijan,1,0,0,1,2012
James Thompson,South Africa,1,0,0,1,2012
John Smith,South Africa,1,0,0,1,2012
Sizwe Ndlovu,South Africa,1,0,0,1,2012
Matthew Brittain,South Africa,1,0,0,1,2012
Saeid Mohammadpour,Islamic Republic of Iran,1,0,0,1,2012
Navab Nassirshalal,Islamic Republic of Iran,1,0,0,1,2012
Behdad Salimi,Islamic Republic of Iran,1,0,0,1,2012
Lasha Shavdatuashvili,Georgia,1,0,0,1,2012
Rūta Meilutytė,Lithuania,1,0,0,1,2012
Ma Long,People's Republic of China,1,0,0,1,2012
Zhang Nan,People's Republic of China,1,0,0,1,2012
Tian Qing,People's Republic of China,1,0,0,1,2012
Lin Qingfeng,People's Republic of China,1,0,0,1,2012
Lu Xiaojun,People's Republic of China,1,0,0,1,2012
Wang Mingjuan,People's Republic of China,1,0,0,1,2012
Li Xueying,People's Republic of China,1,0,0,1,2012
Zhou Lulu,People's Republic of China,1,0,0,1,2012
Zhang Chenglong,People's Republic of China,1,0,0,1,2012
Yi Siling,People's Republic of China,1,0,0,1,2012
Milica Mandić,Serbia,1,0,0,1,2012
Arthur Zanetti,Brazil,1,0,0,1,2012
Wang Hao,People's Republic of China,1,0,0,1,2012
Luo Yutong,People's Republic of China,1,0,0,1,2012
Cao Yuan,People's Republic of China,1,0,0,1,2012
Zhang Yanquan,People's Republic of China,1,0,0,1,2012
Hsu Shu-Ching,Chinese Taipei,1,0,0,1,2012
Luo Xiaojuan,People's Republic of China,1,0,0,1,2012
Chen Ding,People's Republic of China,1,0,0,1,2012
Nicola Adams,Great Britain,1,0,0,1,2012
Luke Campbell,Great Britain,1,0,0,1,2012
Anthony Joshua,Great Britain,1,0,0,1,2012
Jade Jones,Great Britain,1,0,0,1,2012
Peter Wilson,Great Britain,1,0,0,1,2012
Adenízia,Brazil,1,0,0,1,2012
Dani Lins,Brazil,1,0,0,1,2012
Fê Garay,Brazil,1,0,0,1,2012
Natália,Brazil,1,0,0,1,2012
Tandara,Brazil,1,0,0,1,2012
Taoufik Makhloufi,Algeria,1,0,0,1,2012
Omid Norouzi,Islamic Republic of Iran,1,0,0,1,2012
Komeil Ghasemi,Islamic Republic of Iran,1,0,0,1,2012
Tim Baillie,Great Britain,1,0,0,1,2012
Etienne Stott,Great Britain,1,0,0,1,2012
Ed McKeever,Great Britain,1,0,0,1,2012
Kat Copeland,Great Britain,1,0,0,1,2012
Sophie Hosking,Great Britain,1,0,0,1,2012
Heather Stanning,Great Britain,1,0,0,1,2012
Jessica Rossi,Italy,1,0,0,1,2012
Sebastián Crismanich,Argentina,1,0,0,1,2012
Giovanni Cernogoraz,Croatia,1,0,0,1,2012
Ivan Buljubašić,Croatia,1,0,0,1,2012
Petar Muslim,Croatia,1,0,0,1,2012
Robeisy Ramírez,Cuba,1,0,0,1,2012
Paulo Obradović,Croatia,1,0,0,1,2012
Sandro Sukno,Croatia,1,0,0,1,2012
Nikša Dobud,Croatia,1,0,0,1,2012
David Rudisha,Kenya,1,0,0,1,2012
Murray Stewart,Australia,1,0,0,1,2012
Caster Semenya,South Africa,1,0,0,1,2012
Valerio Aspromonte,Italy,1,0,0,1,2012
Andrea Baldini,Italy,1,0,0,1,2012
Tiki Gelana,Ethiopia,1,0,0,1,2012
Dani King,Great Britain,1,0,0,1,2012
Joanna Rowsell Shand,Great Britain,1,0,0,1,2012
Jessica Ennis-Hill,Great Britain,1,0,0,1,2012
Mathew Belcher,Australia,1,0,0,1,2012
Iain Jensen,Australia,1,0,0,1,2012
Helen Glover,Great Britain,1,0,0,1,2012
Joel González,Spain,1,0,0,1,2012
Kim Jang-Mi,Republic of Korea,1,0,0,1,2012
Choi Hyeon-Ju,Republic of Korea,1,0,0,1,2012
Song Dae-Nam,Republic of Korea,1,0,0,1,2012
Israel Jiménez,Mexico,1,0,0,1,2012
Carlos Salcido,Mexico,1,0,0,1,2012
Hiram Mier,Mexico,1,0,0,1,2012
Miguel Ponce,Mexico,1,0,0,1,2012
Darvin Chávez,Mexico,1,0,0,1,2012
Javier Aquino,Mexico,1,0,0,1,2012
Javier Cortés,Mexico,1,0,0,1,2012
Néstor Vidrio,Mexico,1,0,0,1,2012
Diego Reyes,Mexico,1,0,0,1,2012
Héctor Herrera,Mexico,1,0,0,1,2012
Jorge Enríquez,Mexico,1,0,0,1,2012
Oribe Peralta,Mexico,1,0,0,1,2012
Giovani dos Santos,Mexico,1,0,0,1,2012
Marco Fabián,Mexico,1,0,0,1,2012
Kim Ji-Yeon,Republic of Korea,1,0,0,1,2012
Gu Bon-Gil,Republic of Korea,1,0,0,1,2012
Kim Jeong-Hwan,Republic of Korea,1,0,0,1,2012
Won U-Yeong,Republic of Korea,1,0,0,1,2012
Yang Hak-Seon,Republic of Korea,1,0,0,1,2012
Fernandinha,Brazil,1,0,0,1,2012
Lasse Norman Hansen,Denmark,1,0,0,1,2012
Merel de Blaey,Netherlands,1,0,0,1,2012
Carlien Dirkse van den Heuvel,Netherlands,1,0,0,1,2012
Margot van Geffen,Netherlands,1,0,0,1,2012
Kelly Jonker,Netherlands,1,0,0,1,2012
Kim Lammers,Netherlands,1,0,0,1,2012
Caia van Maasakker,Netherlands,1,0,0,1,2012
Kitty van Male,Netherlands,1,0,0,1,2012
Joyce Sombroek,Netherlands,1,0,0,1,2012
Dorian van Rijsselberge,Netherlands,1,0,0,1,2012
Oskar Deecke,Germany,1,0,0,1,2012
Florian Fuchs,Germany,1,0,0,1,2012
Martin Häner,Germany,1,0,0,1,2012
Jan Philipp Rabente,Germany,1,0,0,1,2012
Thilo Stralkowski,Germany,1,0,0,1,2012
Christopher Wesley,Germany,1,0,0,1,2012
Mariana Pajón,Colombia,1,0,0,1,2012
Julie Bresset,France,1,0,0,1,2012
Tamara Echegoyen,Spain,1,0,0,1,2012
Ángela Pumariega,Spain,1,0,0,1,2012
Sofía Toro,Spain,1,0,0,1,2012
William Accambray,France,1,0,0,1,2012
Xavier Barachet,France,1,0,0,1,2012
Samuel Honrubia,France,1,0,0,1,2012
Guillaume Joli,France,1,0,0,1,2012
Cédric Sorhaindo,France,1,0,0,1,2012
Kim Hyeon-U,Republic of Korea,1,0,0,1,2012
Sebastian Brendel,Germany,1,0,0,1,2012
Peter Kretschmer,Germany,1,0,0,1,2012
Kurt Kuschela,Germany,1,0,0,1,2012
Demetrius Pinder,The Bahamas,1,0,0,1,2012
Tim Grohmann,Germany,1,0,0,1,2012
Eric Johannesen,Germany,1,0,0,1,2012
Andreas Kuffner,Germany,1,0,0,1,2012
Lukas Müller,Germany,1,0,0,1,2012
Maximilian Reinelt,Germany,1,0,0,1,2012
Martin Sauer,Germany,1,0,0,1,2012
Lauritz Schoof,Germany,1,0,0,1,2012
Karl Schulze,Germany,1,0,0,1,2012
Philipp Wende,Germany,1,0,0,1,2012
Kristina Vogel,Germany,1,0,0,1,2012
Miriam Welte,Germany,1,0,0,1,2012
Scott Brash,Great Britain,1,0,0,1,2012
Yolane Kukla,Australia,1,0,0,1,2012
Dirk Schrade,Germany,1,0,0,1,2012
Rudolf Dombi,Hungary,1,0,0,1,2012
Krisztina Fazekas Zur,Hungary,1,0,0,1,2012
Florent Manaudou,France,1,0,0,1,2012
Renaud Lavillenie,France,1,0,0,1,2012
Keshorn Walcott,Trinidad and Tobago,1,0,0,1,2012
Kemar Bailey-Cole,Jamaica,1,0,0,1,2012
Russell Westbrook,United States,1,0,0,1,2012
Andre Iguodala,United States,1,0,0,1,2012
Kevin Durant,United States,1,0,0,1,2012
Tyson Chandler,United States,1,0,0,1,2012
Lisa Carrington,New Zealand,1,0,0,1,2012
Polly Powrie,New Zealand,1,0,0,1,2012
Li Xuerui,People's Republic of China,1,0,0,1,2012
Joseph Sullivan,New Zealand,1,0,0,1,2012
Alex Gregory,Great Britain,1,0,0,1,2012
Peter Kennaugh,Great Britain,1,0,0,1,2012
Kelley O'Hara,United States,1,0,0,1,2012
Jeneba Tarmoh,United States,1,0,0,1,2012
Tianna Madison-Bartoletta,United States,1,0,0,1,2012
Megan Rapinoe,United States,1,0,0,1,2012
Bianca Knight,United States,1,0,0,1,2012
Claire Donahue,United States,1,0,0,1,2012
Becky Sauerbrunn,United States,1,0,0,1,2012
Amy LePeilbet,United States,1,0,0,1,2012
Sydney Leroux,United States,1,0,0,1,2012
Francena McCorory,United States,1,0,0,1,2012
Krisztián Berki,Hungary,1,0,0,1,2012
Lindsay Whalen,United States,1,0,0,1,2012
Jordyn Wieber,United States,1,0,0,1,2012
Angel McCoughtry,United States,1,0,0,1,2012
Aries Merritt,United States,1,0,0,1,2012
Maya Moore,United States,1,0,0,1,2012
Alex Morgan,United States,1,0,0,1,2012
Christian Taylor,United States,1,0,0,1,2012
Lauren Perdue,United States,1,0,0,1,2012
Meghan Musnicki,United States,1,0,0,1,2012
Matt McLean,United States,1,0,0,1,2012
Claressa Shields,United States,1,0,0,1,2012
Esther Lofgren,United States,1,0,0,1,2012
Jake Varner,United States,1,0,0,1,2012
Asjha Jones,United States,1,0,0,1,2012
Katie Ledecky,United States,1,0,0,1,2012
Kevin Love,United States,1,0,0,1,2012
Annika Dries,United States,1,0,0,1,2012
Conor Dwyer,United States,1,0,0,1,2012
Ashton Eaton,United States,1,0,0,1,2012
Alyssa Anderson,United States,1,0,0,1,2012
Keshia Baker,United States,1,0,0,1,2012
Rachel Bootsma,United States,1,0,0,1,2012
Tina Charles,United States,1,0,0,1,2012
Kyla Ross,United States,1,0,0,1,2012
Melissa Seidemann,United States,1,0,0,1,2012
Maggie Steffens,United States,1,0,0,1,2012
Davis Tarwater,United States,1,0,0,1,2012
Taylor Ritzel,United States,1,0,0,1,2012
Courtney Mathewson,United States,1,0,0,1,2012
Tyler McGill,United States,1,0,0,1,2012
Kayla Harrison,United States,1,0,0,1,2012
Charlie Houchin,United States,1,0,0,1,2012
Tyler Clary,United States,1,0,0,1,2012
Breeja Larson,United States,1,0,0,1,2012
Jordan Burroughs,United States,1,0,0,1,2012
Philip Hindes,Great Britain,1,0,0,1,2012
Om Yun-Chol,Democratic People's Republic of Korea,1,0,0,1,2012
Kim Un-Guk,Democratic People's Republic of Korea,1,0,0,1,2012
Rim Jong-Sim,Democratic People's Republic of Korea,1,0,0,1,2012
James Harden,United States,1,0,0,1,2012
Anthony Davis,United States,1,0,0,1,2012
Diamond Dixon,United States,1,0,0,1,2012
Shannon Vreeland,United States,1,0,0,1,2012
Guo Weiyang,People's Republic of China,1,0,0,1,2012
Giorgio Avola,Italy,1,0,0,1,2012
Xu Anqi,People's Republic of China,1,0,0,1,2012
Aleksey Obmochayev,Russian Federation,1,0,0,1,2012
Guo Shuang,People's Republic of China,0,2,1,3,2012
Ryosuke Irie,Japan,0,2,1,3,2012
İnna Osipenko-Radomska,Azerbaijan,0,2,0,2,2012
Park Tae-Hwan,Republic of Korea,0,2,0,2,2012
Gerco Schröder,Netherlands,0,2,0,2,2012
Marcel Nguyen,Germany,0,2,0,2,2012
Mireia Belmonte,Spain,0,2,0,2,2012
Sarah Hammer,United States,0,2,0,2,2012
Grégory Baugé,France,0,2,0,2,2012
Aliaksandra Herasimenia,Belarus,0,2,0,2,2012
Viktoriya Komova,Russian Federation,0,2,0,2,2012
Satomi Suzuki,Japan,0,1,2,3,2012
Veronica Campbell-Brown,Jamaica,0,1,1,2,2012
Vivian Cheruiyot,Kenya,0,1,1,2,2012
Natasa Dusev-Janics,Hungary,0,1,1,2,2012
Takeshi Matsuda,Japan,0,1,1,2,2012
Marleen Veldhuis,Netherlands,0,1,1,2,2012
Cătălina Ponor,Romania,0,1,1,2,2012
Andrea Fuentes,Spain,0,1,1,2,2012
Louis Smith,Great Britain,0,1,1,2,2012
Christian Sprenger,Australia,0,1,1,2,2012
Elizabeth Beisel,United States,0,1,1,2,2012
Kim Crow-Brennan,Australia,0,1,1,2,2012
Maximilian Levy,Germany,0,1,1,2,2012
Bronte Barratt,Australia,0,1,1,2,2012
Huang Xuechen,People's Republic of China,0,1,1,2,2012
Liu Ou,People's Republic of China,0,1,1,2,2012
Diego Occhiuzzi,Italy,0,1,1,2,2012
Denis Ablyazin,Russian Federation,0,1,1,2,2012
Ona Carbonell,Spain,0,1,1,2,2012
James Magnussen,Australia,0,1,1,2,2012
Adelinde Cornelissen,Netherlands,0,1,1,2,2012
Will Claye,United States,0,1,1,2,2012
Mariya Paseka,Russian Federation,0,1,1,2,2012
Zoltán Kammerer,Hungary,0,1,0,1,2012
Mary Thomson-King,Great Britain,0,1,0,1,2012
William Fox-Pitt,Great Britain,0,1,0,1,2012
Judith Arndt,Germany,0,1,0,1,2012
Teun de Nooijer,Netherlands,0,1,0,1,2012
Homare Sawa,Japan,0,1,0,1,2012
Drew Ginn,Australia,0,1,0,1,2012
Lesley Thompson-Willie,Canada,0,1,0,1,2012
Emanuel,Brazil,0,1,0,1,2012
Danielle Scott-Arruda,United States,0,1,0,1,2012
Tatyana Tomashova,Russian Federation,0,1,0,1,2012
Primož Kozmus,Slovenia,0,1,0,1,2012
Marc Burns,Trinidad and Tobago,0,1,0,1,2012
Angelo Taylor,United States,0,1,0,1,2012
Juan Carlos Navarro,Spain,0,1,0,1,2012
Edwige Lawson-Wade,France,0,1,0,1,2012
Katrin Wagner-Augustin,Germany,0,1,0,1,2012
Sabine Spitz,Germany,0,1,0,1,2012
Lucha Aymar,Argentina,0,1,0,1,2012
Alessio Sartori,Italy,0,1,0,1,2012
Nick Dempsey,Great Britain,0,1,0,1,2012
Iain Percy,Great Britain,0,1,0,1,2012
Leisel Jones,Australia,0,1,0,1,2012
Kosuke Kitajima,Japan,0,1,0,1,2012
Jason Lezak,United States,0,1,0,1,2012
Oh Sang-Eun,Republic of Korea,0,1,0,1,2012
Yu Seung-Min,Republic of Korea,0,1,0,1,2012
Roger Federer,Switzerland,0,1,0,1,2012
Dante,Brazil,0,1,0,1,2012
Giba,Brazil,0,1,0,1,2012
Logan Tom,United States,0,1,0,1,2012
Stefano Tempesti,Italy,0,1,0,1,2012
Karina Maruyama,Japan,0,1,0,1,2012
Kozue Ando,Japan,0,1,0,1,2012
Takaharu Furukawa,Japan,0,1,0,1,2012
Thiago Pereira,Brazil,0,1,0,1,2012
Inge Dekker,Netherlands,0,1,0,1,2012
Hiromi Miyake,Japan,0,1,0,1,2012
Óscar Figueroa,Colombia,0,1,0,1,2012
Yevgeny Korotyshkin,Russian Federation,0,1,0,1,2012
Jonas Høgh Christensen,Denmark,0,1,0,1,2012
Thomas Lurz,Germany,0,1,0,1,2012
Darcy Marquardt,Canada,0,1,0,1,2012
Britta Oppelt,Germany,0,1,0,1,2012
Xu Dongxiang,People's Republic of China,0,1,0,1,2012
Sarah Outhwaite-Tait,Australia,0,1,0,1,2012
Andréanne Morin,Canada,0,1,0,1,2012
Ondřej Synek,Czech Republic,0,1,0,1,2012
Mark Hunter,Great Britain,0,1,0,1,2012
Brian Price,Canada,0,1,0,1,2012
Chen Ying,People's Republic of China,0,1,0,1,2012
Wei Ning,People's Republic of China,0,1,0,1,2012
Sylwia Bogacka,Poland,0,1,0,1,2012
Håkan Dahlby,Sweden,0,1,0,1,2012
Sherone Simpson,Jamaica,0,1,0,1,2012
Li Yanfeng,People's Republic of China,0,1,0,1,2012
Lashinda Demus,United States,0,1,0,1,2012
Novlene Williams-Mills,Jamaica,0,1,0,1,2012
Christine Ohuruogu,Great Britain,0,1,0,1,2012
Carolin Leonhardt,Germany,0,1,0,1,2012
Adam Van Koeverden,Canada,0,1,0,1,2012
Emanuel Silva,Portugal,0,1,0,1,2012
Raman Piatrushenka,Belarus,0,1,0,1,2012
Vadzim Makhneu,Belarus,0,1,0,1,2012
David Cal,Spain,0,1,0,1,2012
Aliaksandr Bahdanovich,Belarus,0,1,0,1,2012
Betty Heidler,Germany,0,1,0,1,2012
Lee Chong Wei,Malaysia,0,1,0,1,2012
Britta Heidemann,Germany,0,1,0,1,2012
Yuki Ota,Japan,0,1,0,1,2012
Clemente Russo,Italy,0,1,0,1,2012
Roberto Cammarelle,Italy,0,1,0,1,2012
Alina Dumitru,Romania,0,1,0,1,2012
Christina Obergföll,Germany,0,1,0,1,2012
Miklós Ungvári,Hungary,0,1,0,1,2012
Jennie Reed,United States,0,1,0,1,2012
Sara Algotsson Ostholt,Sweden,0,1,0,1,2012
Caterine Ibargüen,Colombia,0,1,0,1,2012
Fabian Hambüchen,Germany,0,1,0,1,2012
Michaël Llodra,France,0,1,0,1,2012
Ai Fukuhara,Japan,0,1,0,1,2012
Ju Se-Hyeok,Republic of Korea,0,1,0,1,2012
Tonya Verbeek,Canada,0,1,0,1,2012
Stanka Zlateva,Bulgaria,0,1,0,1,2012
Karam Gaber,Egypt,0,1,0,1,2012
Paola Espinosa,Mexico,0,1,0,1,2012
Sushil Kumar,India,0,1,0,1,2012
Brigitte Yagüe,Spain,0,1,0,1,2012
José Manuel Calderón,Spain,0,1,0,1,2012
Rudy Fernández,Spain,0,1,0,1,2012
Pau Gasol,Spain,0,1,0,1,2012
Felipe Reyes,Spain,0,1,0,1,2012
Huang Shanshan,People's Republic of China,0,1,0,1,2012
Kyoko Yano,Japan,0,1,0,1,2012
Floris Evers,Netherlands,0,1,0,1,2012
Lindsey Berg,United States,0,1,0,1,2012
Tayyiba Haneef-Park,United States,0,1,0,1,2012
Ricardinho,Brazil,0,1,0,1,2012
Rodrigão,Brazil,0,1,0,1,2012
Serginho,Brazil,0,1,0,1,2012
Pietro Figlioli,Australia,0,1,0,1,2012
Danijel Premuš,Croatia,0,1,0,1,2012
Maurizio Felugo,Italy,0,1,0,1,2012
Miho Fukumoto,Japan,0,1,0,1,2012
Yukari Kinga,Japan,0,1,0,1,2012
Azusa Iwashimizu,Japan,0,1,0,1,2012
Aya Miyama,Japan,0,1,0,1,2012
Mizuho Sakaguchi,Japan,0,1,0,1,2012
Shinobu Ohno,Japan,0,1,0,1,2012
Yuki Nagasato-Ogimi,Japan,0,1,0,1,2012
Marcelo,Brazil,0,1,0,1,2012
Alexandre Pato,Brazil,0,1,0,1,2012
Aída Román,Mexico,0,1,0,1,2012
Brady Ellison,United States,0,1,0,1,2012
Rigoberto Urán,Colombia,0,1,0,1,2012
Tina Cook,Great Britain,0,1,0,1,2012
Nicole Davis,United States,0,1,0,1,2012
Ryan Cochrane,Canada,0,1,0,1,2012
Hinkelien Schreuder,Netherlands,0,1,0,1,2012
Femke Heemskerk,Netherlands,0,1,0,1,2012
Germain Chardin,France,0,1,0,1,2012
Annekatrin Thiele,Germany,0,1,0,1,2012
Sofya Velikaya,Russian Federation,0,1,0,1,2012
Yanet Bermoy,Cuba,0,1,0,1,2012
Asley González,Cuba,0,1,0,1,2012
Ole Bischof,Germany,0,1,0,1,2012
Hiroaki Hiraoka,Japan,0,1,0,1,2012
Naidangiin Tüvshinbayar,Mongolia,0,1,0,1,2012
Han Sun-Cheol,Republic of Korea,0,1,0,1,2012
John Joe Nevin,Ireland,0,1,0,1,2012
Sarah Walker,New Zealand,0,1,0,1,2012
Kévin Sireau,France,0,1,0,1,2012
Jack Bobridge,Australia,0,1,0,1,2012
Nino Schurter,Switzerland,0,1,0,1,2012
Marc Gasol,Spain,0,1,0,1,2012
Thiago Silva,Brazil,0,1,0,1,2012
Roderick Weusthof,Netherlands,0,1,0,1,2012
Robert van der Horst,Netherlands,0,1,0,1,2012
Noel Barrionuevo,Argentina,0,1,0,1,2012
Carla Rebecchi,Argentina,0,1,0,1,2012
Rosario Luchetti,Argentina,0,1,0,1,2012
Valentino Gallo,Italy,0,1,0,1,2012
Murilo,Brazil,0,1,0,1,2012
Bruninho,Brazil,0,1,0,1,2012
Lilli Schwarzkopf,Germany,0,1,0,1,2012
Sofia Assefa,Ethiopia,0,1,0,1,2012
Richard Thompson,Trinidad and Tobago,0,1,0,1,2012
Leo Manzano,United States,0,1,0,1,2012
Mahiedine Mekhissi-Benabbad,France,0,1,0,1,2012
Ehsan Haddadi,Islamic Republic of Iran,0,1,0,1,2012
Kerron Stewart,Jamaica,0,1,0,1,2012
Gong Lijiao,People's Republic of China,0,1,0,1,2012
Yarisley Silva,Cuba,0,1,0,1,2012
Rosemarie Whyte,Jamaica,0,1,0,1,2012
Shericka Williams,Jamaica,0,1,0,1,2012
Dawn Harper,United States,0,1,0,1,2012
Galen Rupp,United States,0,1,0,1,2012
Shereefa Lloyd,Jamaica,0,1,0,1,2012
Trey Hardee,United States,0,1,0,1,2012
Si Tianfeng,People's Republic of China,0,1,0,1,2012
Keston Bledman,Trinidad and Tobago,0,1,0,1,2012
Emmanuel Callender,Trinidad and Tobago,0,1,0,1,2012
Grégory Mallet,France,0,1,0,1,2012
Takuro Fujii,Japan,0,1,0,1,2012
Anastasiya Zuyeva-Fesikova,Russian Federation,0,1,0,1,2012
Kylie Palmer,Australia,0,1,0,1,2012
Kelci Bryant,United States,0,1,0,1,2012
Germán Sánchez,Mexico,0,1,0,1,2012
Jiang Tingting,People's Republic of China,0,1,0,1,2012
Jiang Wenwen,People's Republic of China,0,1,0,1,2012
Luo Xi,People's Republic of China,0,1,0,1,2012
Lisa Nordén,Sweden,0,1,0,1,2012
Javier Gómez,Spain,0,1,0,1,2012
Abir Abdulrahman,Egypt,0,1,0,1,2012
Triyatno,Indonesia,0,1,0,1,2012
Bartłomiej Bonk,Poland,0,1,0,1,2012
Cao Zhongrong,People's Republic of China,0,1,0,1,2012
David Florence,Great Britain,0,1,0,1,2012
Vavřinec Hradilek,Czech Republic,0,1,0,1,2012
Andrei Bahdanovich,Belarus,0,1,0,1,2012
Saúl Craviotto,Spain,0,1,0,1,2012
Marc Houtzager,Netherlands,0,1,0,1,2012
Angie Bainbridge,Australia,0,1,0,1,2012
Dmitry Ushakov,Russian Federation,0,1,0,1,2012
Anastasiya Ivankova,Belarus,0,1,0,1,2012
Kseniya Sankovich,Belarus,0,1,0,1,2012
Alina Tumilovich,Belarus,0,1,0,1,2012
Mariya Stadnik,Azerbaijan,0,1,0,1,2012
Besik Kudukhov,Russian Federation,0,1,0,1,2012
Rövşən Bayramov,Azerbaijan,0,1,0,1,2012
Tamás Lőrincz,Hungary,0,1,0,1,2012
Arsen Julfalakyan,Armenia,0,1,0,1,2012
Zuzana Štefečeková,Slovakia,0,1,0,1,2012
Anders Golding,Denmark,0,1,0,1,2012
Sayaka Hirano,Japan,0,1,0,1,2012
He Kexin,People's Republic of China,0,1,0,1,2012
Kseniya Afanasyeva,Russian Federation,0,1,0,1,2012
Saskia Clark,Great Britain,0,1,0,1,2012
Tuuli Petäjä,Finland,0,1,0,1,2012
Peter Burling,New Zealand,0,1,0,1,2012
Pavlos Kontides,Cyprus,0,1,0,1,2012
Andrew Simpson,Great Britain,0,1,0,1,2012
Rachelle De Jong-Viinberg,Canada,0,1,0,1,2012
Janine Hanson,Canada,0,1,0,1,2012
Krista Guloien,Canada,0,1,0,1,2012
Brooke Pratley,Australia,0,1,0,1,2012
Kate Hornsey,Australia,0,1,0,1,2012
Ashley Brzozowicz,Canada,0,1,0,1,2012
Zac Purchase,Great Britain,0,1,0,1,2012
Richard Chambers,Great Britain,0,1,0,1,2012
James Chapman,Australia,0,1,0,1,2012
Andrew Byrnes,Canada,0,1,0,1,2012
Malcolm Howard,Canada,0,1,0,1,2012
Jeong Hyo-Jeong,Republic of Korea,0,1,0,1,2012
Aida Shanayeva,Russian Federation,0,1,0,1,2012
Kenta Chida,Japan,0,1,0,1,2012
Rareș Dumitrescu,Romania,0,1,0,1,2012
Dorian Mortelette,France,0,1,0,1,2012
Bartosz Piasecki,Norway,0,1,0,1,2012
Choi Yeong-Rae,Republic of Korea,0,1,0,1,2012
Vladimer Khinchegashvili,Georgia,0,1,0,1,2012
Revaz Lashkhi,Georgia,0,1,0,1,2012
Aleksandr Mikhaylin,Russian Federation,0,1,0,1,2012
Kamilla Gafurzyanova,Russian Federation,0,1,0,1,2012
Inna Deriglazova,Russian Federation,0,1,0,1,2012
Tatyana Kashirina,Russian Federation,0,1,0,1,2012
Sofya Ochigava,Russian Federation,0,1,0,1,2012
Nadezhda Torlopova,Russian Federation,0,1,0,1,2012
Anastasiya Grishina,Russian Federation,0,1,0,1,2012
Ryo Miyake,Japan,0,1,0,1,2012
Kasumi Ishikawa,Japan,0,1,0,1,2012
Mizuki Fujii,Japan,0,1,0,1,2012
Reika Kakiiwa,Japan,0,1,0,1,2012
Yevgeny Kuznetsov,Russian Federation,0,1,0,1,2012
Antti Ruuskanen,Finland,0,1,0,1,2012
Kazuhito Tanaka,Japan,0,1,0,1,2012
Koji Yamamuro,Japan,0,1,0,1,2012
Yusuke Tanaka,Japan,0,1,0,1,2012
Ryohei Kato,Japan,0,1,0,1,2012
Mana Iwabuchi,Japan,0,1,0,1,2012
Ayumi Kaihori,Japan,0,1,0,1,2012
Nahomi Kawasumi,Japan,0,1,0,1,2012
Megumi Takase,Japan,0,1,0,1,2012
Asuna Tanaka,Japan,0,1,0,1,2012
Saki Kumagai,Japan,0,1,0,1,2012
Aya Sameshima,Japan,0,1,0,1,2012
Schillonie Calvert,Jamaica,0,1,0,1,2012
Milka Maneva,Bulgaria,0,1,0,1,2012
Mariya Sharapova,Russian Federation,0,1,0,1,2012
Riki Nakaya,Japan,0,1,0,1,2012
Mika Sugimoto,Japan,0,1,0,1,2012
Natallia Leshchyk,Belarus,0,1,0,1,2012
Maryna Hancharova,Belarus,0,1,0,1,2012
Aliaksandra Narkevich,Belarus,0,1,0,1,2012
Anthony Obame,Gabon,0,1,0,1,2012
Rustam Totrov,Russian Federation,0,1,0,1,2012
Luguelín Santos,Dominican Republic,0,1,0,1,2012
Florin Zalomir,Romania,0,1,0,1,2012
Bojana Popović,Montenegro,0,1,0,1,2012
Anđela Bulatović,Montenegro,0,1,0,1,2012
Ana Đokić,Montenegro,0,1,0,1,2012
Ana Radović,Montenegro,0,1,0,1,2012
Suzana Lazović,Montenegro,0,1,0,1,2012
Sonja Barjaktarović,Montenegro,0,1,0,1,2012
Corina Căprioriu,Romania,0,1,0,1,2012
Radmila Miljanić-Petrović,Montenegro,0,1,0,1,2012
Milena Knežević-Raičević,Montenegro,0,1,0,1,2012
Marina Vukčević-Rajčić,Montenegro,0,1,0,1,2012
Majda Mehmedović,Montenegro,0,1,0,1,2012
Maja Savić,Montenegro,0,1,0,1,2012
Katarina Bulatović,Montenegro,0,1,0,1,2012
Valeriy Andriytsev,Ukraine,0,1,0,1,2012
Martin Sinković,Croatia,0,1,0,1,2012
Pimsiri Sirikaew,Thailand,0,1,0,1,2012
Valent Sinković,Croatia,0,1,0,1,2012
Marija Jovanović,Montenegro,0,1,0,1,2012
Denys Berinchyk,Ukraine,0,1,0,1,2012
Tiberiu Dolniceanu,Romania,0,1,0,1,2012
Sajjad Anoushiravani,Islamic Republic of Iran,0,1,0,1,2012
Kianoush Rostami,Islamic Republic of Iran,0,1,0,1,2012
Mohammad Bagheri Motamed,Islamic Republic of Iran,0,1,0,1,2012
Jova Radičević,Montenegro,0,1,0,1,2012
Kim Min-Jae,Republic of Korea,0,1,0,1,2012
Priscah Jeptoo,Kenya,0,1,0,1,2012
Heiki Nabi,Estonia,0,1,0,1,2012
Damir Martin,Croatia,0,1,0,1,2012
Yelena Sokolova,Russian Federation,0,1,0,1,2012
Wang Yihan,People's Republic of China,0,1,0,1,2012
Xu Chen,People's Republic of China,0,1,0,1,2012
Ma Jin,People's Republic of China,0,1,0,1,2012
Gong Jinjie,People's Republic of China,0,1,0,1,2012
Wu Jingbiao,People's Republic of China,0,1,0,1,2012
Lu Haojie,People's Republic of China,0,1,0,1,2012
Huang Wenyi,People's Republic of China,0,1,0,1,2012
Hou Yuzhuo,People's Republic of China,0,1,0,1,2012
Kaeo Pongprayoon,Thailand,0,1,0,1,2012
Sui Lu,People's Republic of China,0,1,0,1,2012
Ren Cancan,People's Republic of China,0,1,0,1,2012
Ivana Maksimović-Anđušić,Serbia,0,1,0,1,2012
Esquiva Florentino,Brazil,0,1,0,1,2012
Anne-Caroline Graffe,France,0,1,0,1,2012
Amaurys Perez,Italy,0,1,0,1,2012
Niccolò Gitto,Italy,0,1,0,1,2012
Alex Giorgetti,Italy,0,1,0,1,2012
Christian Presciutti,Italy,0,1,0,1,2012
Deni Fiorentini,Italy,0,1,0,1,2012
Matteo Aicardi,Italy,0,1,0,1,2012
Giacomo Pastorino,Italy,0,1,0,1,2012
Massimo Giacoppo,Italy,0,1,0,1,2012
Qiu Bo,People's Republic of China,0,1,0,1,2012
Cheng Ming,People's Republic of China,0,1,0,1,2012
Fang Yuting,People's Republic of China,0,1,0,1,2012
Xu Jing,People's Republic of China,0,1,0,1,2012
Lu Ying,People's Republic of China,0,1,0,1,2012
Wu Yiwen,People's Republic of China,0,1,0,1,2012
Sun Wenyan,People's Republic of China,0,1,0,1,2012
Chang Si,People's Republic of China,0,1,0,1,2012
Chen Xiaojun,People's Republic of China,0,1,0,1,2012
Jo-Wilfried Tsonga,France,0,1,0,1,2012
Qieyang Shijie,People's Republic of China,0,1,0,1,2012
Xu Lili,People's Republic of China,0,1,0,1,2012
Samantha Murray,Great Britain,0,1,0,1,2012
Fred Evans,Great Britain,0,1,0,1,2012
Gabe Bergen,Canada,0,1,0,1,2012
Jeremiah Brown,Canada,0,1,0,1,2012
Will Crothers,Canada,0,1,0,1,2012
Rob Gibson,Canada,0,1,0,1,2012
Lauren Wilkinson,Canada,0,1,0,1,2012
Jing Ruixue,People's Republic of China,0,1,0,1,2012
Sadegh Goudarzi,Islamic Republic of Iran,0,1,0,1,2012
Alison,Brazil,0,1,0,1,2012
Fie Udby Erichsen,Denmark,0,1,0,1,2012
Mathias Boe,Denmark,0,1,0,1,2012
Laura Robson,Great Britain,0,1,0,1,2012
Gemma Gibbons,Great Britain,0,1,0,1,2012
Romano Battisti,Italy,0,1,0,1,2012
David Šain,Croatia,0,1,0,1,2012
Erick Barrondo,Guatemala,0,1,0,1,2012
Fernando Pimenta,Portugal,0,1,0,1,2012
Richard Hounslow,Great Britain,0,1,0,1,2012
Chris Bartley,Great Britain,0,1,0,1,2012
Peter Chambers,Great Britain,0,1,0,1,2012
Rob Williams,Great Britain,0,1,0,1,2012
Massimo Fabbrizi,Italy,0,1,0,1,2012
Alejandra Orozco,Mexico,0,1,0,1,2012
Iván García,Mexico,0,1,0,1,2012
Alaaeldin Abouelkassem,Egypt,0,1,0,1,2012
Stuart Bithell,Great Britain,0,1,0,1,2012
Hannah Mills,Great Britain,0,1,0,1,2012
Luke Patience,Great Britain,0,1,0,1,2012
Nyambayaryn Tögstsogt,Mongolia,0,1,0,1,2012
Nijel Amos,Botswana,0,1,0,1,2012
Macarena Rodríguez,Argentina,0,1,0,1,2012
Sofía Maccari,Argentina,0,1,0,1,2012
Flor Mutio,Argentina,0,1,0,1,2012
Silvina D'Elia,Argentina,0,1,0,1,2012
Maru Scarone,Argentina,0,1,0,1,2012
Dani Sruoga,Argentina,0,1,0,1,2012
Rocío Sánchez,Argentina,0,1,0,1,2012
Delfina Merino,Argentina,0,1,0,1,2012
Luca Tesconi,Italy,0,1,0,1,2012
Martina Cavallero,Argentina,0,1,0,1,2012
Jose Sruoga,Argentina,0,1,0,1,2012
Florencia Habif,Argentina,0,1,0,1,2012
Mitch Watt,Australia,0,1,0,1,2012
Jess Fox,Australia,0,1,0,1,2012
Brittany Broben,Australia,0,1,0,1,2012
Glenn O'Shea,Australia,0,1,0,1,2012
Sam Willoughby,Australia,0,1,0,1,2012
Rohan Dennis,Australia,0,1,0,1,2012
Michael Hepburn,Australia,0,1,0,1,2012
Joshua Dunkley-Smith,Australia,0,1,0,1,2012
William Lockwood,Australia,0,1,0,1,2012
Dejen Gebremeskel,Ethiopia,0,1,0,1,2012
Douglas Csima,Canada,0,1,0,1,2012
Natalie Mastracci,Canada,0,1,0,1,2012
Abel Kirui,Kenya,0,1,0,1,2012
Sally Kipyego,Kenya,0,1,0,1,2012
Nina Curtis,Australia,0,1,0,1,2012
Olivia Price,Australia,0,1,0,1,2012
Lucinda Whitty,Australia,0,1,0,1,2012
Johan Sjöstrand,Sweden,0,1,0,1,2012
Fredrik Petersen,Sweden,0,1,0,1,2012
Andreas Nilsson,Sweden,0,1,0,1,2012
Jonas Larholm,Sweden,0,1,0,1,2012
Jonas Källman,Sweden,0,1,0,1,2012
Tobias Karlsson,Sweden,0,1,0,1,2012
Magnus Jernemyr,Sweden,0,1,0,1,2012
Johan Jakobsson,Sweden,0,1,0,1,2012
Mattias Gustafsson,Sweden,0,1,0,1,2012
Niclas Ekberg,Sweden,0,1,0,1,2012
Dalibor Doder,Sweden,0,1,0,1,2012
Nur Tatar,Turkey,0,1,0,1,2012
Mattias Andersson,Sweden,0,1,0,1,2012
Kim Andersson,Sweden,0,1,0,1,2012
Kim Ekdahl du Rietz,Sweden,0,1,0,1,2012
Nicolás García,Spain,0,1,0,1,2012
Michael Jamieson,Great Britain,0,1,0,1,2012
Kim Jong-Hyeon,Republic of Korea,0,1,0,1,2012
Sin A-Ram,Republic of Korea,0,1,0,1,2012
Choi In-Jeong,Republic of Korea,0,1,0,1,2012
Lee Dae-Hun,Republic of Korea,0,1,0,1,2012
Carsten Mogensen,Denmark,0,1,0,1,2012
Citra Febrianti,Indonesia,0,1,0,1,2012
Clémence Beikes,France,0,1,0,1,2012
Jennifer Digbeu,France,0,1,0,1,2012
Céline Dumerc,France,0,1,0,1,2012
Élodie Godin,France,0,1,0,1,2012
Sandrine Gruda,France,0,1,0,1,2012
Émilie Gomis,France,0,1,0,1,2012
Marion Laborde,France,0,1,0,1,2012
Florence Lepron,France,0,1,0,1,2012
Endéné Miyem,France,0,1,0,1,2012
Emmeline Ndongue,France,0,1,0,1,2012
Isabelle Yacoubou,France,0,1,0,1,2012
Jaime Espinal,Puerto Rico,0,1,0,1,2012
Kerstin Thiele,Germany,0,1,0,1,2012
Vijay Kumar,India,0,1,0,1,2012
Marta Bach,Spain,0,1,0,1,2012
Andrea Blas,Spain,0,1,0,1,2012
Anna Espar,Spain,0,1,0,1,2012
Laura Ester,Spain,0,1,0,1,2012
Maica García,Spain,0,1,0,1,2012
Laura López,Spain,0,1,0,1,2012
Ona Meseguer,Spain,0,1,0,1,2012
Lorena Miranda,Spain,0,1,0,1,2012
Mati Ortiz,Spain,0,1,0,1,2012
Jenny Pareja,Spain,0,1,0,1,2012
Pili Peña,Spain,0,1,0,1,2012
Roser Tarragó,Spain,0,1,0,1,2012
Sander Baart,Netherlands,0,1,0,1,2012
Billy Bakker,Netherlands,0,1,0,1,2012
Marcel Balkestein,Netherlands,0,1,0,1,2012
Rogier Hofman,Netherlands,0,1,0,1,2012
Tim Jenniskens,Netherlands,0,1,0,1,2012
Wouter Jolie,Netherlands,0,1,0,1,2012
Robbert Kemperman,Netherlands,0,1,0,1,2012
Jaap Stockmann,Netherlands,0,1,0,1,2012
Valentin Verga,Netherlands,0,1,0,1,2012
Klaas Vermeulen,Netherlands,0,1,0,1,2012
Bob de Voogd,Netherlands,0,1,0,1,2012
Mink van der Weerden,Netherlands,0,1,0,1,2012
Sander de Wijn,Netherlands,0,1,0,1,2012
Marit Bouwmeester,Netherlands,0,1,0,1,2012
Alex Sandro,Brazil,0,1,0,1,2012
Sandro,Brazil,0,1,0,1,2012
Ganso,Brazil,0,1,0,1,2012
Hulk,Brazil,0,1,0,1,2012
Leandro Damião,Brazil,0,1,0,1,2012
Neymar,Brazil,0,1,0,1,2012
Juan,Brazil,0,1,0,1,2012
Oscar,Brazil,0,1,0,1,2012
Rômulo,Brazil,0,1,0,1,2012
Neto,Brazil,0,1,0,1,2012
Rafael,Brazil,0,1,0,1,2012
Gabriel,Brazil,0,1,0,1,2012
Danilo,Brazil,0,1,0,1,2012
Bryan Coquard,France,0,1,0,1,2012
Michaël D'Almeida,France,0,1,0,1,2012
Víctor Claver,Spain,0,1,0,1,2012
Serge Ibaka,Spain,0,1,0,1,2012
Sergio Llull,Spain,0,1,0,1,2012
Sergio Rodríguez,Spain,0,1,0,1,2012
Víctor Sada,Spain,0,1,0,1,2012
Fernando San Emeterio,Spain,0,1,0,1,2012
Andrea Hlaváčková,Czech Republic,0,1,0,1,2012
Lucie Hradecká,Czech Republic,0,1,0,1,2012
Sideris Tasiadis,Germany,0,1,0,1,2012
Carina Bär,Germany,0,1,0,1,2012
Julia Richter,Germany,0,1,0,1,2012
Tony Martin,Germany,0,1,0,1,2012
Céline Goberville,France,0,1,0,1,2012
Zara Phillips,Great Britain,0,1,0,1,2012
Nicola Wilson,Great Britain,0,1,0,1,2012
Blair Evans,Australia,0,1,0,1,2012
Jade Neilsen,Australia,0,1,0,1,2012
Helen Langehanenberg,Germany,0,1,0,1,2012
Dorothee Schneider,Germany,0,1,0,1,2012
Kristina Bröring-Sprehe,Germany,0,1,0,1,2012
Tamás Kulifai,Hungary,0,1,0,1,2012
Dániel Pauman,Hungary,0,1,0,1,2012
Maikel van der Vleuten,Netherlands,0,1,0,1,2012
Jur Vrieling,Netherlands,0,1,0,1,2012
Björn Otto,Germany,0,1,0,1,2012
David Storl,Germany,0,1,0,1,2012
Dávid Tóth,Hungary,0,1,0,1,2012
Conlin McCabe,Canada,0,1,0,1,2012
Blair Tuke,New Zealand,0,1,0,1,2012
Bruno Uvini,Brazil,0,1,0,1,2012
Leandro Vissotto,Brazil,0,1,0,1,2012
Lucão,Brazil,0,1,0,1,2012
Sidão,Brazil,0,1,0,1,2012
Thiago Alves,Brazil,0,1,0,1,2012
Wallace,Brazil,0,1,0,1,2012
Lionel Cox,Belgium,0,1,0,1,2012
Jacob Wukie,United States,0,1,0,1,2012
Tamari Miyashiro,United States,0,1,0,1,2012
April Ross,United States,0,1,0,1,2012
Brigetta Barrett,United States,0,1,0,1,2012
Courtney Thompson,United States,0,1,0,1,2012
Jen Kessy,United States,0,1,0,1,2012
Abby Johnston,United States,0,1,0,1,2012
Erik Kynard,United States,0,1,0,1,2012
Jordan Larson-Burbach,United States,0,1,0,1,2012
Jimmy Feigen,United States,0,1,0,1,2012
Dotsie Bausch,United States,0,1,0,1,2012
Foluke Akinradewo,United States,0,1,0,1,2012
Haley Anderson,United States,0,1,0,1,2012
Yekaterina Poistogova,Russian Federation,0,1,0,1,2012
Jason Richardson,United States,0,1,0,1,2012
Lauren Tamayo,United States,0,1,0,1,2012
Christa Harmotto-Dietzen,United States,0,1,0,1,2012
Megan Hodge,United States,0,1,0,1,2012
Destinee Hooker,United States,0,1,0,1,2012
Michael Tinsley,United States,0,1,0,1,2012
Adilbek Niyazymbetov,Kazakhstan,0,1,0,1,2012
Lizzie Armitstead-Deignan,Great Britain,0,1,0,1,2012
Tony McQuay,United States,0,1,0,1,2012
Jake Kaminski,United States,0,1,0,1,2012
Manteo Mitchell,United States,0,1,0,1,2012
Bryshon Nellum,United States,0,1,0,1,2012
Josh Mance,United States,0,1,0,1,2012
Christine Day,Jamaica,0,1,0,1,2012
Samantha Henry-Robinson,Jamaica,0,1,0,1,2012
Darya Dmitriyeva,Russian Federation,0,1,0,1,2012
Larisa Korobeynikova,Russian Federation,0,1,0,1,2012
Suguru Awaji,Japan,0,1,0,1,2012
Alexandru Sirițeanu,Romania,0,1,0,1,2012
Choi Eun-Suk,Republic of Korea,0,1,0,1,2012
Lucas,Brazil,0,1,0,1,2012
Julieta Franco,Argentina,0,1,0,1,2012
Carla Dupuy,Argentina,0,1,0,1,2012
Michael Phelps,United States,5,1,0,6,2016
Katie Ledecky,United States,4,1,0,5,2016
Simone Biles,United States,4,0,1,5,2016
Katinka Hosszú,Hungary,3,1,0,4,2016
Usain Bolt,Jamaica,3,0,0,3,2016
Jason Kenny,Great Britain,3,0,0,3,2016
Danuta Kozák,Hungary,3,0,0,3,2016
Ryan Murphy,United States,3,0,0,3,2016
Simone Manuel,United States,2,2,0,4,2016
Maya DiRado,United States,2,1,1,4,2016
Allyson Felix,United States,2,1,0,3,2016
Elaine Thompson,Jamaica,2,1,0,3,2016
Nathan Adrian,United States,2,0,2,4,2016
Max Whitlock,Great Britain,2,0,1,3,2016
Anthony Ervin,United States,2,0,0,2,2016
Kohei Uchimura,Japan,2,0,0,2,2016
Mo Farah,Great Britain,2,0,0,2,2016
Nataliya Ishchenko,Russian Federation,2,0,0,2,2016
Svetlana Romashina,Russian Federation,2,0,0,2,2016
Gabriella Szabó,Hungary,2,0,0,2,2016
Niccolò Campriani,Italy,2,0,0,2,2016
Ma Long,People's Republic of China,2,0,0,2,2016
Ding Ning,People's Republic of China,2,0,0,2,2016
Laura Trott-Kenny,Great Britain,2,0,0,2,2016
Sebastian Brendel,Germany,2,0,0,2,2016
Marcus Groß,Germany,2,0,0,2,2016
Tianna Madison-Bartoletta,United States,2,0,0,2,2016
Shi Tingmao,People's Republic of China,2,0,0,2,2016
Jang Hye-Jin,Republic of Korea,2,0,0,2,2016
Yana Yegoryan,Russian Federation,2,0,0,2,2016
Lilly King,United States,2,0,0,2,2016
Chen Aisen,People's Republic of China,2,0,0,2,2016
Max Rendschmidt,Germany,2,0,0,2,2016
Gu Bon-Chan,Republic of Korea,2,0,0,2,2016
Caeleb Dressel,United States,2,0,0,2,2016
Emma McKeon,Australia,1,2,1,4,2016
Aly Raisman,United States,1,2,0,3,2016
Penny Oleksiak,Canada,1,1,2,4,2016
Dana Vollmer,United States,1,1,1,3,2016
Sarah Sjöström,Sweden,1,1,1,3,2016
Aliya Mustafina,Russian Federation,1,1,1,3,2016
Kosuke Hagino,Japan,1,1,1,3,2016
Tori Bowie,United States,1,1,1,3,2016
Isabell Werth,Germany,1,1,0,2,2016
Vivian Cheruiyot,Kenya,1,1,0,2,2016
Sun Yang,People's Republic of China,1,1,0,2,2016
Cate Campbell,Australia,1,1,0,2,2016
Sofya Velikaya,Russian Federation,1,1,0,2,2016
Allison Schmitt,United States,1,1,0,2,2016
Oleh Verniaiev,Ukraine,1,1,0,2,2016
Zhang Jike,People's Republic of China,1,1,0,2,2016
Li Xiaoxia,People's Republic of China,1,1,0,2,2016
Jack Laugher,Great Britain,1,1,0,2,2016
Liam Heath,Great Britain,1,1,0,2,2016
Hoàng Xuân Vinh,Vietnam,1,1,0,2,2016
Charlotte Dujardin,Great Britain,1,1,0,2,2016
Brittany Elmslie,Australia,1,1,0,2,2016
Michael Jung,Germany,1,1,0,2,2016
Madi Wilson,Australia,1,1,0,2,2016
Laurie Hernandez,United States,1,1,0,2,2016
Madison Kocian,United States,1,1,0,2,2016
Abbey Weitzeil,United States,1,1,0,2,2016
Kathleen Baker,United States,1,1,0,2,2016
Astier Nicolas,France,1,1,0,2,2016
Callum Skinner,Great Britain,1,1,0,2,2016
Adam Peaty,Great Britain,1,1,0,2,2016
Kyle Chalmers,Australia,1,0,2,3,2016
Mireia Belmonte,Spain,1,0,1,2,2016
LaShawn Merritt,United States,1,0,1,2,2016
Saúl Craviotto,Spain,1,0,1,2,2016
Zhang Nan,People's Republic of China,1,0,1,2,2016
Cao Yuan,People's Republic of China,1,0,1,2,2016
Pernille Blume,Denmark,1,0,1,2,2016
Gi Bo-Bae,Republic of Korea,1,0,1,2,2016
Kristina Vogel,Germany,1,0,1,2,2016
Kristina Bröring-Sprehe,Germany,1,0,1,2,2016
Lisa Carrington,New Zealand,1,0,1,2,2016
Conor Dwyer,United States,1,0,1,2,2016
Gauthier Grumier,France,1,0,1,2,2016
Almaz Ayana,Ethiopia,1,0,1,2,2016
Anna Korakaki,Greece,1,0,1,2,2016
Anna van der Breggen,Netherlands,1,0,1,2,2016
Katie Meili,United States,1,0,1,2,2016
Leah Smith,United States,1,0,1,2,2016
Kenzo Shirai,Japan,1,0,1,2,2016
Timur Safin,Russian Federation,1,0,1,2,2016
Cody Miller,United States,1,0,1,2,2016
David Plummer,United States,1,0,1,2,2016
Jack Sock,United States,1,0,1,2,2016
Roger-Yves Bost,France,1,0,0,1,2016
Philippe Rozier,France,1,0,0,1,2016
Nick Skelton,Great Britain,1,0,0,1,2016
Fehaid Al-Deehani,Individual Olympic Athletes,1,0,0,1,2016
Santiago Lange,Argentina,1,0,0,1,2016
Bradley Wiggins,Great Britain,1,0,0,1,2016
Helen Richardson-Walsh,Great Britain,1,0,0,1,2016
Kate Richardson-Walsh,Great Britain,1,0,0,1,2016
Sue Bird,United States,1,0,0,1,2016
Tamika Catchings,United States,1,0,0,1,2016
Diana Taurasi,United States,1,0,0,1,2016
Óscar Figueroa,Colombia,1,0,0,1,2016
Ryan Lochte,United States,1,0,0,1,2016
Fabian Cancellara,Switzerland,1,0,0,1,2016
Kristin Armstrong,United States,1,0,0,1,2016
Matt Langridge,Great Britain,1,0,0,1,2016
Mahé Drysdale,New Zealand,1,0,0,1,2016
Eric Murray,New Zealand,1,0,0,1,2016
Andy Triggs Hodge,Great Britain,1,0,0,1,2016
Barbara Lechner-Engleder,Germany,1,0,0,1,2016
Jin Jong-O,Republic of Korea,1,0,0,1,2016
Yuriy Cheban,Ukraine,1,0,0,1,2016
Asafa Powell,Jamaica,1,0,0,1,2016
Matej Tóth,Slovakia,1,0,0,1,2016
Dilshod Nazarov,Tajikistan,1,0,0,1,2016
Fu Haifeng,People's Republic of China,1,0,0,1,2016
Ana Maria Brânză-Popescu,Romania,1,0,0,1,2016
Eliud Kipchoge,Kenya,1,0,0,1,2016
Ruth Beitía,Spain,1,0,0,1,2016
Caterine Ibargüen,Colombia,1,0,0,1,2016
Fabian Hambüchen,Germany,1,0,0,1,2016
Rafael Nadal,Spain,1,0,0,1,2016
Kaori Icho,Japan,1,0,0,1,2016
Mijaín López,Cuba,1,0,0,1,2016
Davor Štefanek,Serbia,1,0,0,1,2016
Wu Minxia,People's Republic of China,1,0,0,1,2016
Carmelo Anthony,United States,1,0,0,1,2016
Matías Paredes,Argentina,1,0,0,1,2016
Lucas Rey,Argentina,1,0,0,1,2016
Juan Vivaldi,Argentina,1,0,0,1,2016
Serginho,Brazil,1,0,0,1,2016
Slobodan Nikić,Serbia,1,0,0,1,2016
Annike Krahn,Germany,1,0,0,1,2016
Melanie Behringer,Germany,1,0,0,1,2016
Simone Laudehr,Germany,1,0,0,1,2016
Anja Mittag,Germany,1,0,0,1,2016
Josip Glasnović,Croatia,1,0,0,1,2016
Sylvia Fowles,United States,1,0,0,1,2016
Seimone Augustus,United States,1,0,0,1,2016
Yekaterina Marennikova,Russian Federation,1,0,0,1,2016
Irina Bliznova,Russian Federation,1,0,0,1,2016
Pete Reed,Great Britain,1,0,0,1,2016
Hamish Bond,New Zealand,1,0,0,1,2016
Kim Crow-Brennan,Australia,1,0,0,1,2016
Annekatrin Thiele,Germany,1,0,0,1,2016
Laura Ludwig,Germany,1,0,0,1,2016
Yekaterina Dyachenko,Russian Federation,1,0,0,1,2016
Paula Pareto,Argentina,1,0,0,1,2016
Teddy Riner,France,1,0,0,1,2016
Liliyana Natsir,Indonesia,1,0,0,1,2016
Robson Conceição,Brazil,1,0,0,1,2016
Ed Clancy,Great Britain,1,0,0,1,2016
Steven Burke,Great Britain,1,0,0,1,2016
Nino Schurter,Switzerland,1,0,0,1,2016
Babett Peter,Germany,1,0,0,1,2016
Mikkel Hansen,Denmark,1,0,0,1,2016
Jesper Nøddesbo,Denmark,1,0,0,1,2016
Kasper Søndergaard,Denmark,1,0,0,1,2016
Crista Cullen,Great Britain,1,0,0,1,2016
Alex Danson,Great Britain,1,0,0,1,2016
Kami Craig,United States,1,0,0,1,2016
Andrija Prlainović,Serbia,1,0,0,1,2016
Filip Filipović,Serbia,1,0,0,1,2016
Duško Pijetlović,Serbia,1,0,0,1,2016
Živko Gocić,Serbia,1,0,0,1,2016
Wei Qiuyue,People's Republic of China,1,0,0,1,2016
Xu Yunli,People's Republic of China,1,0,0,1,2016
Bruninho,Brazil,1,0,0,1,2016
Kerron Clement,United States,1,0,0,1,2016
Michelle Carter,United States,1,0,0,1,2016
Anita Włodarczyk,Poland,1,0,0,1,2016
Natasha Hastings,United States,1,0,0,1,2016
Chen Ruolin,People's Republic of China,1,0,0,1,2016
Lin Yue,People's Republic of China,1,0,0,1,2016
Alistair Brownlee,Great Britain,1,0,0,1,2016
Long Qingquan,People's Republic of China,1,0,0,1,2016
Max Hoff,Germany,1,0,0,1,2016
Maialen Chourraut,Spain,1,0,0,1,2016
Rie Kaneto,Japan,1,0,0,1,2016
Rosie MacLennan,Canada,1,0,0,1,2016
Liu Hong,People's Republic of China,1,0,0,1,2016
Christian Reitz,Germany,1,0,0,1,2016
Andy Murray,Great Britain,1,0,0,1,2016
Yelena Vesnina,Russian Federation,1,0,0,1,2016
Saskia Clark,Great Britain,1,0,0,1,2016
Cecilia Carranza,Argentina,1,0,0,1,2016
Peter Burling,New Zealand,1,0,0,1,2016
Šime Fantela,Croatia,1,0,0,1,2016
Igor Marenić,Croatia,1,0,0,1,2016
Elle Logan,United States,1,0,0,1,2016
Hans Gruhne,Germany,1,0,0,1,2016
Emese Szász-Kovács,Hungary,1,0,0,1,2016
Áron Szilágyi,Hungary,1,0,0,1,2016
Vladimer Khinchegashvili,Georgia,1,0,0,1,2016
Artur Akhmatkhuzin,Russian Federation,1,0,0,1,2016
Yuliya Gavrilova,Russian Federation,1,0,0,1,2016
Inna Deriglazova,Russian Federation,1,0,0,1,2016
Aleksey Cheremisinov,Russian Federation,1,0,0,1,2016
Roman Vlasov,Russian Federation,1,0,0,1,2016
Aleksandr Lesun,Russian Federation,1,0,0,1,2016
Anastasiya Bliznyuk,Russian Federation,1,0,0,1,2016
Aleksandra Patskevich,Russian Federation,1,0,0,1,2016
Alla Shishkina,Russian Federation,1,0,0,1,2016
Yekaterina Makarova,Russian Federation,1,0,0,1,2016
Viktoriya Zhilinskayte,Russian Federation,1,0,0,1,2016
Olga Levina-Akopyan,Russian Federation,1,0,0,1,2016
Anna Sedoykina,Russian Federation,1,0,0,1,2016
Koji Yamamuro,Japan,1,0,0,1,2016
Yusuke Tanaka,Japan,1,0,0,1,2016
Ryohei Kato,Japan,1,0,0,1,2016
Yohan Blake,Jamaica,1,0,0,1,2016
Haruka Tachimoto,Japan,1,0,0,1,2016
Artur Aleksanyan,Armenia,1,0,0,1,2016
Simona Gherman,Romania,1,0,0,1,2016
Ruslan Nurudinov,Uzbekistan,1,0,0,1,2016
Sandra Perković,Croatia,1,0,0,1,2016
Martin Sinković,Croatia,1,0,0,1,2016
Valent Sinković,Croatia,1,0,0,1,2016
Joseph Schooling,Singapore,1,0,0,1,2016
Kianoush Rostami,Islamic Republic of Iran,1,0,0,1,2016
Chen Long,People's Republic of China,1,0,0,1,2016
Gong Jinjie,People's Republic of China,1,0,0,1,2016
Majlinda Kelmendi,Albania,1,0,0,1,2016
Jérémie Azou,France,1,0,0,1,2016
Stefan Mitrović,Serbia,1,0,0,1,2016
Gojko Pijetlović,Serbia,1,0,0,1,2016
Dušan Mandić,Serbia,1,0,0,1,2016
Milan Aleksić,Serbia,1,0,0,1,2016
Yannick Borel,France,1,0,0,1,2016
Hsu Shu-Ching,Chinese Taipei,1,0,0,1,2016
Elia Viviani,Italy,1,0,0,1,2016
Rafaela Silva,Brazil,1,0,0,1,2016
Wang Zhen,People's Republic of China,1,0,0,1,2016
Nicola Adams,Great Britain,1,0,0,1,2016
Jade Jones,Great Britain,1,0,0,1,2016
Derek Drouin,Canada,1,0,0,1,2016
Natalia Madaj,Poland,1,0,0,1,2016
Alison,Brazil,1,0,0,1,2016
Magdalena Fularczyk-Kozłowska,Poland,1,0,0,1,2016
René Toft Hansen,Denmark,1,0,0,1,2016
Nicola White,Great Britain,1,0,0,1,2016
Chris Mears,Great Britain,1,0,0,1,2016
Charline Picon,France,1,0,0,1,2016
Pénélope Leprévost,France,1,0,0,1,2016
Niklas Landin,Denmark,1,0,0,1,2016
Lasse Svan,Denmark,1,0,0,1,2016
Phelan Hill,Great Britain,1,0,0,1,2016
Constantine Louloudis,Great Britain,1,0,0,1,2016
George Nash,Great Britain,1,0,0,1,2016
Will Satch,Great Britain,1,0,0,1,2016
Moe Sbihi,Great Britain,1,0,0,1,2016
Heather Stanning,Great Britain,1,0,0,1,2016
Hannah Mills,Great Britain,1,0,0,1,2016
Robeisy Ramírez,Cuba,1,0,0,1,2016
Julio César la Cruz,Cuba,1,0,0,1,2016
Hui Ruoqi,People's Republic of China,1,0,0,1,2016
David Rudisha,Kenya,1,0,0,1,2016
Chloe Esposito,Australia,1,0,0,1,2016
Fazliddin Gaybnazarov,Uzbekistan,1,0,0,1,2016
Caster Semenya,South Africa,1,0,0,1,2016
Juan Martín López,Argentina,1,0,0,1,2016
Lucas Rossi,Argentina,1,0,0,1,2016
Facundo Callioni,Argentina,1,0,0,1,2016
Lucas Vila,Argentina,1,0,0,1,2016
Pedro Ibarra,Argentina,1,0,0,1,2016
Manuel Brunet,Argentina,1,0,0,1,2016
Agustín Mazzilli,Argentina,1,0,0,1,2016
Gonzalo Peillat,Argentina,1,0,0,1,2016
Carolina Marín,Spain,1,0,0,1,2016
Joanna Rowsell Shand,Great Britain,1,0,0,1,2016
Gregorio Paltrinieri,Italy,1,0,0,1,2016
Helen Glover,Great Britain,1,0,0,1,2016
Sohrab Moradi,Islamic Republic of Iran,1,0,0,1,2016
Taha Akgül,Turkey,1,0,0,1,2016
Tony Yoka,France,1,0,0,1,2016
Ekaterini Stefanidi,Greece,1,0,0,1,2016
Marit Bouwmeester,Netherlands,1,0,0,1,2016
Dorian van Rijsselberge,Netherlands,1,0,0,1,2016
Tontowi Ahmad,Indonesia,1,0,0,1,2016
Neymar,Brazil,1,0,0,1,2016
Mariana Pajón,Colombia,1,0,0,1,2016
Lukáš Krpálek,Czech Republic,1,0,0,1,2016
Shaunae Miller,The Bahamas,1,0,0,1,2016
Carina Bär,Germany,1,0,0,1,2016
Lauritz Schoof,Germany,1,0,0,1,2016
Karl Schulze,Germany,1,0,0,1,2016
Philipp Wende,Germany,1,0,0,1,2016
Dorothee Schneider,Germany,1,0,0,1,2016
Krisztina Fazekas Zur,Hungary,1,0,0,1,2016
Maaike Head,Netherlands,1,0,0,1,2016
Sharon van Rouwendaal,Netherlands,1,0,0,1,2016
Kemar Bailey-Cole,Jamaica,1,0,0,1,2016
Kevin Durant,United States,1,0,0,1,2016
Blair Tuke,New Zealand,1,0,0,1,2016
Bronte Campbell,Australia,1,0,0,1,2016
Alex Gregory,Great Britain,1,0,0,1,2016
Hannah Macleod,Great Britain,1,0,0,1,2016
Tom Ransley,Great Britain,1,0,0,1,2016
Georgie Twigg,Great Britain,1,0,0,1,2016
Laura Unsworth,Great Britain,1,0,0,1,2016
Mario Gyr,Switzerland,1,0,0,1,2016
Simon Niepmann,Switzerland,1,0,0,1,2016
Simon Schürch,Switzerland,1,0,0,1,2016
Lucas Tramèr,Switzerland,1,0,0,1,2016
Lucão,Brazil,1,0,0,1,2016
Wallace,Brazil,1,0,0,1,2016
Greg Van Avermaet,Belgium,1,0,0,1,2016
Gwen Jorgensen,United States,1,0,0,1,2016
Matthew Centrowitz,United States,1,0,0,1,2016
Francena McCorory,United States,1,0,0,1,2016
Lindsay Whalen,United States,1,0,0,1,2016
Angel McCoughtry,United States,1,0,0,1,2016
Maya Moore,United States,1,0,0,1,2016
Christian Taylor,United States,1,0,0,1,2016
Meghan Musnicki,United States,1,0,0,1,2016
Connor Fields,United States,1,0,0,1,2016
Claressa Shields,United States,1,0,0,1,2016
Gabby Douglas,United States,1,0,0,1,2016
Ashton Eaton,United States,1,0,0,1,2016
Jimmy Feigen,United States,1,0,0,1,2016
Missy Franklin,United States,1,0,0,1,2016
Tina Charles,United States,1,0,0,1,2016
Melissa Seidemann,United States,1,0,0,1,2016
Maggie Steffens,United States,1,0,0,1,2016
Courtney Mathewson,United States,1,0,0,1,2016
Kayla Harrison,United States,1,0,0,1,2016
Daniyar Yeleusinov,Kazakhstan,1,0,0,1,2016
Philip Hindes,Great Britain,1,0,0,1,2016
Rim Jong-Sim,Democratic People's Republic of Korea,1,0,0,1,2016
Tony McQuay,United States,1,0,0,1,2016
Faith Kibiegon,Kenya,1,0,0,1,2016
Kevin Staut,France,1,0,0,1,2016
Marc López,Spain,1,0,0,1,2016
Loredana Dinu,Romania,1,0,0,1,2016
Alicia Quirk,Australia,1,0,0,1,2016
Amy Turner,Australia,1,0,0,1,2016
Charlotte Caslick,Australia,1,0,0,1,2016
Chloe Dalton,Australia,1,0,0,1,2016
Ellia Green,Australia,1,0,0,1,2016
Emilee Cherry,Australia,1,0,0,1,2016
Emma Tonegato,Australia,1,0,0,1,2016
Evania Pelite,Australia,1,0,0,1,2016
Gemma Etheridge,Australia,1,0,0,1,2016
Nicole Beck,Australia,1,0,0,1,2016
Shannon Parry,Australia,1,0,0,1,2016
Sharni Williams,Australia,1,0,0,1,2016
Catherine Skinner,Australia,1,0,0,1,2016
Nafi Thiam,Belgium,1,0,0,1,2016
Kahena Kunze,Brazil,1,0,0,1,2016
Martine Grael,Brazil,1,0,0,1,2016
Ruth Jebet,Bahrain,1,0,0,1,2016
Erica Wiebe,Canada,1,0,0,1,2016
Zhong Tianshi,People's Republic of China,1,0,0,1,2016
Liu Huixia,People's Republic of China,1,0,0,1,2016
Ren Qian,People's Republic of China,1,0,0,1,2016
Zhang Mengxue,People's Republic of China,1,0,0,1,2016
Zheng Shuyin,People's Republic of China,1,0,0,1,2016
Liu Shiwen,People's Republic of China,1,0,0,1,2016
Zhang Changning,People's Republic of China,1,0,0,1,2016
Yang Fangxu,People's Republic of China,1,0,0,1,2016
Lin Li,People's Republic of China,1,0,0,1,2016
Yan Ni,People's Republic of China,1,0,0,1,2016
Zhu Ting,People's Republic of China,1,0,0,1,2016
Ding Xia,People's Republic of China,1,0,0,1,2016
Gong Xiangyu,People's Republic of China,1,0,0,1,2016
Liu Xiaotong,People's Republic of China,1,0,0,1,2016
Yuan Xinyue,People's Republic of China,1,0,0,1,2016
Meng Suping,People's Republic of China,1,0,0,1,2016
Deng Wei,People's Republic of China,1,0,0,1,2016
Xiang Yanmei,People's Republic of China,1,0,0,1,2016
Sara Kolak,Croatia,1,0,0,1,2016
Estelle Mossely,France,1,0,0,1,2016
Émilie Andéol,France,1,0,0,1,2016
Elinor Barker,Great Britain,1,0,0,1,2016
Katie Archibald,Great Britain,1,0,0,1,2016
Giselle Ansley,Great Britain,1,0,0,1,2016
Hollie Webb,Great Britain,1,0,0,1,2016
Lily Owsley,Great Britain,1,0,0,1,2016
Maddie Hinch,Great Britain,1,0,0,1,2016
Sam Quek,Great Britain,1,0,0,1,2016
Shona McCallin,Great Britain,1,0,0,1,2016
Sophie Bray,Great Britain,1,0,0,1,2016
Susannah Townsend,Great Britain,1,0,0,1,2016
Kira Walkenhorst,Germany,1,0,0,1,2016
Alexandra Popp,Germany,1,0,0,1,2016
Almuth Schult,Germany,1,0,0,1,2016
Dzsenifer Marozsán,Germany,1,0,0,1,2016
Isabel Kerschowski,Germany,1,0,0,1,2016
Josephine Henning,Germany,1,0,0,1,2016
Lena Goeßling,Germany,1,0,0,1,2016
Leonie Maier,Germany,1,0,0,1,2016
Mandy Islacker,Germany,1,0,0,1,2016
Melanie Leupolz,Germany,1,0,0,1,2016
Sara Däbritz,Germany,1,0,0,1,2016
Saskia Bartusiak,Germany,1,0,0,1,2016
Svenja Huth,Germany,1,0,0,1,2016
Tabea Kemme,Germany,1,0,0,1,2016
Julia Lier,Germany,1,0,0,1,2016
Lisa Schmidla,Germany,1,0,0,1,2016
Tamara Csipes,Hungary,1,0,0,1,2016
Diana Bacosi,Italy,1,0,0,1,2016
Ayaka Takahashi,Japan,1,0,0,1,2016
Misaki Matsutomo,Japan,1,0,0,1,2016
Eri Tosaka,Japan,1,0,0,1,2016
Risako Kawai,Japan,1,0,0,1,2016
Sara Dosho,Japan,1,0,0,1,2016
Jemima Sumgong,Kenya,1,0,0,1,2016
Choi Mi-Seon,Republic of Korea,1,0,0,1,2016
Park In-Bi,Republic of Korea,1,0,0,1,2016
Oh Hye-Ri,Republic of Korea,1,0,0,1,2016
Kim So-Hui,Republic of Korea,1,0,0,1,2016
Elis Ligtlee,Netherlands,1,0,0,1,2016
Sanne Wevers,Netherlands,1,0,0,1,2016
Ilse Paulis,Netherlands,1,0,0,1,2016
Mónica Puig,Puerto Rico,1,0,0,1,2016
Simona Pop,Romania,1,0,0,1,2016
Anna Sen,Russian Federation,1,0,0,1,2016
Anna Vyakhireva,Russian Federation,1,0,0,1,2016
Darya Dmitriyeva,Russian Federation,1,0,0,1,2016
Yekaterina Ilyina,Russian Federation,1,0,0,1,2016
Marina Sudakova,Russian Federation,1,0,0,1,2016
Mayya Petrova,Russian Federation,1,0,0,1,2016
Polina Kuznetsova,Russian Federation,1,0,0,1,2016
Viktoriya Kalinina,Russian Federation,1,0,0,1,2016
Vladlena Bobrovnikova,Russian Federation,1,0,0,1,2016
Anastasiya Maksimova,Russian Federation,1,0,0,1,2016
Anastasiya Tatareva,Russian Federation,1,0,0,1,2016
Margarita Mamun,Russian Federation,1,0,0,1,2016
Mariya Tolkachova,Russian Federation,1,0,0,1,2016
Vera Biryukova,Russian Federation,1,0,0,1,2016
Yelena Prokofyeva,Russian Federation,1,0,0,1,2016
Gelena Topilina,Russian Federation,1,0,0,1,2016
Mariya Shurochkina,Russian Federation,1,0,0,1,2016
Svetlana Kolesnichenko,Russian Federation,1,0,0,1,2016
Vlada Chigiryova,Russian Federation,1,0,0,1,2016
Tina Trstenjak,Slovenia,1,0,0,1,2016
Jenny Rissveds,Sweden,1,0,0,1,2016
Sopita Tanasan,Thailand,1,0,0,1,2016
Sukanya Srisurat,Thailand,1,0,0,1,2016
Brianna Rollins,United States,1,0,0,1,2016
Courtney Okolo,United States,1,0,0,1,2016
Dalilah Muhammad,United States,1,0,0,1,2016
English Gardner,United States,1,0,0,1,2016
Morolake Akinosun,United States,1,0,0,1,2016
Phyllis Francis,United States,1,0,0,1,2016
Taylor Ellis-Watson,United States,1,0,0,1,2016
Breanna Stewart,United States,1,0,0,1,2016
Brittney Griner,United States,1,0,0,1,2016
Elena Delle Donne,United States,1,0,0,1,2016
Amanda Elmore,United States,1,0,0,1,2016
Amanda Polk,United States,1,0,0,1,2016
Emily Regan,United States,1,0,0,1,2016
Katelin Snyder,United States,1,0,0,1,2016
Kerry Simmonds,United States,1,0,0,1,2016
Lauren Schmetterling,United States,1,0,0,1,2016
Tessa Gobbo,United States,1,0,0,1,2016
Ginny Thrasher,United States,1,0,0,1,2016
Kelsi Worrell,United States,1,0,0,1,2016
Melanie Margalis,United States,1,0,0,1,2016
Olivia Smoliga,United States,1,0,0,1,2016
Bethanie Mattek-Sands,United States,1,0,0,1,2016
Aria Fischer,United States,1,0,0,1,2016
Ashleigh Johnson,United States,1,0,0,1,2016
Kaleigh Gilchrist,United States,1,0,0,1,2016
Kiley Neushul,United States,1,0,0,1,2016
KK Clark,United States,1,0,0,1,2016
Maddie Musselman,United States,1,0,0,1,2016
Makenzie Fischer,United States,1,0,0,1,2016
Rachel Fattal,United States,1,0,0,1,2016
Sami Hill,United States,1,0,0,1,2016
Helen Maroulis,United States,1,0,0,1,2016
Ignacio Ortiz,Argentina,1,0,0,1,2016
Isidoro Ibarra,Argentina,1,0,0,1,2016
Joaquín Menini,Argentina,1,0,0,1,2016
Juan Gilardi,Argentina,1,0,0,1,2016
Juan Saladino,Argentina,1,0,0,1,2016
Luca Masso,Argentina,1,0,0,1,2016
Matías Rey,Argentina,1,0,0,1,2016
Tom Burton,Australia,1,0,0,1,2016
Mack Horton,Australia,1,0,0,1,2016
Radik İsayev,Azerbaijan,1,0,0,1,2016
Uladzislau Hancharou,Belarus,1,0,0,1,2016
Thiago Braz,Brazil,1,0,0,1,2016
Bruno Schmidt,Brazil,1,0,0,1,2016
Felipe Anderson,Brazil,1,0,0,1,2016
Renato Augusto,Brazil,1,0,0,1,2016
Gabriel Barbosa,Brazil,1,0,0,1,2016
Rodrigo Caio,Brazil,1,0,0,1,2016
Rodrigo Dourado,Brazil,1,0,0,1,2016
Gabriel Jesus,Brazil,1,0,0,1,2016
Luan,Brazil,1,0,0,1,2016
Thiago Maia,Brazil,1,0,0,1,2016
Marquinhos,Brazil,1,0,0,1,2016
Rafinha,Brazil,1,0,0,1,2016
Douglas Santos,Brazil,1,0,0,1,2016
Walace,Brazil,1,0,0,1,2016
William,Brazil,1,0,0,1,2016
Zeca,Brazil,1,0,0,1,2016
Douglas Souza,Brazil,1,0,0,1,2016
Éder,Brazil,1,0,0,1,2016
Guerra,Brazil,1,0,0,1,2016
Luiz Felipe,Brazil,1,0,0,1,2016
Maurício Borges,Brazil,1,0,0,1,2016
Maurício Souza,Brazil,1,0,0,1,2016
Ricardo Lucarelli,Brazil,1,0,0,1,2016
William Arjona,Brazil,1,0,0,1,2016
Zhao Shuai,People's Republic of China,1,0,0,1,2016
Xu Xin,People's Republic of China,1,0,0,1,2016
Cheick Sallah Cissé,Côte d'Ivoire,1,0,0,1,2016
Arlen López,Cuba,1,0,0,1,2016
Ismael Borrero,Cuba,1,0,0,1,2016
Casper Mortensen,Denmark,1,0,0,1,2016
Henrik Toft Hansen,Denmark,1,0,0,1,2016
Henrik Møllgaard Jensen,Denmark,1,0,0,1,2016
Jannick Green Krejberg,Denmark,1,0,0,1,2016
Mads Christiansen,Denmark,1,0,0,1,2016
Mads Mensah Larsen,Denmark,1,0,0,1,2016
Michael Damgaard Nielsen,Denmark,1,0,0,1,2016
Morten Olsen,Denmark,1,0,0,1,2016
Cristian Toro,Spain,1,0,0,1,2016
Marcus Walz,Spain,1,0,0,1,2016
Apisai Domolailai,Fiji,1,0,0,1,2016
Jasa Veremalua,Fiji,1,0,0,1,2016
Jerry Tuwai,Fiji,1,0,0,1,2016
Josua Tuisova,Fiji,1,0,0,1,2016
Kitione Taliga,Fiji,1,0,0,1,2016
Leone Nakarawa,Fiji,1,0,0,1,2016
Osea Kolinisau,Fiji,1,0,0,1,2016
Samisoni Viriviri,Fiji,1,0,0,1,2016
Savenaca Rawaca,Fiji,1,0,0,1,2016
Semi Kunatani,Fiji,1,0,0,1,2016
Vatemo Ravouvou,Fiji,1,0,0,1,2016
Viliame Mata,Fiji,1,0,0,1,2016
Denis Gargaud Chanut,France,1,0,0,1,2016
Karim Laghouag,France,1,0,0,1,2016
Mathieu Lemoine,France,1,0,0,1,2016
Thibaut Vallette,France,1,0,0,1,2016
Daniel Jérent,France,1,0,0,1,2016
Jean-Michel Lucenay,France,1,0,0,1,2016
Pierre Houin,France,1,0,0,1,2016
Joe Clarke,Great Britain,1,0,0,1,2016
Owain Doull,Great Britain,1,0,0,1,2016
Justin Rose,Great Britain,1,0,0,1,2016
Matt Gotrel,Great Britain,1,0,0,1,2016
Paul Bennett,Great Britain,1,0,0,1,2016
Scott Durant,Great Britain,1,0,0,1,2016
Giles Scott,Great Britain,1,0,0,1,2016
Lasha Talakhadze,Georgia,1,0,0,1,2016
Christoph Harting,Germany,1,0,0,1,2016
Thomas Röhler,Germany,1,0,0,1,2016
Jan Vandrey,Germany,1,0,0,1,2016
Tom Liebscher,Germany,1,0,0,1,2016
Sönke Rothenberger,Germany,1,0,0,1,2016
Henri Junghänel,Germany,1,0,0,1,2016
Eleftherios Petrounias,Greece,1,0,0,1,2016
Hassan Yazdani,Islamic Republic of Iran,1,0,0,1,2016
Daniele Garozzo,Italy,1,0,0,1,2016
Fabio Basile,Italy,1,0,0,1,2016
Gabriele Rossetti,Italy,1,0,0,1,2016
Jevaughn Minzie,Jamaica,1,0,0,1,2016
Nickel Ashmeade,Jamaica,1,0,0,1,2016
Omar McLeod,Jamaica,1,0,0,1,2016
Ahmad Abughaush,Jordan,1,0,0,1,2016
Mashu Baker,Japan,1,0,0,1,2016
Shohei Ono,Japan,1,0,0,1,2016
Dmitry Balandin,Kazakhstan,1,0,0,1,2016
Nidzhat Rakhimov,Azerbaijan,1,0,0,1,2016
Conseslus Kipruto,Kenya,1,0,0,1,2016
Lee Seung-Yun,Republic of Korea,1,0,0,1,2016
Kim Wu-Jin,Republic of Korea,1,0,0,1,2016
Park Sang-Yeong,Republic of Korea,1,0,0,1,2016
Ferry Weertman,Netherlands,1,0,0,1,2016
Ri Se-Gwang,Democratic People's Republic of Korea,1,0,0,1,2016
Wayde van Niekerk,South Africa,1,0,0,1,2016
Yevgeny Tishchenko,Russian Federation,1,0,0,1,2016
Beslan Mudranov,Russian Federation,1,0,0,1,2016
Khasan Khalmurzayev,Russian Federation,1,0,0,1,2016
Abdulrashid Sadulayev,Russian Federation,1,0,0,1,2016
Davit Chakvetadze,Russian Federation,1,0,0,1,2016
Soslan Ramonov,Russian Federation,1,0,0,1,2016
Branislav Mitrović,Serbia,1,0,0,1,2016
Miloš Ćuk,Serbia,1,0,0,1,2016
Nikola Jakšić,Serbia,1,0,0,1,2016
Sava Ranđelović,Serbia,1,0,0,1,2016
Ladislav Škantár,Slovakia,1,0,0,1,2016
Peter Škantár,Slovakia,1,0,0,1,2016
Arman Hall,United States,1,0,0,1,2016
David Verburg,United States,1,0,0,1,2016
Gil Roberts,United States,1,0,0,1,2016
Jeff Henderson,United States,1,0,0,1,2016
Kyle Clemons,United States,1,0,0,1,2016
Ryan Crouser,United States,1,0,0,1,2016
DeAndre Jordan,United States,1,0,0,1,2016
DeMarcus Cousins,United States,1,0,0,1,2016
DeMar DeRozan,United States,1,0,0,1,2016
Draymond Green,United States,1,0,0,1,2016
Harrison Barnes,United States,1,0,0,1,2016
Jimmy Butler,United States,1,0,0,1,2016
Klay Thompson,United States,1,0,0,1,2016
Kyle Lowry,United States,1,0,0,1,2016
Kyrie Irving,United States,1,0,0,1,2016
Paul George,United States,1,0,0,1,2016
Blake Pieroni,United States,1,0,0,1,2016
Cierra Runge,United States,1,0,0,1,2016
Clark Smith,United States,1,0,0,1,2016
Gunnar Bentz,United States,1,0,0,1,2016
Jack Conger,United States,1,0,0,1,2016
Kevin Cordes,United States,1,0,0,1,2016
Ryan Held,United States,1,0,0,1,2016
Tom Shields,United States,1,0,0,1,2016
Townley Haas,United States,1,0,0,1,2016
Kyle Snyder,United States,1,0,0,1,2016
Hasanboy Dusmatov,Uzbekistan,1,0,0,1,2016
Shakhobiddin Zoirov,Uzbekistan,1,0,0,1,2016
Wéverton,Brazil,1,0,0,1,2016
Ro Dakuwaqa,Fiji,1,0,0,1,2016
Tatyana Yerokhina,Russian Federation,1,0,0,1,2016
Luan Garcia,Brazil,1,0,0,1,2016
Shi Zhiyong,People's Republic of China,1,0,0,1,2016
Dmitry Zherebchenko,Russian Federation,1,0,0,1,2016
Ellie Watton,Great Britain,1,0,0,1,2016
Joie Leigh,Great Britain,1,0,0,1,2016
Denis Ablyazin,Russian Federation,0,2,1,3,2016
Isaquias Queiroz,Brazil,0,2,1,3,2016
Sarah Hammer,United States,0,2,0,2,2016
Yuliya Yefimova,Russian Federation,0,2,0,2,2016
Huang Xuechen,People's Republic of China,0,2,0,2,2016
Chad le Clos,South Africa,0,2,0,2,2016
Sun Wenyan,People's Republic of China,0,2,0,2,2016
Taoufik Makhloufi,Algeria,0,2,0,2,2016
Tina Dietze,Germany,0,2,0,2,2016
Franziska Weber,Germany,0,2,0,2,2016
Florent Manaudou,France,0,2,0,2,2016
Danell Leyva,United States,0,2,0,2,2016
Mariya Paseka,Russian Federation,0,2,0,2,2016
Madeline Groves,Australia,0,2,0,2,2016
Becky James,Great Britain,0,2,0,2,2016
Jazz Carlin,Great Britain,0,2,0,2,2016
Duncan Scott,Great Britain,0,2,0,2,2016
James Guy,Great Britain,0,2,0,2,2016
Andre De Grasse,Canada,0,1,2,3,2016
Géza Imre,Hungary,0,1,1,2,2016
Tania Cagnotto,Italy,0,1,1,2,2016
Du Li,People's Republic of China,0,1,1,2,2016
Brady Ellison,United States,0,1,1,2,2016
Olha Kharlan,Ukraine,0,1,1,2,2016
Shelly-Ann Fraser-Pryce,Jamaica,0,1,1,2,2016
David Boudia,United States,0,1,1,2,2016
Jun Mizutani,Japan,0,1,1,2,2016
David Belyavsky,Russian Federation,0,1,1,2,2016
Josef Dostál,Czech Republic,0,1,1,2,2016
Mitch Larkin,Australia,0,1,1,2,2016
Alexander Massialas,United States,0,1,1,2,2016
Sun Yiwen,People's Republic of China,0,1,1,2,2016
Shericka Jackson,Jamaica,0,1,1,2,2016
Martina Hingis,Switzerland,0,1,0,1,2016
Peder Fredricson,Sweden,0,1,0,1,2016
Carl Hester,Great Britain,0,1,0,1,2016
Giovanni Pellielo,Italy,0,1,0,1,2016
Ivan Tsikan,Belarus,0,1,0,1,2016
Mélina Robert-Michon,France,0,1,0,1,2016
Veronica Campbell-Brown,Jamaica,0,1,0,1,2016
Juraj Tarr,Slovakia,0,1,0,1,2016
Erik Vlček,Slovakia,0,1,0,1,2016
Ingrid Klimke,Germany,0,1,0,1,2016
Katherine Grainger,Great Britain,0,1,0,1,2016
Frances Houghton,Great Britain,0,1,0,1,2016
Nick Dempsey,Great Britain,0,1,0,1,2016
Vasilij Žbogar,Slovenia,0,1,0,1,2016
Marco Innocenti,Italy,0,1,0,1,2016
Spyros Gianniotis,Greece,0,1,0,1,2016
Venus Williams,United States,0,1,0,1,2016
Laia Palau,Spain,0,1,0,1,2016
Lucila Pascua,Spain,0,1,0,1,2016
László Cseh,Hungary,0,1,0,1,2016
Amanda Weir,United States,0,1,0,1,2016
Fabien Gilot,France,0,1,0,1,2016
Valerie Adams-Vili,New Zealand,0,1,0,1,2016
Chiara Càinero,Italy,0,1,0,1,2016
Novlene Williams-Mills,Jamaica,0,1,0,1,2016
Zhang Wenxiu,People's Republic of China,0,1,0,1,2016
Justin Gatlin,United States,0,1,0,1,2016
Lee Chong Wei,Malaysia,0,1,0,1,2016
Erwann Le Péchoux,France,0,1,0,1,2016
Nicola Spirig Hug,Switzerland,0,1,0,1,2016
Sunette Viljoen,South Africa,0,1,0,1,2016
Beezie Madden,United States,0,1,0,1,2016
McLain Ward,United States,0,1,0,1,2016
Saori Yoshida,Japan,0,1,0,1,2016
Gyuzel Manyurova,Kazakhstan,0,1,0,1,2016
Maja Włoszczowska,Poland,0,1,0,1,2016
Jaroslav Kulhavý,Czech Republic,0,1,0,1,2016
Lotta Schelin,Sweden,0,1,0,1,2016
Michaël Guigou,France,0,1,0,1,2016
Nikola Karabatic,France,0,1,0,1,2016
Daniel Narcisse,France,0,1,0,1,2016
Thierry Omeyer,France,0,1,0,1,2016
Tania Di Mario,Italy,0,1,0,1,2016
Damir Burić,Croatia,0,1,0,1,2016
Xavier García,Croatia,0,1,0,1,2016
Hedvig Lindahl,Sweden,0,1,0,1,2016
Caroline Seger,Sweden,0,1,0,1,2016
Nilla Fischer,Sweden,0,1,0,1,2016
Jean-Charles Valladont,France,0,1,0,1,2016
Alba Torrens,Spain,0,1,0,1,2016
Laura Nicholls,Spain,0,1,0,1,2016
Diego Hypólito,Brazil,0,1,0,1,2016
Louis Smith,Great Britain,0,1,0,1,2016
Amandine Leynaud,France,0,1,0,1,2016
Camille Ayglon-Saurina,France,0,1,0,1,2016
Alexandra Lacrabère,France,0,1,0,1,2016
Jelena Nikolić,Serbia,0,1,0,1,2016
Maja Ognjenović,Serbia,0,1,0,1,2016
Stefana Veljković,Serbia,0,1,0,1,2016
Jovana Brakočević-Kancian,Serbia,0,1,0,1,2016
Cameron van der Burgh,South Africa,0,1,0,1,2016
Mindaugas Griškonis,Lithuania,0,1,0,1,2016
Felix Drahotta,Germany,0,1,0,1,2016
Shaun Keeling,South Africa,0,1,0,1,2016
Yuri Alvear,Colombia,0,1,0,1,2016
Idalys Ortiz,Cuba,0,1,0,1,2016
Travis Stevens,United States,0,1,0,1,2016
Kamilla Rytter Juhl,Denmark,0,1,0,1,2016
Emma Johansson,Sweden,0,1,0,1,2016
Jack Bobridge,Australia,0,1,0,1,2016
Mark Cavendish,Great Britain,0,1,0,1,2016
Jakob Fuglsang,Denmark,0,1,0,1,2016
Luc Abalo,France,0,1,0,1,2016
Cédric Charlier,Belgium,0,1,0,1,2016
Jérôme Truyens,Belgium,0,1,0,1,2016
Felix Denayer,Belgium,0,1,0,1,2016
Thomas Briels,Belgium,0,1,0,1,2016
John-John Dohmen,Belgium,0,1,0,1,2016
Maartje Paumen,Netherlands,0,1,0,1,2016
Naomi van As,Netherlands,0,1,0,1,2016
Ellen Hoog,Netherlands,0,1,0,1,2016
Lidewij Welten,Netherlands,0,1,0,1,2016
Eva de Goede,Netherlands,0,1,0,1,2016
Teresa Frassinetti,Italy,0,1,0,1,2016
Maro Joković,Croatia,0,1,0,1,2016
Josip Pavić,Croatia,0,1,0,1,2016
Andro Bušlje,Croatia,0,1,0,1,2016
Emanuele Birarelli,Italy,0,1,0,1,2016
Jared Tallent,Australia,0,1,0,1,2016
Piotr Małachowski,Poland,0,1,0,1,2016
Brittney Reese,United States,0,1,0,1,2016
Robbie Renwick,Great Britain,0,1,0,1,2016
Emily Seebohm,Australia,0,1,0,1,2016
Bronte Barratt,Australia,0,1,0,1,2016
Francesca Dallapè,Italy,0,1,0,1,2016
Pandelela Rinong,Malaysia,0,1,0,1,2016
Germán Sánchez,Mexico,0,1,0,1,2016
Hidilyn Diaz,Philippines,0,1,0,1,2016
Eko Irawan,Indonesia,0,1,0,1,2016
Vadzim Straltsou,Belarus,0,1,0,1,2016
Pavlo Tymoshchenko,Ukraine,0,1,0,1,2016
David Florence,Great Britain,0,1,0,1,2016
Peter Kauzer,Slovenia,0,1,0,1,2016
Luuka Jones,New Zealand,0,1,0,1,2016
Dong Dong,People's Republic of China,0,1,0,1,2016
Mariya Stadnik,Azerbaijan,0,1,0,1,2016
Xetaq Qazyumov,Azerbaijan,0,1,0,1,2016
Mark O. Madsen,Denmark,0,1,0,1,2016
Rıza Kayaalp,Turkey,0,1,0,1,2016
María Espinoza,Mexico,0,1,0,1,2016
Timea Bacsinszky,Switzerland,0,1,0,1,2016
Jo Aleh,New Zealand,0,1,0,1,2016
Nathan Outteridge,Australia,0,1,0,1,2016
Jess Eddie,Great Britain,0,1,0,1,2016
Katie Greves,Great Britain,0,1,0,1,2016
James McRae,Australia,0,1,0,1,2016
Morten Jørgensen,Denmark,0,1,0,1,2016
Richard Schmidt,Germany,0,1,0,1,2016
Enzo Lefort,France,0,1,0,1,2016
Francine Niyonsaba,Burundi,0,1,0,1,2016
Siobhan-Marie O'Connor,Great Britain,0,1,0,1,2016
Federica Radicchi,Italy,0,1,0,1,2016
Nataliya Vorobyova,Russian Federation,0,1,0,1,2016
Kseniya Perova,Russian Federation,0,1,0,1,2016
Inna Stepanova,Russian Federation,0,1,0,1,2016
Koki Niwa,Japan,0,1,0,1,2016
Olga Zabelinskaya,Russian Federation,0,1,0,1,2016
Kirani James,Grenada,0,1,0,1,2016
Ryota Yamagata,Japan,0,1,0,1,2016
Shota Iizuka,Japan,0,1,0,1,2016
Aleksey Denisenko,Russian Federation,0,1,0,1,2016
Annalise Murphy,Ireland,0,1,0,1,2016
Marcus Svensson,Sweden,0,1,0,1,2016
Toğrul Əsgərov,Azerbaijan,0,1,0,1,2016
Pimsiri Sirikaew,Thailand,0,1,0,1,2016
Serhiy Kulish,Ukraine,0,1,0,1,2016
Élodie Clouvel,France,0,1,0,1,2016
Nikolay Kuksenkov,Russian Federation,0,1,0,1,2016
Horia Tecău,Romania,0,1,0,1,2016
Tonči Stipanović,Croatia,0,1,0,1,2016
Christinna Pedersen,Denmark,0,1,0,1,2016
Elmar Qasımov,Azerbaijan,0,1,0,1,2016
Damir Martin,Croatia,0,1,0,1,2016
Varlam Lip'art'eliani,Georgia,0,1,0,1,2016
Jelle van Gorkom,Netherlands,0,1,0,1,2016
Aleksandra Cotti,Italy,0,1,0,1,2016
Giulia Emmolo,Italy,0,1,0,1,2016
Roberta Bianconi,Italy,0,1,0,1,2016
Giulia Gorlero,Italy,0,1,0,1,2016
Valentin Demyanenko,Azerbaijan,0,1,0,1,2016
Lu Xiaojun,People's Republic of China,0,1,0,1,2016
Emma Berglund,Sweden,0,1,0,1,2016
Erlon Silva,Brazil,0,1,0,1,2016
Arthur Zanetti,Brazil,0,1,0,1,2016
He Zi,People's Republic of China,0,1,0,1,2016
Xu Jiayu,People's Republic of China,0,1,0,1,2016
Sun Yujie,People's Republic of China,0,1,0,1,2016
Marta Walczykiewicz,Poland,0,1,0,1,2016
Milenko Zorić,Serbia,0,1,0,1,2016
Marko Tomićević,Serbia,0,1,0,1,2016
Saulius Ritter,Lithuania,0,1,0,1,2016
Cai Zelin,People's Republic of China,0,1,0,1,2016
Bojana Živković,Serbia,0,1,0,1,2016
Milena Rašić,Serbia,0,1,0,1,2016
Lisa Dahlkvist,Sweden,0,1,0,1,2016
Jonathan Brownlee,Great Britain,0,1,0,1,2016
Lutalo Muhammad,Great Britain,0,1,0,1,2016
Lindsay Jennerich,Canada,0,1,0,1,2016
Patricia Obee,Canada,0,1,0,1,2016
Komeil Ghasemi,Islamic Republic of Iran,0,1,0,1,2016
Sofia Jakobsson,Sweden,0,1,0,1,2016
Linda Sembrant,Sweden,0,1,0,1,2016
Kasper Winther Jørgensen,Denmark,0,1,0,1,2016
Kosse Asllani,Sweden,0,1,0,1,2016
Jacob Barsøe,Denmark,0,1,0,1,2016
Sara Slott Petersen,Denmark,0,1,0,1,2016
Richard Hounslow,Great Britain,0,1,0,1,2016
Jon Schofield,Great Britain,0,1,0,1,2016
Victoria Thornley,Great Britain,0,1,0,1,2016
Melanie Wilson,Great Britain,0,1,0,1,2016
Ivan Zaytsev,Italy,0,1,0,1,2016
Paolo Nicolai,Italy,0,1,0,1,2016
Daniele Lupo,Italy,0,1,0,1,2016
Dorjsurengiin Sumiya,Mongolia,0,1,0,1,2016
Sandro Sukno,Croatia,0,1,0,1,2016
Juan Martín del Potro,Argentina,0,1,0,1,2016
Angelique Kerber,Germany,0,1,0,1,2016
Michael Hepburn,Australia,0,1,0,1,2016
Josh Booth,Australia,0,1,0,1,2016
Joshua Dunkley-Smith,Australia,0,1,0,1,2016
Karsten Forsterling,Australia,0,1,0,1,2016
William Lockwood,Australia,0,1,0,1,2016
Genzebe Dibaba,Ethiopia,0,1,0,1,2016
Elisa Di Francisca,Italy,0,1,0,1,2016
Hellen Obiri,Kenya,0,1,0,1,2016
Rossella Fiamingo,Italy,0,1,0,1,2016
Paolo Pizzo,Italy,0,1,0,1,2016
Jessica Ennis-Hill,Great Britain,0,1,0,1,2016
Mathew Belcher,Australia,0,1,0,1,2016
Iain Jensen,Australia,0,1,0,1,2016
Chris Walker-Hebborn,Great Britain,0,1,0,1,2016
Orlando Ortega,Cuba,0,1,0,1,2016
Kim Jong-Hyeon,Republic of Korea,0,1,0,1,2016
Maxime Beaumont,France,0,1,0,1,2016
Audrey Tcheuméo,France,0,1,0,1,2016
Mutaz Essa Barshim,Qatar,0,1,0,1,2016
Carlien Dirkse van den Heuvel,Netherlands,0,1,0,1,2016
Margot van Geffen,Netherlands,0,1,0,1,2016
Kelly Jonker,Netherlands,0,1,0,1,2016
Caia van Maasakker,Netherlands,0,1,0,1,2016
Kitty van Male,Netherlands,0,1,0,1,2016
Joyce Sombroek,Netherlands,0,1,0,1,2016
Sandra Aguilar,Spain,0,1,0,1,2016
Elena López,Spain,0,1,0,1,2016
Lourdes Mohedano,Spain,0,1,0,1,2016
Alejandra Quereda,Spain,0,1,0,1,2016
Blandine Dancette,France,0,1,0,1,2016
Siraba Dembélé,France,0,1,0,1,2016
Allison Pineau,France,0,1,0,1,2016
Cédric Sorhaindo,France,0,1,0,1,2016
Eric Johannesen,Germany,0,1,0,1,2016
Andreas Kuffner,Germany,0,1,0,1,2016
Maximilian Reinelt,Germany,0,1,0,1,2016
Martin Sauer,Germany,0,1,0,1,2016
Gauthier Boccard,Belgium,0,1,0,1,2016
Tom Boon,Belgium,0,1,0,1,2016
Dafne Schippers,Netherlands,0,1,0,1,2016
Sandra Auffarth,Germany,0,1,0,1,2016
Daniýar Ismaýilow,Turkey,0,1,0,1,2016
Chantal Achterberg,Netherlands,0,1,0,1,2016
Carline Bouw,Netherlands,0,1,0,1,2016
Inge Janssen,Netherlands,0,1,0,1,2016
Jérémy Stravius,France,0,1,0,1,2016
Renaud Lavillenie,France,0,1,0,1,2016
Kévin Mayer,France,0,1,0,1,2016
Cheong Jun Hoong,Malaysia,0,1,0,1,2016
Polly Powrie,New Zealand,0,1,0,1,2016
Rebecca Scown,New Zealand,0,1,0,1,2016
Jessica Ashwood,Australia,0,1,0,1,2016
Eddie Dawkins,New Zealand,0,1,0,1,2016
Ethan Mitchell,New Zealand,0,1,0,1,2016
Pieter Timmers,Belgium,0,1,0,1,2016
Florent Van Aubel,Belgium,0,1,0,1,2016
Vincent Vanasch,Belgium,0,1,0,1,2016
Simon Gougnard,Belgium,0,1,0,1,2016
Chan Peng Soon,Malaysia,0,1,0,1,2016
Goh Liu Ying,Malaysia,0,1,0,1,2016
Evan Jager,United States,0,1,0,1,2016
Gevvie Stone,United States,0,1,0,1,2016
Daryl Homer,United States,0,1,0,1,2016
Connor Jaeger,United States,0,1,0,1,2016
Lia Neal,United States,0,1,0,1,2016
Alise Post,United States,0,1,0,1,2016
Will Claye,United States,0,1,0,1,2016
Adilbek Niyazymbetov,Kazakhstan,0,1,0,1,2016
Valeriya Zholobova-Koblova,Russian Federation,0,1,0,1,2016
Om Yun-Chol,Democratic People's Republic of Korea,0,1,0,1,2016
Brankica Mihajlović,Serbia,0,1,0,1,2016
Rüstəm Orucov,Azerbaijan,0,1,0,1,2016
Julius Yego,Kenya,0,1,0,1,2016
Jake Kaminski,United States,0,1,0,1,2016
Boniface Tumuti,Kenya,0,1,0,1,2016
Christine Day,Jamaica,0,1,0,1,2016
Rusheen McDonald,Jamaica,0,1,0,1,2016
Xu Anqi,People's Republic of China,0,1,0,1,2016
Lisa Darmanin,Australia,0,1,0,1,2016
Leah Neale,Australia,0,1,0,1,2016
Tamsin Cook,Australia,0,1,0,1,2016
Taylor McKeown,Australia,0,1,0,1,2016
Daria Naumava,Belarus,0,1,0,1,2016
Maryia Mamashuk,Belarus,0,1,0,1,2016
Ágatha,Brazil,0,1,0,1,2016
Bárbara,Brazil,0,1,0,1,2016
Eunice Kirwa,Bahrain,0,1,0,1,2016
Mirela Demireva,Bulgaria,0,1,0,1,2016
Yin Junhua,People's Republic of China,0,1,0,1,2016
Si Yajie,People's Republic of China,0,1,0,1,2016
Hao Jialu,People's Republic of China,0,1,0,1,2016
Chen Peina,People's Republic of China,0,1,0,1,2016
Zhang Binbin,People's Republic of China,0,1,0,1,2016
Yin Chengxin,People's Republic of China,0,1,0,1,2016
Guo Li,People's Republic of China,0,1,0,1,2016
Tang Mengni,People's Republic of China,0,1,0,1,2016
Gu Xiao,People's Republic of China,0,1,0,1,2016
Li Xiaolu,People's Republic of China,0,1,0,1,2016
Liang Xinping,People's Republic of China,0,1,0,1,2016
Zeng Zhen,People's Republic of China,0,1,0,1,2016
Emma Jørgensen,Denmark,0,1,0,1,2016
Anna Cruz,Spain,0,1,0,1,2016
Astou Ndour,Spain,0,1,0,1,2016
Laura Gil,Spain,0,1,0,1,2016
Laura Quevedo,Spain,0,1,0,1,2016
Leonor Rodríguez,Spain,0,1,0,1,2016
Leticia Romero,Spain,0,1,0,1,2016
Marta Xargay,Spain,0,1,0,1,2016
Sílvia Domínguez,Spain,0,1,0,1,2016
Artemi Gavezou,Spain,0,1,0,1,2016
Eva Calvo,Spain,0,1,0,1,2016
Sarah Ourahmoune,France,0,1,0,1,2016
Béatrice Edwige,France,0,1,0,1,2016
Chloé Bulleux,France,0,1,0,1,2016
Estelle Nze Minko,France,0,1,0,1,2016
Gnonsiane Niombla,France,0,1,0,1,2016
Grâce Zaadi,France,0,1,0,1,2016
Laura Glauser,France,0,1,0,1,2016
Laurisa Landre,France,0,1,0,1,2016
Manon Houette,France,0,1,0,1,2016
Clarisse Agbegnenou,France,0,1,0,1,2016
Haby Niaré,France,0,1,0,1,2016
Fiona Bigwood,Great Britain,0,1,0,1,2016
Karen Bennett,Great Britain,0,1,0,1,2016
Olivia Carnegie-Brown,Great Britain,0,1,0,1,2016
Polly Swann,Great Britain,0,1,0,1,2016
Zoe de Toledo,Great Britain,0,1,0,1,2016
Zoe Lee,Great Britain,0,1,0,1,2016
Bryony Page,Great Britain,0,1,0,1,2016
Lisa Unruh,Germany,0,1,0,1,2016
Sabrina Hering,Germany,0,1,0,1,2016
Steffi Kriegerstein,Germany,0,1,0,1,2016
Monika Karsch,Germany,0,1,0,1,2016
Petrissa Solja,Germany,0,1,0,1,2016
Xiaona Shan,Germany,0,1,0,1,2016
Ying Han,Germany,0,1,0,1,2016
Sri Wahyuni Agustiani,Indonesia,0,1,0,1,2016
P. V. Sindhu,India,0,1,0,1,2016
Odette Giuffrida,Italy,0,1,0,1,2016
Rachele Bruni,Italy,0,1,0,1,2016
Arianna Garibotti,Italy,0,1,0,1,2016
Chiara Tabani,Italy,0,1,0,1,2016
Elisa Queirolo,Italy,0,1,0,1,2016
Francesca Pomeri,Italy,0,1,0,1,2016
Laura Teani,Italy,0,1,0,1,2016
Rosaria Aiello,Italy,0,1,0,1,2016
Anneisha McLaughlin-Whilby,Jamaica,0,1,0,1,2016
Chrisann Gordon,Jamaica,0,1,0,1,2016
Shashalee Forbes,Jamaica,0,1,0,1,2016
Simone Facey,Jamaica,0,1,0,1,2016
Stephenie McPherson,Jamaica,0,1,0,1,2016
Zhazira Zhapparkul,Kazakhstan,0,1,0,1,2016
Hyvin Kiyeng,Kenya,0,1,0,1,2016
Jeong Bo-Gyeong,Republic of Korea,0,1,0,1,2016
María Guadalupe González,Mexico,0,1,0,1,2016
Nouchka Fontijn,Netherlands,0,1,0,1,2016
Laurien Leurink,Netherlands,0,1,0,1,2016
Marloes Keetels,Netherlands,0,1,0,1,2016
Maria Verschoor,Netherlands,0,1,0,1,2016
Willemijn Bos,Netherlands,0,1,0,1,2016
Xan de Waard,Netherlands,0,1,0,1,2016
Nicole Beukers,Netherlands,0,1,0,1,2016
Lydia Ko,New Zealand,0,1,0,1,2016
Gayle Broughton,New Zealand,0,1,0,1,2016
Huriana Manuel,New Zealand,0,1,0,1,2016
Kayla McAlister,New Zealand,0,1,0,1,2016
Kelly Brazier,New Zealand,0,1,0,1,2016
Niall Williams,New Zealand,0,1,0,1,2016
Portia Woodman,New Zealand,0,1,0,1,2016
Ruby Tui,New Zealand,0,1,0,1,2016
Sarah Goss,New Zealand,0,1,0,1,2016
Shakira Baker,New Zealand,0,1,0,1,2016
Terina Te Tamaki,New Zealand,0,1,0,1,2016
Theresa Fitzpatrick,New Zealand,0,1,0,1,2016
Tyla Nathan-Wong,New Zealand,0,1,0,1,2016
Gen Behrent,New Zealand,0,1,0,1,2016
Alex Maloney,New Zealand,0,1,0,1,2016
Molly Meech,New Zealand,0,1,0,1,2016
Natalie Rooney,New Zealand,0,1,0,1,2016
Choe Hyo-Sim,Democratic People's Republic of Korea,0,1,0,1,2016
Kim Kuk-Hyang,Democratic People's Republic of Korea,0,1,0,1,2016
Tuyana Dashidorzhiyeva,Russian Federation,0,1,0,1,2016
Anastasiya Voynova,Russian Federation,0,1,0,1,2016
Darya Shmelyova,Russian Federation,0,1,0,1,2016
Angelina Melnikova,Russian Federation,0,1,0,1,2016
Darya Spiridonova,Russian Federation,0,1,0,1,2016
Seda Tutkhalyan,Russian Federation,0,1,0,1,2016
Yana Kudryavtseva,Russian Federation,0,1,0,1,2016
Vitalina Batsarashkina,Russian Federation,0,1,0,1,2016
Tijana Bogdanović,Serbia,0,1,0,1,2016
Bianka Buša,Serbia,0,1,0,1,2016
Jovana Stevanović,Serbia,0,1,0,1,2016
Tijana Bošković,Serbia,0,1,0,1,2016
Tijana Malešević,Serbia,0,1,0,1,2016
Elin Rubensson,Sweden,0,1,0,1,2016
Emilia Appelqvist,Sweden,0,1,0,1,2016
Fridolina Rolfö,Sweden,0,1,0,1,2016
Jessica Samuelsson,Sweden,0,1,0,1,2016
Jonna Andersson,Sweden,0,1,0,1,2016
Magda Eriksson,Sweden,0,1,0,1,2016
Olivia Schough,Sweden,0,1,0,1,2016
Pauline Hammarlund,Sweden,0,1,0,1,2016
Stina Blackstenius,Sweden,0,1,0,1,2016
Alina Komashchuk,Ukraine,0,1,0,1,2016
Olena Kravatska,Ukraine,0,1,0,1,2016
Olena Voronina,Ukraine,0,1,0,1,2016
Nia Ali,United States,0,1,0,1,2016
Sandi Morris,United States,0,1,0,1,2016
Chloé Dygert,United States,0,1,0,1,2016
Jennifer Valente,United States,0,1,0,1,2016
Kelly Catlin,United States,0,1,0,1,2016
Lucy Davis,United States,0,1,0,1,2016
Yulimar Rojas,Venezuela,0,1,0,1,2016
Gor Minasyan,Armenia,0,1,0,1,2016
Simon Martirosyan,Armenia,0,1,0,1,2016
Migran Arutyunyan,Armenia,0,1,0,1,2016
Alex Edmondson,Australia,0,1,0,1,2016
Callum Scotson,Australia,0,1,0,1,2016
Sam Welsford,Australia,0,1,0,1,2016
Alexander Belonogoff,Australia,0,1,0,1,2016
Alex Hill,Australia,0,1,0,1,2016
Cameron Girdlestone,Australia,0,1,0,1,2016
Jason Waterhouse,Australia,0,1,0,1,2016
Will Ryan,Australia,0,1,0,1,2016
Lorenso Sotomayor,Azerbaijan,0,1,0,1,2016
Arthur Van Doren,Belgium,0,1,0,1,2016
Elliot Van Strydonck,Belgium,0,1,0,1,2016
Emmanuel Stockbroekx,Belgium,0,1,0,1,2016
Loïck Luypaert,Belgium,0,1,0,1,2016
Sébastien Dockier,Belgium,0,1,0,1,2016
Tanguy Cosyns,Belgium,0,1,0,1,2016
Felipe Wu,Brazil,0,1,0,1,2016
Tian Tao,People's Republic of China,0,1,0,1,2016
Yuberjén Martínez,Colombia,0,1,0,1,2016
Anđelo Šetka,Croatia,0,1,0,1,2016
Antonio Petković,Croatia,0,1,0,1,2016
Ivan Krapić,Croatia,0,1,0,1,2016
Luka Bukić,Croatia,0,1,0,1,2016
Luka Lončar,Croatia,0,1,0,1,2016
Marko Bijač,Croatia,0,1,0,1,2016
Marko Macan,Croatia,0,1,0,1,2016
Yasmany Lugo,Cuba,0,1,0,1,2016
Jacob Larsen,Denmark,0,1,0,1,2016
Feyisa Lilesa,Ethiopia,0,1,0,1,2016
Sofiane Oumiha,France,0,1,0,1,2016
Jean-Paul Tony Helissey,France,0,1,0,1,2016
Jérémy Cadot,France,0,1,0,1,2016
Adrien Dipanda,France,0,1,0,1,2016
Kentin Mahé,France,0,1,0,1,2016
Ludovic Fabregas,France,0,1,0,1,2016
Luka Karabatic,France,0,1,0,1,2016
Mathieu Grébille,France,0,1,0,1,2016
Timothey N'Guessan,France,0,1,0,1,2016
Valentin Porte,France,0,1,0,1,2016
Vincent Gérard,France,0,1,0,1,2016
Jean Quiquampoix,France,0,1,0,1,2016
Clément Mignon,France,0,1,0,1,2016
Mehdy Metella,France,0,1,0,1,2016
William Meynard,France,0,1,0,1,2016
Joe Joyce,Great Britain,0,1,0,1,2016
Spencer Wilton,Great Britain,0,1,0,1,2016
Ruaridh McConnochie,Great Britain,0,1,0,1,2016
Dan Bibby,Great Britain,0,1,0,1,2016
Dan Norton,Great Britain,0,1,0,1,2016
James Davies,Great Britain,0,1,0,1,2016
James Rodwell,Great Britain,0,1,0,1,2016
Mark Bennett,Great Britain,0,1,0,1,2016
Mark Robertson,Great Britain,0,1,0,1,2016
Marcus Watson,Great Britain,0,1,0,1,2016
Ollie Lindsay-Hague,Great Britain,0,1,0,1,2016
Phil Burgess,Great Britain,0,1,0,1,2016
Sam Cross,Great Britain,0,1,0,1,2016
Tom Mitchell,Great Britain,0,1,0,1,2016
Dan Wallace,Great Britain,0,1,0,1,2016
Stephen Milne,Great Britain,0,1,0,1,2016
Davie Selke,Germany,0,1,0,1,2016
Grischa Prömel,Germany,0,1,0,1,2016
Jeremy Toljan,Germany,0,1,0,1,2016
Julian Brandt,Germany,0,1,0,1,2016
Lars Bender,Germany,0,1,0,1,2016
Leon Goretzka,Germany,0,1,0,1,2016
Lukas Klostermann,Germany,0,1,0,1,2016
Matthias Ginter,Germany,0,1,0,1,2016
Max Christiansen,Germany,0,1,0,1,2016
Max Meyer,Germany,0,1,0,1,2016
Niklas Süle,Germany,0,1,0,1,2016
Nils Petersen,Germany,0,1,0,1,2016
Philipp Max,Germany,0,1,0,1,2016
Robert Bauer,Germany,0,1,0,1,2016
Serge Gnabry,Germany,0,1,0,1,2016
Sven Bender,Germany,0,1,0,1,2016
Timo Horn,Germany,0,1,0,1,2016
Hannes Ocik,Germany,0,1,0,1,2016
Malte Jakschik,Germany,0,1,0,1,2016
Maximilian Munski,Germany,0,1,0,1,2016
Gary O'Donovan,Ireland,0,1,0,1,2016
Paul O'Donovan,Ireland,0,1,0,1,2016
Andrea Santarelli,Italy,0,1,0,1,2016
Enrico Garozzo,Italy,0,1,0,1,2016
Marco Fichera,Italy,0,1,0,1,2016
Filippo Lanza,Italy,0,1,0,1,2016
Luca Vettori,Italy,0,1,0,1,2016
Massimo Colaci,Italy,0,1,0,1,2016
Matteo Piano,Italy,0,1,0,1,2016
Oleg Antonov,Italy,0,1,0,1,2016
Osmany Juantorena,Italy,0,1,0,1,2016
Pasquale Sottile,Italy,0,1,0,1,2016
Salvatore Rossini,Italy,0,1,0,1,2016
Simone Buti,Italy,0,1,0,1,2016
Simone Giannelli,Italy,0,1,0,1,2016
Fitzroy Dunkley,Jamaica,0,1,0,1,2016
Javon Francis,Jamaica,0,1,0,1,2016
Nathon Allen,Jamaica,0,1,0,1,2016
Peter Matthews,Jamaica,0,1,0,1,2016
Aska Cambridge,Japan,0,1,0,1,2016
Yoshihide Kiryu,Japan,0,1,0,1,2016
Hisayoshi Harasawa,Japan,0,1,0,1,2016
Masato Sakai,Japan,0,1,0,1,2016
Maharu Yoshimura,Japan,0,1,0,1,2016
Rei Higuchi,Japan,0,1,0,1,2016
Shinobu Ota,Japan,0,1,0,1,2016
Vasily Levit,Kazakhstan,0,1,0,1,2016
Yeldos Smetov,Kazakhstan,0,1,0,1,2016
Paul Tanui,Kenya,0,1,0,1,2016
An Ba-Ul,Republic of Korea,0,1,0,1,2016
Goh V Shem,Malaysia,0,1,0,1,2016
Tan Wee Kiong,Malaysia,0,1,0,1,2016
Matthijs Büchli,Netherlands,0,1,0,1,2016
Tom Dumoulin,Netherlands,0,1,0,1,2016
Razak Alfaga,Niger,0,1,0,1,2016
Sam Webster,New Zealand,0,1,0,1,2016
Florin Mergea,Romania,0,1,0,1,2016
Luvo Manyonga,South Africa,0,1,0,1,2016
Lawrence Brittain,South Africa,0,1,0,1,2016
Ivan Stretovich,Russian Federation,0,1,0,1,2016
Nikita Nagorny,Russian Federation,0,1,0,1,2016
Sergey Kamensky,Russian Federation,0,1,0,1,2016
Aniuar Geduyev,Russian Federation,0,1,0,1,2016
Bogdan Bogdanović,Serbia,0,1,0,1,2016
Marko Simonović,Serbia,0,1,0,1,2016
Milan Mačvan,Serbia,0,1,0,1,2016
Miloš Teodosić,Serbia,0,1,0,1,2016
Miroslav Raduljica,Serbia,0,1,0,1,2016
Nemanja Nedović,Serbia,0,1,0,1,2016
Nikola Jokić,Serbia,0,1,0,1,2016
Nikola Kalinić,Serbia,0,1,0,1,2016
Stefan Birčević,Serbia,0,1,0,1,2016
Stefan Jović,Serbia,0,1,0,1,2016
Stefan Marković,Serbia,0,1,0,1,2016
Vladimir Štimac,Serbia,0,1,0,1,2016
Denis Myšák,Slovakia,0,1,0,1,2016
Matej Beňuš,Slovakia,0,1,0,1,2016
Tibor Linka,Slovakia,0,1,0,1,2016
Henrik Stenson,Sweden,0,1,0,1,2016
Tawin Hanprab,Thailand,0,1,0,1,2016
Selim Yaşar,Turkey,0,1,0,1,2016
Zhan Beleniuk,Ukraine,0,1,0,1,2016
Zach Garrett,United States,0,1,0,1,2016
Joe Kovacs,United States,0,1,0,1,2016
Paul Chelimo,United States,0,1,0,1,2016
Shakur Stevenson,United States,0,1,0,1,2016
Mike Hixon,United States,0,1,0,1,2016
Sam Dorman,United States,0,1,0,1,2016
Steele Johnson,United States,0,1,0,1,2016
Kent Farrington,United States,0,1,0,1,2016
Chase Kalisz,United States,0,1,0,1,2016
Josh Prenot,United States,0,1,0,1,2016
Rajeev Ram,United States,0,1,0,1,2016
Bektemir Melikuziyev,Uzbekistan,0,1,0,1,2016
Shakhram Giyasov,Uzbekistan,0,1,0,1,2016
Yoel Finol,Venezuela,0,1,0,1,2016
Olivier Nyokas,France,0,1,0,1,2016
Tamara Horacek,France,0,1,0,1,2016
Marie Prouvensier,France,0,1,0,1,2016
Silvija Popović,Serbia,0,1,0,1,2016
Julia Krajewski,Germany,0,1,0,1,2016
Christania Williams,Jamaica,0,1,0,1,2016
Larissa Meijer,Netherlands,0,1,0,1,2016
Laura Nunnink,Netherlands,0,1,0,1,2016
Michelle van der Pols,Netherlands,0,1,0,1,2016
Alexandre de Paeuw,Belgium,0,1,0,1,2016
Alexander Hendrickx,Belgium,0,1,0,1,2016
John Pius Boland,Ireland,2,0,0,2,1896
Alexandre Tuffèri,Greece,0,1,0,1,1896
Fred Lane,Great Britain,2,0,0,2,1900
William Exshaw,Great Britain,2,0,0,2,1900
Stan Rowley,Great Britain,1,0,3,4,1900
George Orton,United States,1,0,1,2,1900
Charles Sands,United States,1,0,0,1,1900
Constantin Henriquez,Haiti,1,0,0,1,1900
André Roosevelt,United States,1,0,0,1,1900
Denis Daly,Ireland,1,0,0,1,1900
Foxhall Keene,United States,1,0,0,1,1900
Frank Mackey,United States,1,0,0,1,1900
Michel Théato,Luxembourg,1,0,0,1,1900
Victor Lindberg,New Zealand,1,0,0,1,1900
Harold Mahony,Ireland,0,2,1,3,1900
Otto Wahle,United States,0,2,0,2,1900
Pat Leahy,Ireland,0,1,1,2,1900
William Anderson,Great Britain,0,1,0,1,1900
John Braid,Great Britain,0,1,0,1,1900
W. Browning,Great Britain,0,1,0,1,1900
Robert Horne,Great Britain,0,1,0,1,1900
Timothée Jordan,Great Britain,0,1,0,1,1900
Arthur MacEvoy,Great Britain,0,1,0,1,1900
Douglas Robinson,Great Britain,0,1,0,1,1900
Alfred Schneidau,Great Britain,0,1,0,1,1900
Henry Terry,Great Britain,0,1,0,1,1900
Jean De Madre,Great Britain,0,1,0,1,1900
Walter McCreery,United States,0,1,0,1,1900
Polly Whittier,United States,0,1,0,1,1900
Alfred Van Landeghem,Denmark,0,1,0,1,1900
František Janda-Suk,Czech Republic,0,1,0,1,1900
Francis Henríquez de Zubiria,France,0,1,0,1,1900
Archibald Warden,Great Britain,0,0,1,1,1900
Abbie Pratt,United States,0,0,1,1,1900
Milan Neralić,Croatia,0,0,1,1,1900
Eric Thornton,Great Britain,0,0,1,1,1900
Henk van Heuckelum,Netherlands,0,0,1,1,1900
Bill Burgess,Great Britain,0,0,1,1,1900
Frederick Gill,Great Britain,0,0,1,1,1900
Julius Lenhart,United States,2,1,0,3,1904
Adolf Spinnler,Switzerland,1,0,1,2,1904
Charles Ericksen,United States,1,0,0,1,1904
Bernhoff Hansen,United States,1,0,0,1,1904
Tom Kiely,Ireland,1,0,0,1,1904
Frank Gailey,United States,0,3,1,4,1904
Albert Corey,United States,0,2,0,2,1904
Franz Kugler,United States,0,1,3,4,1904
Al Lambert,United States,0,1,0,1,1904
John Daly,Ireland,0,1,0,1,1904
Otto Wahle,United States,0,0,1,1,1904
Gustav Tiefenthaler,United States,0,0,1,1,1904
Ned Barrett,Ireland,1,0,1,2,1908
John Barnett,Australia,1,0,0,1,1908
Bede Smith,Australia,1,0,0,1,1908
Phil Carmichael,Australia,1,0,0,1,1908
Dan Carroll,Australia,1,0,0,1,1908
Bob Craig,Australia,1,0,0,1,1908
Tom Griffin,Australia,1,0,0,1,1908
Jack Hickey,Australia,1,0,0,1,1908
Mannie McArthur,Australia,1,0,0,1,1908
Arthur McCabe,Australia,1,0,0,1,1908
Paddy McCue,Australia,1,0,0,1,1908
Chris McKivat,Australia,1,0,0,1,1908
Charles McMurtrie,Australia,1,0,0,1,1908
Syd Middleton,Australia,1,0,0,1,1908
Tom Richards,Australia,1,0,0,1,1908
Charles Russell,Australia,1,0,0,1,1908
Joshua Millner,Ireland,1,0,0,1,1908
Joe Deakin,Ireland,1,0,0,1,1908
Frank Beaurepaire,Australia,0,1,1,2,1908
James Parke,Ireland,0,1,0,1,1908
Hardress Lloyd,Ireland,0,1,0,1,1908
John McCann,Ireland,0,1,0,1,1908
Percy O'Reilly,Ireland,0,1,0,1,1908
Auston Rotheram,Ireland,0,1,0,1,1908
"Jack, Lord Wodehouse",Ireland,0,1,0,1,1908
Jim Clarke,Ireland,0,1,0,1,1908
Percy Allman-Smith,Ireland,0,1,0,1,1908
Henry Brown,Ireland,0,1,0,1,1908
Walter Campbell,Ireland,0,1,0,1,1908
William Graham,Ireland,0,1,0,1,1908
Richard Gregg,Ireland,0,1,0,1,1908
Edward Holmes,Ireland,0,1,0,1,1908
Robert Kennedy,Ireland,0,1,0,1,1908
Henry Murphy,Ireland,0,1,0,1,1908
Walter Peterson,Ireland,0,1,0,1,1908
Charles Power,Ireland,0,1,0,1,1908
Franks Robinson,Ireland,0,1,0,1,1908
Alfred Van Landeghem,Denmark,0,1,0,1,1908
William Lane-Joynt,Ireland,0,1,0,1,1908
Snowy Baker,Australia,0,1,0,1,1908
Denis Horgan,Ireland,0,1,0,1,1908
Con Leahy,Ireland,0,1,0,1,1908
Jack Peterson,Ireland,0,1,0,1,1908
Beatrice Hill-Lowe,Ireland,0,0,1,1,1908
Charles Foulkes,Mixed team,0,0,1,1,1908
Jaroslav Tuček,Czech Republic,0,0,1,1,1908
Maurice Blood,Ireland,0,0,1,1,1908
Bob Hutton,Ireland,0,0,1,1,1908
Harry Kerr,New Zealand,0,0,1,1,1908
Cecil Healy,Australia,1,1,0,2,1912
Harold Hardwick,Australia,1,0,2,3,1912
Fanny Durack,Australia,1,0,0,1,1912
Les Boardman,Australia,1,0,0,1,1912
Malcolm Champion,New Zealand,1,0,0,1,1912
"Pierre, Baron de Coubertin",Germany,1,0,0,1,1912
Matt Hynes,Ireland,0,1,0,1,1912
Rudolf Cvetko,Slovenia,0,1,0,1,1912
Albert Bogen,Hungary,0,1,0,1,1912
Mina Wylie,Australia,0,1,0,1,1912
Martin Klein,Russian Federation,0,1,0,1,1912
Mart Kuusik,Russian Federation,0,0,1,1,1912
Harry Blaus,Russian Federation,0,0,1,1,1912
Mór Kóczán,Hungary,0,0,1,1,1912
Tony Wilding,New Zealand,0,0,1,1,1912
Dan Carroll,Australia,1,0,0,1,1920
Frederick Barrett,Ireland,1,0,0,1,1920
"Jack, Lord Wodehouse",Ireland,1,0,0,1,1920
Noel Purcell,Ireland,1,0,0,1,1920
Frank Beaurepaire,Australia,0,1,1,2,1920
Harry Edward,Guyana,0,0,2,2,1920
Milada Skrbková,Czechoslovakia,0,0,1,1,1920
Ladislav Žemla,Czech Republic,0,0,1,1,1920
Karel Hartmann,Czechoslovakia,0,0,1,1,1920
Vilém Loos,Czechoslovakia,0,0,1,1,1920
Jan Palouš,Czechoslovakia,0,0,1,1,1920
Jan Peka,Czechoslovakia,0,0,1,1,1920
Karel Pešek,Czechoslovakia,0,0,1,1,1920
Josef Šroubek,Czechoslovakia,0,0,1,1,1920
Otakar Vindyš,Czechoslovakia,0,0,1,1,1920
Basil Williams,Ireland,0,0,1,1,1920
Karel Wälzer,Czechoslovakia,0,0,1,1,1920
Leon Štukelj,Yugoslavia,2,0,0,2,1924
Bedřich Šupčík,Czechoslovakia,1,0,1,2,1924
Robert Pražák,Czechoslovakia,0,3,0,3,1924
Frank Beaurepaire,Australia,0,1,1,2,1924
Jan Koutný,Czechoslovakia,0,1,0,1,1924
Ladislav Vácha,Czechoslovakia,0,0,2,2,1924
Frederick Barrett,Ireland,0,0,1,1,1924
Bohumil Mořkovský,Czechoslovakia,0,0,1,1,1924
Antonio Cattalinich,Italy,0,0,1,1,1924
Francesco Cattalinich,Italy,0,0,1,1,1924
Simeone Cattalinich,Italy,0,0,1,1,1924
Vittorio Gliubich,Italy,0,0,1,1,1924
Pietro Ivanov,Italy,0,0,1,1,1924
Bruno Sorich,Italy,0,0,1,1,1924
Bohumil Durdis,Czechoslovakia,0,0,1,1,1924
Ladislav Vácha,Czechoslovakia,1,2,0,3,1928
Leon Štukelj,Yugoslavia,1,0,2,3,1928
František Ventura,Czechoslovakia,1,0,0,1,1928
Boughera El Ouafi,France,1,0,0,1,1928
Emanuel Löffler,Czechoslovakia,0,2,1,3,1928
Jože Primožič,Yugoslavia,0,1,1,2,1928
Jack London,Guyana,0,1,1,2,1928
Jan Heřmánek,Czechoslovakia,0,1,0,1,1928
Josef Effenberger,Czechoslovakia,0,1,0,1,1928
Jan Gajdoš,Czechoslovakia,0,1,0,1,1928
Jan Koutný,Czechoslovakia,0,1,0,1,1928
Bedřich Šupčík,Czechoslovakia,0,1,0,1,1928
Ladislav Tikal,Czechoslovakia,0,1,0,1,1928
Václav Veselý,Czechoslovakia,0,1,0,1,1928
Jindřich Maudr,Czechoslovakia,0,1,0,1,1928
Stane Derganc,Yugoslavia,0,0,2,2,1928
Karol von Rómmel,Russian Federation,0,0,1,1,1928
Edvard Antonijevič,Yugoslavia,0,0,1,1,1928
Drago Ciotti,Yugoslavia,0,0,1,1,1928
Boris Gregorka,Yugoslavia,0,0,1,1,1928
Anton Malej,Yugoslavia,0,0,1,1,1928
Janez Porenta,Yugoslavia,0,0,1,1,1928
Jaroslav Skobla,Czechoslovakia,0,0,1,1,1928
Jaroslav Skobla,Czechoslovakia,1,0,0,1,1932
"Václav Pšenička, Sr.",Czechoslovakia,0,1,0,1,1932
Josef Urban,Czechoslovakia,0,1,0,1,1932
František Douda,Czechoslovakia,0,0,1,1,1932
Alfred Schwarzmann,West Germany,3,0,2,5,1936
Heinz Pollay,West Germany,2,0,0,2,1936
Jan Brzák-Felix,Czechoslovakia,1,0,0,1,1936
Václav Mottl,Czechoslovakia,1,0,0,1,1936
Zdeněk Škrland,Czechoslovakia,1,0,0,1,1936
Vladimír Syrovátka,Czechoslovakia,1,0,0,1,1936
Ali Dara,Pakistan,1,0,0,1,1936
Alois Hudec,Czechoslovakia,1,0,0,1,1936
Son Gi-Jeong,Republic of Korea,1,0,0,1,1936
Gisela Jacob-Arendt,West Germany,0,1,1,2,1936
Bohuslav Karlík,Czechoslovakia,0,1,0,1,1936
Jaroslava Bajerová,Czechoslovakia,0,1,0,1,1936
Vlasta Děkanová,Czechoslovakia,0,1,0,1,1936
Božena Dobešová,Czechoslovakia,0,1,0,1,1936
Vlasta Foltová,Czechoslovakia,0,1,0,1,1936
Anna Hřebřinová,Czechoslovakia,0,1,0,1,1936
Matylda Pálfyová,Slovakia,0,1,0,1,1936
Zdena Veřmiřovská,Czechoslovakia,0,1,0,1,1936
Marie Větrovská,Czechoslovakia,0,1,0,1,1936
Leon Štukelj,Yugoslavia,0,1,0,1,1936
Bernhard Baier,West Germany,0,1,0,1,1936
"Václav Pšenička, Sr.",Czechoslovakia,0,1,0,1,1936
Jozef Herda,Slovakia,0,1,0,1,1936
Josef Klapuch,Czechoslovakia,0,1,0,1,1936
Werner Krogmann,West Germany,0,1,0,1,1936
Julius Eisenecker,West Germany,0,0,2,2,1936
Hans Esser,West Germany,0,0,1,1,1936
Nam Sung-Yong,Republic of Korea,0,0,1,1,1936
Emil Zátopek,Czechoslovakia,1,1,0,2,1948
Július Torma,Slovakia,1,0,0,1,1948
Jan Brzák-Felix,Czechoslovakia,1,0,0,1,1948
František Čapek,Czechoslovakia,1,0,0,1,1948
Josef Holeček,Czechoslovakia,1,0,0,1,1948
Bohumil Kudrna,Czechoslovakia,1,0,0,1,1948
Randhir Singh Gentle,Uganda,1,0,0,1,1948
Akhtar Hussain,Pakistan,1,0,0,1,1948
Latif-ur Rehman,Pakistan,1,0,0,1,1948
Zdeňka Honsová,Czechoslovakia,1,0,0,1,1948
Marie Kovářová,Czechoslovakia,1,0,0,1,1948
Miloslava Misáková,Czechoslovakia,1,0,0,1,1948
Milena Müllerová,Czechoslovakia,1,0,0,1,1948
Věra Růžičková,Czechoslovakia,1,0,0,1,1948
Olga Šilhánová,Czechoslovakia,1,0,0,1,1948
Božena Srncová,Czechoslovakia,1,0,0,1,1948
Zdena Veřmiřovská,Czechoslovakia,1,0,0,1,1948
Václav Havel,Czechoslovakia,0,1,0,1,1948
Jiří Pecka,Czechoslovakia,0,1,0,1,1948
Aleksandar Atanacković,Yugoslavia,0,1,0,1,1948
Stjepan Bobek,Yugoslavia,0,1,0,1,1948
Željko Čajkovski,Yugoslavia,0,1,0,1,1948
Zlatko Čajkovski,Yugoslavia,0,1,0,1,1948
Zvonko Cimermančić,Yugoslavia,0,1,0,1,1948
Miodrag Jovanović,Yugoslavia,0,1,0,1,1948
Ljubomir Lovrić,Yugoslavia,0,1,0,1,1948
Prvoslav Mihajlović,Yugoslavia,0,1,0,1,1948
Rajko Mitić,Yugoslavia,0,1,0,1,1948
Franjo Šoštarić,Yugoslavia,0,1,0,1,1948
Branko Stanković,Yugoslavia,0,1,0,1,1948
Kosta Tomašević,Yugoslavia,0,1,0,1,1948
Bernard Vukas,Yugoslavia,0,1,0,1,1948
Franjo Velfl,Yugoslavia,0,1,0,1,1948
Alain Mimoun,France,0,1,0,1,1948
Ivan Gubijan,Yugoslavia,0,1,0,1,1948
Zdeněk Růžička,Czechoslovakia,0,0,2,2,1948
Leo Sotorník,Czechoslovakia,0,0,1,1,1948
Róbert Zimonyi,United States,0,0,1,1,1948
Éva Gérard-Novák,Hungary,0,0,1,1,1948
Birte Christoffersen-Hanson,Sweden,0,0,1,1,1948
Viktor Chukarin,Ukraine,4,2,0,6,1952
Emil Zátopek,Czechoslovakia,3,0,0,3,1952
Mariya Gorokhovskaya,Ukraine,2,5,0,7,1952
Nina Bocharova,Ukraine,2,2,0,4,1952
Hrant Shahinyan,Soviet Union,2,2,0,4,1952
Yekaterina Kalinchuk,Soviet Union,2,1,0,3,1952
Éva Gérard-Novák,Hungary,1,2,0,3,1952
Galina Minaicheva,Soviet Union,1,1,1,3,1952
Pelageya Danilova,Soviet Union,1,1,0,2,1952
Medeya Jugeli,Soviet Union,1,1,0,2,1952
Galina Shamray,Uzbekistan,1,1,0,2,1952
Galina Urbanovich,Soviet Union,1,1,0,2,1952
Yevgeny Korolkov,Soviet Union,1,1,0,2,1952
Dmitry Leonkin,Ukraine,1,0,1,2,1952
Ján Zachara,Slovakia,1,0,0,1,1952
Josef Holeček,Czechoslovakia,1,0,0,1,1952
Randhir Singh Gentle,Uganda,1,0,0,1,1952
Vladimir Belyakov,Soviet Union,1,0,0,1,1952
Iosif Berdiyev,Soviet Union,1,0,0,1,1952
Valentin Muratov,Soviet Union,1,0,0,1,1952
Mikhail Perlman,Soviet Union,1,0,0,1,1952
Jiří Havlis,Czechoslovakia,1,0,0,1,1952
Jan Jindra,Czechoslovakia,1,0,0,1,1952
Miroslav Koranda,Czechoslovakia,1,0,0,1,1952
Stanislav Lusk,Czechoslovakia,1,0,0,1,1952
"Karel Mejta, Sr.",Czechoslovakia,1,0,0,1,1952
Yury Tyukalov,Soviet Union,1,0,0,1,1952
Duje Bonačić,Yugoslavia,1,0,0,1,1952
Petar Šegvić,Yugoslavia,1,0,0,1,1952
Mate Trojanović,Yugoslavia,1,0,0,1,1952
Velimir Valenta,Yugoslavia,1,0,0,1,1952
Anatoly Bogdanov,Soviet Union,1,0,0,1,1952
Trofim Lomakin,Soviet Union,1,0,0,1,1952
Rapael Chimishk'iani,Soviet Union,1,0,0,1,1952
Ivan Udodov,Soviet Union,1,0,0,1,1952
Boris Gurevich,Soviet Union,1,0,0,1,1952
Johannes Kotkas,Soviet Union,1,0,0,1,1952
Arsen Mek'ok'ishvili,Soviet Union,1,0,0,1,1952
Yakov Punkin,Ukraine,1,0,0,1,1952
Shazam Safin,Soviet Union,1,0,0,1,1952
Davit Tsimak'uridze,Soviet Union,1,0,0,1,1952
Dana Ingrová-Zátopková,Czechoslovakia,1,0,0,1,1952
Nina Romashkova-Ponomaryova,Soviet Union,1,0,0,1,1952
Galina Zybina,Soviet Union,1,0,0,1,1952
Aleksandra Chudina,Soviet Union,0,2,1,3,1952
Alain Mimoun,France,0,2,0,2,1952
Willi Büsing,West Germany,0,1,1,2,1952
Boris Andreyev,Soviet Union,0,1,1,2,1952
Maria Sander,West Germany,0,1,1,2,1952
Ilmar Kullam,Soviet Union,0,1,0,1,1952
Justinas Lagunavičius,Soviet Union,0,1,0,1,1952
Edgar Basel,West Germany,0,1,0,1,1952
Aleksandr Moiseyev,Soviet Union,0,1,0,1,1952
Stepas Butautas,Lithuania,0,1,0,1,1952
Nodar Jorjik'ia,Soviet Union,0,1,0,1,1952
Anatoly Konev,Soviet Union,0,1,0,1,1952
Otar Korkia,Soviet Union,0,1,0,1,1952
Heino Kruus,Soviet Union,0,1,0,1,1952
Joann Lõssov,Soviet Union,0,1,0,1,1952
Yury Ozerov,Soviet Union,0,1,0,1,1952
Kazys Petkevičius,Soviet Union,0,1,0,1,1952
Stasys Stonkus,Soviet Union,0,1,0,1,1952
Maigonis Valdmanis,Soviet Union,0,1,0,1,1952
Viktor Vlasov,Soviet Union,0,1,0,1,1952
Viktor Mednov,Soviet Union,0,1,0,1,1952
Sergey Shcherbakov,Soviet Union,0,1,0,1,1952
Jan Brzák-Felix,Czechoslovakia,0,1,0,1,1952
Bohumil Kudrna,Czechoslovakia,0,1,0,1,1952
Otto Rothe,West Germany,0,1,0,1,1952
Klaus Wagner,West Germany,0,1,0,1,1952
Vladimir Beara,Yugoslavia,0,1,0,1,1952
Stjepan Bobek,Yugoslavia,0,1,0,1,1952
Vujadin Boškov,Yugoslavia,0,1,0,1,1952
Zlatko Čajkovski,Yugoslavia,0,1,0,1,1952
Tomislav Crnković,Yugoslavia,0,1,0,1,1952
Ivica Horvat,Yugoslavia,0,1,0,1,1952
Rajko Mitić,Yugoslavia,0,1,0,1,1952
Tihomir Ognjanov,Yugoslavia,0,1,0,1,1952
Branko Stanković,Yugoslavia,0,1,0,1,1952
Bernard Vukas,Yugoslavia,0,1,0,1,1952
Branko Zebec,Yugoslavia,0,1,0,1,1952
Alfred Schwarzmann,West Germany,0,1,0,1,1952
Helmut Heinhold,West Germany,0,1,0,1,1952
Heinz Manchen,West Germany,0,1,0,1,1952
Helmut Noll,West Germany,0,1,0,1,1952
Slava Amiragov,Soviet Union,0,1,0,1,1952
Igor Borisov,Soviet Union,0,1,0,1,1952
Yevgeny Brago,Soviet Union,0,1,0,1,1952
Leonid Gissen,Soviet Union,0,1,0,1,1952
Igor Yemchuk,Ukraine,0,1,0,1,1952
Aleksey Komarov,Soviet Union,0,1,0,1,1952
Vladimir Kryukov,Soviet Union,0,1,0,1,1952
Igor Polyakov,Soviet Union,0,1,0,1,1952
Vladimir Rodimushkin,Soviet Union,0,1,0,1,1952
Yevgeny Samsonov,Soviet Union,0,1,0,1,1952
Georgy Zhilin,Ukraine,0,1,0,1,1952
Veljko Bakašun,Yugoslavia,0,1,0,1,1952
Marko Brajnović,Yugoslavia,0,1,0,1,1952
Vladimir Ivković,Yugoslavia,0,1,0,1,1952
Zdravko Ježić,Yugoslavia,0,1,0,1,1952
Zdravko-Ćiro Kovačić,Yugoslavia,0,1,0,1,1952
Ivo Kurtini,Yugoslavia,0,1,0,1,1952
Lovro Radonić,Yugoslavia,0,1,0,1,1952
Ivo Štakula,Yugoslavia,0,1,0,1,1952
Boško Vuksanović,Yugoslavia,0,1,0,1,1952
Yevgeny Lopatin,Soviet Union,0,1,0,1,1952
Grigory Novak,Soviet Union,0,1,0,1,1952
Nikolay Saksonov,Soviet Union,0,1,0,1,1952
Josef Růžička,Czechoslovakia,0,1,0,1,1952
Rəşid Məmmədbəyov,Soviet Union,0,1,0,1,1952
Shalva Chikhladze,Soviet Union,0,1,0,1,1952
Helga Klein,West Germany,0,1,0,1,1952
Ursula Knab,West Germany,0,1,0,1,1952
Marga Petersen,West Germany,0,1,0,1,1952
Marianne Werner,West Germany,0,1,0,1,1952
Karl Storch,West Germany,0,1,0,1,1952
Josef Doležal,Czechoslovakia,0,1,0,1,1952
Yelizaveta Bagryantseva,Soviet Union,0,1,0,1,1952
Mariya Golubnichaya,Soviet Union,0,1,0,1,1952
Lev Kalyayev,Soviet Union,0,1,0,1,1952
Vladimir Kazantsev,Soviet Union,0,1,0,1,1952
Yury Lituyev,Soviet Union,0,1,0,1,1952
Levan Sanadze,Soviet Union,0,1,0,1,1952
Leonid Shcherbakov,Soviet Union,0,1,0,1,1952
Vladimir Sukharev,Soviet Union,0,1,0,1,1952
Boris Tokarev,Soviet Union,0,1,0,1,1952
Egon Drews,West Germany,0,0,2,2,1952
Wilfried Soltau,West Germany,0,0,2,2,1952
Fritz Thiedemann,West Germany,0,0,2,2,1952
Heinz Ulzheimer,West Germany,0,0,2,2,1952
Günther Heidemann,West Germany,0,0,1,1,1952
Anatoly Bulakov,Soviet Union,0,0,1,1,1952
Gennady Garbuzov,Soviet Union,0,0,1,1,1952
Anatoly Perov,Soviet Union,0,0,1,1,1952
Boris Tishin,Soviet Union,0,0,1,1,1952
Michel Scheuer,West Germany,0,0,1,1,1952
Alfréd Jindra,Czechoslovakia,0,0,1,1,1952
Nina Savina,Soviet Union,0,0,1,1,1952
Ida von Nagel,West Germany,0,0,1,1,1952
Heinz Pollay,West Germany,0,0,1,1,1952
Werner Potzernheim,West Germany,0,0,1,1,1952
Edi Ziegler,West Germany,0,0,1,1,1952
Hana Bobková,Czechoslovakia,0,0,1,1,1952
Alena Chadimová,Czechoslovakia,0,0,1,1,1952
Jana Rabasová,Czechoslovakia,0,0,1,1,1952
Alena Reichová,Czechoslovakia,0,0,1,1,1952
Matylda Matoušková-Šínová,Czechoslovakia,0,0,1,1,1952
Božena Srncová,Czechoslovakia,0,0,1,1,1952
Věra Vančurová,Czechoslovakia,0,0,1,1,1952
Eva Bosáková-Věchtová,Czechoslovakia,0,0,1,1,1952
Lev Vaynshteyn,Soviet Union,0,0,1,1,1952
Günther Haase,West Germany,0,0,1,1,1952
Herbert Klein,West Germany,0,0,1,1,1952
Arkady Vorobyov,Soviet Union,0,0,1,1,1952
Mikuláš Athanasov,Slovakia,0,0,1,1,1952
Nikolay Belov,Soviet Union,0,0,1,1,1952
Artyom Teryan,Soviet Union,0,0,1,1,1952
Erich Natusch,West Germany,0,0,1,1,1952
Georg Nowka,West Germany,0,0,1,1,1952
Theodor Thomsen,West Germany,0,0,1,1,1952
Hans Geister,West Germany,0,0,1,1,1952
Karl-Friedrich Haas,West Germany,0,0,1,1,1952
Werner Lueg,West Germany,0,0,1,1,1952
Herbert Schade,West Germany,0,0,1,1,1952
Günther Steines,West Germany,0,0,1,1,1952
Nino Dumbadze,Soviet Union,0,0,1,1,1952
Yelena Gorchakova,Soviet Union,0,0,1,1,1952
Nadezhda Khnik'ina-Dvalishvili,Soviet Union,0,0,1,1,1952
Klavdiya Tochonova,Soviet Union,0,0,1,1,1952
Aleksandr Anufriyev,Soviet Union,0,0,1,1,1952
Bruno Junk,Soviet Union,0,0,1,1,1952
Larisa Latynina,Ukraine,4,1,1,6,1956
Viktor Chukarin,Ukraine,3,1,1,5,1956
Valentin Muratov,Soviet Union,3,1,0,4,1956
Albert Azaryan,Soviet Union,2,0,0,2,1956
Boris Shakhlin,Ukraine,2,0,0,2,1956
Vladimir Kuts,Ukraine,2,0,0,2,1956
Tamara Manina,Soviet Union,1,2,1,4,1956
Yury Titov,Soviet Union,1,1,2,4,1956
Gratsian Botev,Soviet Union,1,1,0,2,1956
Pavel Kharin,Soviet Union,1,1,0,2,1956
Vasily Borisov,Soviet Union,1,1,0,2,1956
Sofya Muratova,Soviet Union,1,0,3,4,1956
Michel Scheuer,West Germany,1,0,1,2,1956
Polina Astakhova,Ukraine,1,0,1,2,1956
Lyudmila Yegorova,Soviet Union,1,0,1,2,1956
Lidiya Kalinina-Ivanova,Soviet Union,1,0,1,2,1956
Wolfgang Behrendt,Germany,1,0,0,1,1956
Vladimir Engibaryan,Soviet Union,1,0,0,1,1956
Vladimir Safronov,Soviet Union,1,0,0,1,1956
Gennady Shatkov,Soviet Union,1,0,0,1,1956
Meinrad Miltenberger,West Germany,1,0,0,1,1956
Yelizaveta Dementyeva,Soviet Union,1,0,0,1,1956
Randhir Singh Gentle,Uganda,1,0,0,1,1956
Gene Hámori,United States,1,0,0,1,1956
Attila Keresztes,United States,1,0,0,1,1956
Anatoly Bashashkin,Soviet Union,1,0,0,1,1956
Yozhef Betsa,Ukraine,1,0,0,1,1956
Anatoly Ilyin,Soviet Union,1,0,0,1,1956
Anatoly Isayev,Soviet Union,1,0,0,1,1956
Valentin Ivanov,Soviet Union,1,0,0,1,1956
Lev Yashin,Soviet Union,1,0,0,1,1956
Boris Kuznetsov,Soviet Union,1,0,0,1,1956
Anatoly Maslyonkin,Soviet Union,1,0,0,1,1956
Igor Netto,Soviet Union,1,0,0,1,1956
Mikhail Ogonkov,Soviet Union,1,0,0,1,1956
Aleksey Paramonov,Soviet Union,1,0,0,1,1956
Boris Razinsky,Soviet Union,1,0,0,1,1956
Vladimir Ryzhkin,Soviet Union,1,0,0,1,1956
Sergey Salnikov,Soviet Union,1,0,0,1,1956
Nikita Simonyan,Russian Federation,1,0,0,1,1956
Eduard Streltsov,Soviet Union,1,0,0,1,1956
Boris Tatushin,Soviet Union,1,0,0,1,1956
Nikolay Tishchenko,Soviet Union,1,0,0,1,1956
Helmut Bantz,West Germany,1,0,0,1,1956
Pavel Stolbov,Soviet Union,1,0,0,1,1956
Ivan Deryugin,Ukraine,1,0,0,1,1956
Igor Novikov,Soviet Union,1,0,0,1,1956
Aleksandr Tarasov,Soviet Union,1,0,0,1,1956
Aleksandr Berkutov,Soviet Union,1,0,0,1,1956
Vyacheslav Ivanov,Soviet Union,1,0,0,1,1956
Yury Tyukalov,Soviet Union,1,0,0,1,1956
Anatoly Bogdanov,Soviet Union,1,0,0,1,1956
Vitaly Romanenko,Ukraine,1,0,0,1,1956
Ursula Happe,West Germany,1,0,0,1,1956
Fyodor Bogdanovsky,Soviet Union,1,0,0,1,1956
Igor Rybak,Ukraine,1,0,0,1,1956
Arkady Vorobyov,Soviet Union,1,0,0,1,1956
Givi K'art'ozia,Soviet Union,1,0,0,1,1956
Valentin Nikolayev,Soviet Union,1,0,0,1,1956
Anatoly Parfyonov,Soviet Union,1,0,0,1,1956
Nikolay Solovyov,Soviet Union,1,0,0,1,1956
Mirian Tsalkalamanidze,Soviet Union,1,0,0,1,1956
Konstantin Vyrupayev,Soviet Union,1,0,0,1,1956
Alain Mimoun,France,1,0,0,1,1956
Inese Jaunzeme,Soviet Union,1,0,0,1,1956
Tamara Tyshkevich,Soviet Union,1,0,0,1,1956
Leonid Spirin,Soviet Union,1,0,0,1,1956
Olga Fikotová-Connolly,Czechoslovakia,1,0,0,1,1956
Ladislav Fouček,Czechoslovakia,0,2,0,2,1956
Christa Stubnick,Germany,0,2,0,2,1956
Harry Kurschat,West Germany,0,1,0,1,1956
Arkady Bochkaryov,Soviet Union,0,1,0,1,1956
Jānis Krūmiņš,Soviet Union,0,1,0,1,1956
Algirdas Lauritėnas,Soviet Union,0,1,0,1,1956
Valdis Muižnieks,Soviet Union,0,1,0,1,1956
Yury Ozerov,Soviet Union,0,1,0,1,1956
Kazys Petkevičius,Soviet Union,0,1,0,1,1956
Mikhail Semyonov,Soviet Union,0,1,0,1,1956
Stasys Stonkus,Soviet Union,0,1,0,1,1956
Mikhail Studenetsky,Soviet Union,0,1,0,1,1956
Vladimir Torban,Soviet Union,0,1,0,1,1956
Maigonis Valdmanis,Soviet Union,0,1,0,1,1956
Viktor Zubkov,Soviet Union,0,1,0,1,1956
Lev Mukhin,Soviet Union,0,1,0,1,1956
Therese Zenz,Saar,0,1,0,1,1956
Fritz Briel,West Germany,0,1,0,1,1956
Theo Kleine,West Germany,0,1,0,1,1956
Anatoly Demitkov,Soviet Union,0,1,0,1,1956
Mihhail Kaaleste,Soviet Union,0,1,0,1,1956
Igor Pisarev,Soviet Union,0,1,0,1,1956
Václav Machek,Czechoslovakia,0,1,0,1,1956
Akhtar Hussain,Pakistan,0,1,0,1,1956
Latif-ur Rehman,Pakistan,0,1,0,1,1956
Sava Antić,Yugoslavia,0,1,0,1,1956
Ibrahim Biogradlić,Yugoslavia,0,1,0,1,1956
Mladen Koščak,Yugoslavia,0,1,0,1,1956
Dobrosav Krstić,Yugoslavia,0,1,0,1,1956
Luka Lipošinović,Yugoslavia,0,1,0,1,1956
Muhamed Mujić,Yugoslavia,0,1,0,1,1956
Zlatko Papec,Yugoslavia,0,1,0,1,1956
Petar Radenković,Yugoslavia,0,1,0,1,1956
Nikola Radović,Yugoslavia,0,1,0,1,1956
Ivan Šantek,Yugoslavia,0,1,0,1,1956
Dragoslav Šekularac,Yugoslavia,0,1,0,1,1956
Ljubiša Spajić,Yugoslavia,0,1,0,1,1956
Todor Veselinović,Serbia,0,1,0,1,1956
Blagoja Vidinić,Yugoslavia,0,1,0,1,1956
Eva Bosáková-Věchtová,Czechoslovakia,0,1,0,1,1956
Horst Arndt,West Germany,0,1,0,1,1956
Rainer Borkowsky,West Germany,0,1,0,1,1956
Moritz von Groddeck,West Germany,0,1,0,1,1956
Igor Buldakov,Soviet Union,0,1,0,1,1956
Viktor Ivanov,Soviet Union,0,1,0,1,1956
Otakar Hořínek,Czechoslovakia,0,1,0,1,1956
Allan Erdman,Soviet Union,0,1,0,1,1956
Yevgeny Cherkasov,Soviet Union,0,1,0,1,1956
Makhmud Umarov,Soviet Union,0,1,0,1,1956
Ivo Cipci,Yugoslavia,0,1,0,1,1956
Tomislav Franjković,Yugoslavia,0,1,0,1,1956
Vladimir Ivković,Yugoslavia,0,1,0,1,1956
Zdravko Ježić,Yugoslavia,0,1,0,1,1956
Hrvoje Kačić,Yugoslavia,0,1,0,1,1956
Zdravko-Ćiro Kovačić,Yugoslavia,0,1,0,1,1956
Lovro Radonić,Yugoslavia,0,1,0,1,1956
Marijan Žužej,Yugoslavia,0,1,0,1,1956
Ravil Khabutdinov,Soviet Union,0,1,0,1,1956
Yevgeny Minayev,Soviet Union,0,1,0,1,1956
Vasīlijs Stepanovs,Soviet Union,0,1,0,1,1956
Vladimir Stogov,Soviet Union,0,1,0,1,1956
Wilfried Dietrich,West Germany,0,1,0,1,1956
Boris Kulayev,Soviet Union,0,1,0,1,1956
Vladimir Maneyev,Soviet Union,0,1,0,1,1956
Gisela Köhler-Birkemeyer,Germany,0,1,0,1,1956
Klaus Richtzenhain,Germany,0,1,0,1,1956
Karl-Friedrich Haas,West Germany,0,1,0,1,1956
Irina Beglyakova,Soviet Union,0,1,0,1,1956
Mariya Pisareva,Soviet Union,0,1,0,1,1956
Galina Zybina,Soviet Union,0,1,0,1,1956
Leonid Bartenev,Ukraine,0,1,0,1,1956
Yury Konovalov,Soviet Union,0,1,0,1,1956
Mikhail Krivonosov,Soviet Union,0,1,0,1,1956
Yevgeny Maskinskov,Soviet Union,0,1,0,1,1956
Antanas Mikėnas,Soviet Union,0,1,0,1,1956
Vladimir Sukharev,Soviet Union,0,1,0,1,1956
Boris Tokarev,Soviet Union,0,1,0,1,1956
Franjo Mihalić,Yugoslavia,0,1,0,1,1956
Gennady Bukharin,Soviet Union,0,0,2,2,1956
Lev Kuznetsov,Soviet Union,0,0,2,2,1956
Anatoly Lagetko,Soviet Union,0,0,1,1,1956
Romualdas Murauskas,Soviet Union,0,0,1,1,1956
Erich Hagen,Germany,0,0,1,1,1956
Reinhold Pommer,West Germany,0,0,1,1,1956
Gustav-Adolf Schur,Germany,0,0,1,1,1956
Horst Tüller,Germany,0,0,1,1,1956
Günther Brennecke,West Germany,0,0,1,1,1956
Hugo Budinger,West Germany,0,0,1,1,1956
Werner Delmes,West Germany,0,0,1,1,1956
Hugo Dollheiser,West Germany,0,0,1,1,1956
Eberhard Ferstl,West Germany,0,0,1,1,1956
Alfred Lücker,West Germany,0,0,1,1,1956
Helmut Nonn,West Germany,0,0,1,1,1956
Wolfgang Nonn,West Germany,0,0,1,1,1956
Heinz Radzikowski,West Germany,0,0,1,1,1956
Werner Rosenbaum,West Germany,0,0,1,1,1956
Günther Ullerich,West Germany,0,0,1,1,1956
Leonid Bogdanov,Soviet Union,0,0,1,1,1956
Yakov Rylsky,Soviet Union,0,0,1,1,1956
Yevgeny Cherepovsky,Ukraine,0,0,1,1,1956
David Tyshler,Ukraine,0,0,1,1,1956
Igor Yemchuk,Ukraine,0,0,1,1,1956
Vladimir Petrov,Soviet Union,0,0,1,1,1956
Georgy Zhilin,Ukraine,0,0,1,1,1956
Vladimir Sevryugin,Soviet Union,0,0,1,1,1956
Eva-Maria ten Elsen,Germany,0,0,1,1,1956
Kharis Yunichev,Soviet Union,0,0,1,1,1956
Boris Nik'it'ini,Soviet Union,0,0,1,1,1956
Gennady Nikolayev,Turkmenistan,0,0,1,1,1956
Vitaly Sorokin,Soviet Union,0,0,1,1,1956
Vladimir Struzhanov,Soviet Union,0,0,1,1,1956
Viktor Ageyev,Soviet Union,0,0,1,1,1956
Pyotr Breus,Soviet Union,0,0,1,1,1956
Boris Goykhman,Soviet Union,0,0,1,1,1956
Nodar Gvakharia,Soviet Union,0,0,1,1,1956
Vyacheslav Kurennoy,Soviet Union,0,0,1,1,1956
Boris Markarov,Soviet Union,0,0,1,1,1956
P'et're Mshvenieradze,Soviet Union,0,0,1,1,1956
Valentin Prokopov,Soviet Union,0,0,1,1,1956
Mikhail Ryzhak,Soviet Union,0,0,1,1,1956
Yury Shlyapin,Soviet Union,0,0,1,1,1956
Vakht'ang Balavadze,Soviet Union,0,0,1,1,1956
Alimbeg Bestayev,Soviet Union,0,0,1,1,1956
Roman Dzeneladze,Soviet Union,0,0,1,1,1956
Mikhail Shakhov,Ukraine,0,0,1,1,1956
Giorgi Skhirt'ladze,Soviet Union,0,0,1,1,1956
Sloane Farrington,The Bahamas,0,0,1,1,1956
Durward Knowles,The Bahamas,0,0,1,1,1956
Marianne Werner,West Germany,0,0,1,1,1956
Heinz Fütterer,West Germany,0,0,1,1,1956
Manfred Germar,West Germany,0,0,1,1,1956
Lothar Knörzer,West Germany,0,0,1,1,1956
Leo Pohl,West Germany,0,0,1,1,1956
Jiří Skobla,Czechoslovakia,0,0,1,1,1956
Nadezhda Khnik'ina-Dvalishvili,Soviet Union,0,0,1,1,1956
Nadezhda Konyayeva,Soviet Union,0,0,1,1,1956
Nina Romashkova-Ponomaryova,Soviet Union,0,0,1,1,1956
Ardalion Ignatyev,Soviet Union,0,0,1,1,1956
Bruno Junk,Soviet Union,0,0,1,1,1956
Igor Kashkarov,Soviet Union,0,0,1,1,1956
Vitold Kreyer,Soviet Union,0,0,1,1,1956
Vasily Kuznetsov,Soviet Union,0,0,1,1,1956
Anatoly Samotsvetov,Soviet Union,0,0,1,1,1956
Viktor Tsybulenko,Ukraine,0,0,1,1,1956
Boris Shakhlin,Ukraine,4,2,1,7,1960
Larisa Latynina,Ukraine,3,2,1,6,1960
Polina Astakhova,Ukraine,2,1,1,4,1960
Antonina Seredina,Soviet Union,2,0,0,2,1960
Viktor Zhdanovich,Soviet Union,2,0,0,2,1960
Margarita Nikolayeva,Ukraine,2,0,0,2,1960
Ingrid Gulbin-Engel-Krämer,Germany,2,0,0,2,1960
Armin Hary,West Germany,2,0,0,2,1960
Sofya Muratova,Soviet Union,1,2,1,4,1960
Valentina Rastvorova,Ukraine,1,1,0,2,1960
Yury Sisikin,Soviet Union,1,1,0,2,1960
Eva Bosáková-Věchtová,Czechoslovakia,1,1,0,2,1960
Albert Azaryan,Soviet Union,1,1,0,2,1960
Wilfried Dietrich,West Germany,1,1,0,2,1960
Tamara Press,Soviet Union,1,1,0,2,1960
Tamara Lyukhina-Zamotaylova,Soviet Union,1,0,2,3,1960
Viktor Kapitonov,Soviet Union,1,0,1,2,1960
Les Lane,United States,1,0,0,1,1960
Bohumil Němeček,Czechoslovakia,1,0,0,1,1960
Oleg Grigoryev,Soviet Union,1,0,0,1,1960
Dieter Krause,Germany,1,0,0,1,1960
Paul Lange,West Germany,1,0,0,1,1960
Friedhelm Wentzke,West Germany,1,0,0,1,1960
Mariya Shubina,Soviet Union,1,0,0,1,1960
Leonid Geyshtor,Soviet Union,1,0,0,1,1960
Sergey Makarenko,Ukraine,1,0,0,1,1960
Sergey Filatov,Soviet Union,1,0,0,1,1960
Alwin Schockemöhle,West Germany,1,0,0,1,1960
Fritz Thiedemann,West Germany,1,0,0,1,1960
Hans Günter Winkler,West Germany,1,0,0,1,1960
Heidi Schmid,West Germany,1,0,0,1,1960
Galina Gorokhova,Soviet Union,1,0,0,1,1960
Tatyana Petrenko-Samusenko,Soviet Union,1,0,0,1,1960
Valentina Prudskova,Soviet Union,1,0,0,1,1960
Lyudmila Shishova,Soviet Union,1,0,0,1,1960
Aleksandra Zabelina,Soviet Union,1,0,0,1,1960
Mark Midler,Soviet Union,1,0,0,1,1960
Yury Rudov,Soviet Union,1,0,0,1,1960
German Sveshnikov,Soviet Union,1,0,0,1,1960
Andrija Anković,Yugoslavia,1,0,0,1,1960
Vladimir Durković,Yugoslavia,1,0,0,1,1960
Fahrudin Jusufi,Yugoslavia,1,0,0,1,1960
Bora Kostić,Yugoslavia,1,0,0,1,1960
Dušan Maravić,Yugoslavia,1,0,0,1,1960
Željko Matuš,Yugoslavia,1,0,0,1,1960
Željko Perušić,Yugoslavia,1,0,0,1,1960
Novak Roganović,Yugoslavia,1,0,0,1,1960
Milutin Šoškić,Yugoslavia,1,0,0,1,1960
Silvester Takač,Yugoslavia,1,0,0,1,1960
Blagoja Vidinić,Yugoslavia,1,0,0,1,1960
Ante Žanetić,Yugoslavia,1,0,0,1,1960
Lidiya Kalinina-Ivanova,Soviet Union,1,0,0,1,1960
Klaus Bittner,West Germany,1,0,0,1,1960
Gerd Cintl,West Germany,1,0,0,1,1960
Horst Effertz,West Germany,1,0,0,1,1960
Karl-Heinz Hopp,West Germany,1,0,0,1,1960
Bernhard Knubel,West Germany,1,0,0,1,1960
Hans Lenk,West Germany,1,0,0,1,1960
Jürgen Litz,West Germany,1,0,0,1,1960
Michael Obst,West Germany,1,0,0,1,1960
Willi Padge,West Germany,1,0,0,1,1960
Heinz Renneberg,West Germany,1,0,0,1,1960
Klaus Riekemann,West Germany,1,0,0,1,1960
Manfred Rulffs,West Germany,1,0,0,1,1960
Frank Schepke,West Germany,1,0,0,1,1960
Kraft Schepke,West Germany,1,0,0,1,1960
Walter Schröder,West Germany,1,0,0,1,1960
Moritz von Groddeck,West Germany,1,0,0,1,1960
Klaus Zerta,West Germany,1,0,0,1,1960
Václav Kozák,Czechoslovakia,1,0,0,1,1960
Pavel Schmidt,Slovakia,1,0,0,1,1960
Valentin Boreyko,Soviet Union,1,0,0,1,1960
Oleg Golovanov,Soviet Union,1,0,0,1,1960
Vyacheslav Ivanov,Soviet Union,1,0,0,1,1960
Peter Kohnke,West Germany,1,0,0,1,1960
Aleksey Gushchin,Soviet Union,1,0,0,1,1960
Viktor Shamburkin,Soviet Union,1,0,0,1,1960
Viktor Bushuyev,Soviet Union,1,0,0,1,1960
Aleksandr Kurynov,Soviet Union,1,0,0,1,1960
Yevgeny Minayev,Soviet Union,1,0,0,1,1960
Yury Vlasov,Soviet Union,1,0,0,1,1960
Arkady Vorobyov,Soviet Union,1,0,0,1,1960
Ivan Bogdan,Ukraine,1,0,0,1,1960
Oleg Karavayev,Soviet Union,1,0,0,1,1960
Avtandil Koridze,Soviet Union,1,0,0,1,1960
Timir Pinegin,Soviet Union,1,0,0,1,1960
Fyodor Shutkov,Soviet Union,1,0,0,1,1960
Bernd Cullmann,West Germany,1,0,0,1,1960
Martin Lauer,West Germany,1,0,0,1,1960
Walter Mahlendorf,West Germany,1,0,0,1,1960
Vera Kalashnikova-Krepkina,Ukraine,1,0,0,1,1960
Lyudmila Lysenko,Ukraine,1,0,0,1,1960
Elvīra Ozoliņa,Soviet Union,1,0,0,1,1960
Irina Press,Soviet Union,1,0,0,1,1960
Nina Romashkova-Ponomaryova,Soviet Union,1,0,0,1,1960
Pyotr Bolotnikov,Soviet Union,1,0,0,1,1960
Vladimir Golubnichy,Ukraine,1,0,0,1,1960
Vasily Rudenkov,Soviet Union,1,0,0,1,1960
Robert' Shavlaq'adze,Soviet Union,1,0,0,1,1960
Viktor Tsybulenko,Ukraine,1,0,0,1,1960
Yury Titov,Soviet Union,0,2,1,3,1960
Therese Zenz,Saar,0,2,0,2,1960
Hans Grodotzki,Germany,0,2,0,2,1960
Jutta Heine,West Germany,0,2,0,2,1960
Carl Kaufmann,West Germany,0,2,0,2,1960
Vladimir Portnoy,Soviet Union,0,1,1,2,1960
Yury Korneyev,Soviet Union,0,1,0,1,1960
Jānis Krūmiņš,Soviet Union,0,1,0,1,1960
Guram Minashvili,Soviet Union,0,1,0,1,1960
Valdis Muižnieks,Soviet Union,0,1,0,1,1960
Cēzars Ozers,Soviet Union,0,1,0,1,1960
Aleksandr Petrov,Soviet Union,0,1,0,1,1960
Mikhail Semyonov,Soviet Union,0,1,0,1,1960
Vladimer Ugrekhelidze,Soviet Union,0,1,0,1,1960
Maigonis Valdmanis,Soviet Union,0,1,0,1,1960
Albert Valtin,Ukraine,0,1,0,1,1960
Gennady Volnov,Soviet Union,0,1,0,1,1960
Viktor Zubkov,Soviet Union,0,1,0,1,1960
Yury Radonyak,Soviet Union,0,1,0,1,1960
Sergey Sivko,Soviet Union,0,1,0,1,1960
Ingrid Hartmann,West Germany,0,1,0,1,1960
Aleksandr Silayev,Soviet Union,0,1,0,1,1960
Egon Adler,Germany,0,1,0,1,1960
Bernd Barleben,Germany,0,1,0,1,1960
Dieter Gieseler,West Germany,0,1,0,1,1960
Peter Gröning,Germany,0,1,0,1,1960
Erich Hagen,Germany,0,1,0,1,1960
Manfred Klieme,Germany,0,1,0,1,1960
Siegfried Köhler,Germany,0,1,0,1,1960
Günter Lörke,Germany,0,1,0,1,1960
Gustav-Adolf Schur,Germany,0,1,0,1,1960
Jürgen Simon,Germany,0,1,0,1,1960
Lothar Stäber,Germany,0,1,0,1,1960
Hana Růžičková,Czechoslovakia,0,1,0,1,1960
Věra Čáslavská,Czechoslovakia,0,1,0,1,1960
Matylda Matoušková-Šínová,Czechoslovakia,0,1,0,1,1960
Ludmila Švédová,Czechoslovakia,0,1,0,1,1960
Adolfína Tkačíková-Tačová,Czechoslovakia,0,1,0,1,1960
Valery Kerdemelidi,Soviet Union,0,1,0,1,1960
Nikolay Miligulo,Soviet Union,0,1,0,1,1960
Igor Novikov,Soviet Union,0,1,0,1,1960
Hanno Selg,Soviet Union,0,1,0,1,1960
Nikolay Tatarinov,Soviet Union,0,1,0,1,1960
Achim Hill,Germany,0,1,0,1,1960
Aleksandr Berkutov,Soviet Union,0,1,0,1,1960
Antanas Bagdonavičius,Soviet Union,0,1,0,1,1960
Zigmas Jukna,Soviet Union,0,1,0,1,1960
Igor Rudakov,Soviet Union,0,1,0,1,1960
Yury Tyukalov,Soviet Union,0,1,0,1,1960
Marat Niyazov,Turkmenistan,0,1,0,1,1960
Makhmud Umarov,Soviet Union,0,1,0,1,1960
Wiltrud Urselmann,West Germany,0,1,0,1,1960
Viktor Ageyev,Soviet Union,0,1,0,1,1960
Leri Gogoladze,Soviet Union,0,1,0,1,1960
Boris Goykhman,Soviet Union,0,1,0,1,1960
Yury Grigorovsky,Soviet Union,0,1,0,1,1960
Anatoly Kartashov,Soviet Union,0,1,0,1,1960
Vyacheslav Kurennoy,Soviet Union,0,1,0,1,1960
P'et're Mshvenieradze,Soviet Union,0,1,0,1,1960
Vladimir Novikov,Soviet Union,0,1,0,1,1960
Yevgeny Saltsyn,Soviet Union,0,1,0,1,1960
Vladimir Semyonov,Soviet Union,0,1,0,1,1960
Givi Chikvanaia,Soviet Union,0,1,0,1,1960
Tiger Tan,Singapore,0,1,0,1,1960
Trofim Lomakin,Soviet Union,0,1,0,1,1960
Lothar Metz,Germany,0,1,0,1,1960
Günter Maritschnigg,West Germany,0,1,0,1,1960
Vladimir Sinyavsky,Ukraine,0,1,0,1,1960
Giorgi Skhirt'ladze,Soviet Union,0,1,0,1,1960
Branko Martinović,Yugoslavia,0,1,0,1,1960
Hans Fogh,Denmark,0,1,0,1,1960
Aleksander Tšutšelov,Soviet Union,0,1,0,1,1960
Johanna Hübner-Lüttge,Germany,0,1,0,1,1960
Walter Krüger,Germany,0,1,0,1,1960
Anni Biechl,West Germany,0,1,0,1,1960
Brunhilde Hendrix,West Germany,0,1,0,1,1960
Martha Langbein-Pensberger,West Germany,0,1,0,1,1960
Jo Kaiser,West Germany,0,1,0,1,1960
Manfred Kinder,West Germany,0,1,0,1,1960
Jochen Reske,West Germany,0,1,0,1,1960
Dana Ingrová-Zátopková,Czechoslovakia,0,1,0,1,1960
Leonid Bartenev,Ukraine,0,1,0,1,1960
Valery Brumel,Soviet Union,0,1,0,1,1960
Vladimir Goryayev,Soviet Union,0,1,0,1,1960
Yury Konovalov,Soviet Union,0,1,0,1,1960
Gusman Kosanov,Soviet Union,0,1,0,1,1960
Edvin Ozolin,Soviet Union,0,1,0,1,1960
Nikolay Sokolov,Soviet Union,0,1,0,1,1960
Bruno Habārovs,Soviet Union,0,0,2,2,1960
Ursel Brunner,West Germany,0,0,2,2,1960
George Kerr,West Indies Federation,0,0,2,2,1960
Günter Siegmund,Germany,0,0,1,1,1960
Josef Němec,Czechoslovakia,0,0,1,1,1960
Yevgeny Feofanov,Soviet Union,0,0,1,1,1960
Boris Lagutin,Soviet Union,0,0,1,1,1960
András Törő,United States,0,0,1,1,1960
Josef Neckermann,West Germany,0,0,1,1,1960
Arnold Belgardt,Soviet Union,0,0,1,1,1960
Yevgeny Klevtsov,Soviet Union,0,0,1,1,1960
Leonid Kolumbet,Ukraine,0,0,1,1,1960
Vladimir Leonov,Soviet Union,0,0,1,1,1960
Yury Melikhov,Soviet Union,0,0,1,1,1960
Stanislav Moskvin,Soviet Union,0,0,1,1,1960
Aleksey Petrov,Soviet Union,0,0,1,1,1960
Viktor Romanov,Soviet Union,0,0,1,1,1960
Rostislav Vargashkin,Soviet Union,0,0,1,1,1960
Boris Vasilyev,Soviet Union,0,0,1,1,1960
Jürgen Brecht,West Germany,0,0,1,1,1960
Tim Gerresheim,West Germany,0,0,1,1,1960
Eberhard Mehl,West Germany,0,0,1,1,1960
Jürgen Theuerkauff,West Germany,0,0,1,1,1960
Guram Kostava,Soviet Union,0,0,1,1,1960
Aleksandr Pavlovsky,Soviet Union,0,0,1,1,1960
Valentin Chernikov,Soviet Union,0,0,1,1,1960
Arnold Chernushevich,Soviet Union,0,0,1,1,1960
Bohumil Janoušek,Czechoslovakia,0,0,1,1,1960
Jan Jindra,Czechoslovakia,0,0,1,1,1960
Miroslav Koníček,Czechoslovakia,0,0,1,1,1960
Jiří Lundák,Czechoslovakia,0,0,1,1,1960
Stanislav Lusk,Czechoslovakia,0,0,1,1,1960
Václav Pafkovič,Czechoslovakia,0,0,1,1,1960
Luděk Pojezný,Czechoslovakia,0,0,1,1,1960
Jan Švéda,Czechoslovakia,0,0,1,1,1960
Josef Věntus,Czechoslovakia,0,0,1,1,1960
Igor Akhremchik,Soviet Union,0,0,1,1,1960
Yury Bachurov,Soviet Union,0,0,1,1,1960
Valentin Morkovkin,Soviet Union,0,0,1,1,1960
Anatoly Tarabrin,Soviet Union,0,0,1,1,1960
Klaus Zähringer,West Germany,0,0,1,1,1960
Vasily Borisov,Soviet Union,0,0,1,1,1960
Sergey Kalinin,Soviet Union,0,0,1,1,1960
Aleksandr Zabelin,Soviet Union,0,0,1,1,1960
Bärbel Fuhrmann,Germany,0,0,1,1,1960
Barbara Göbel,Germany,0,0,1,1,1960
Ursula Küper,Germany,0,0,1,1,1960
Heidi Pechstein,Germany,0,0,1,1,1960
Ingrid Schmidt,Germany,0,0,1,1,1960
Christel Steffin,Germany,0,0,1,1,1960
Gisela Weiß,Germany,0,0,1,1,1960
Ninel Krutova,Soviet Union,0,0,1,1,1960
Bohumil Kubát,Czechoslovakia,0,0,1,1,1960
Anatoly Albul,Soviet Union,0,0,1,1,1960
Savkuz Dzarasov,Soviet Union,0,0,1,1,1960
Givi K'art'ozia,Soviet Union,0,0,1,1,1960
Vladimer Rubashvili,Soviet Union,0,0,1,1,1960
Konstantin Vyrupayev,Soviet Union,0,0,1,1,1960
Rolf Mulka,West Germany,0,0,1,1,1960
Ingo von Bredow,West Germany,0,0,1,1,1960
Jim Wedderburn,West Indies Federation,0,0,1,1,1960
Hildrun Laufer-Claus,Germany,0,0,1,1,1960
Ulla Donath,Germany,0,0,1,1,1960
Gisela Köhler-Birkemeyer,Germany,0,0,1,1,1960
Halina Richter-Górecka-Herrmann,West Germany,0,0,1,1,1960
Keith Gardner,West Indies Federation,0,0,1,1,1960
Mal Spence,West Indies Federation,0,0,1,1,1960
Birutė Kalėdienė,Soviet Union,0,0,1,1,1960
Vitold Kreyer,Soviet Union,0,0,1,1,1960
Vasily Kuznetsov,Soviet Union,0,0,1,1,1960
Semyon Rzhishchin,Soviet Union,0,0,1,1,1960
Igor Ter-Ovanesyan,Soviet Union,0,0,1,1,1960
Achim Kadelbach,West Germany,0,0,1,1,1960
Věra Čáslavská,Czechoslovakia,3,1,0,4,1964
Larisa Latynina,Ukraine,2,2,2,6,1964
Polina Astakhova,Ukraine,2,1,1,4,1964
Tamara Press,Soviet Union,2,0,0,2,1964
Boris Shakhlin,Ukraine,1,2,1,4,1964
Harry Boldt,West Germany,1,1,0,2,1964
Hermann Schridde,West Germany,1,1,0,2,1964
Tamara Manina,Soviet Union,1,1,0,2,1964
Igor Novikov,Soviet Union,1,1,0,2,1964
Ingrid Gulbin-Engel-Krämer,Germany,1,1,0,2,1964
Umyar Mavlikhanov,Soviet Union,1,0,1,2,1964
Miroslav Cerar,Yugoslavia,1,0,1,2,1964
Albert Mokeyev,Soviet Union,1,0,1,2,1964
Boris Lagutin,Soviet Union,1,0,0,1,1964
Valery Popenchenko,Soviet Union,1,0,0,1,1964
Stanislav Stepashkin,Soviet Union,1,0,0,1,1964
Jürgen Eschert,Germany,1,0,0,1,1964
Roswitha Esser,West Germany,1,0,0,1,1964
Annemarie Zimmermann,West Germany,1,0,0,1,1964
Lyudmila Khvedosyuk-Pinayeva,Soviet Union,1,0,0,1,1964
Anatoly Grishin,Soviet Union,1,0,0,1,1964
Vyacheslav Ionov,Soviet Union,1,0,0,1,1964
Andrey Khimich,Ukraine,1,0,0,1,1964
Vladimir Morozov,Ukraine,1,0,0,1,1964
Stepan Oshchepkov,Soviet Union,1,0,0,1,1964
Nikolay Chuzhikov,Ukraine,1,0,0,1,1964
Kurt Jarasinski,West Germany,1,0,0,1,1964
Reiner Klimke,West Germany,1,0,0,1,1964
Josef Neckermann,West Germany,1,0,0,1,1964
Hans Günter Winkler,West Germany,1,0,0,1,1964
Lothar Claesges,West Germany,1,0,0,1,1964
Jiří Daler,Czechoslovakia,1,0,0,1,1964
Karl-Heinz Henrichs,West Germany,1,0,0,1,1964
Karl Link,West Germany,1,0,0,1,1964
Ernst Streng,West Germany,1,0,0,1,1964
Nugzar Asatiani,Soviet Union,1,0,0,1,1964
Grigory Kriss,Ukraine,1,0,0,1,1964
Boris Melnikov,Soviet Union,1,0,0,1,1964
Mark Midler,Soviet Union,1,0,0,1,1964
Mark Rakita,Soviet Union,1,0,0,1,1964
Yakov Rylsky,Soviet Union,1,0,0,1,1964
Yury Sisikin,Soviet Union,1,0,0,1,1964
Yury Sharov,Soviet Union,1,0,0,1,1964
Viktor Zhdanovich,Soviet Union,1,0,0,1,1964
German Sveshnikov,Soviet Union,1,0,0,1,1964
Lyudmila Gromova,Soviet Union,1,0,0,1,1964
Tamara Lyukhina-Zamotaylova,Soviet Union,1,0,0,1,1964
Yelena Volchetskaya,Soviet Union,1,0,0,1,1964
Viktor Mineyev,Soviet Union,1,0,0,1,1964
Bernhard Britting,West Germany,1,0,0,1,1964
Egbert Hirschfelder,West Germany,1,0,0,1,1964
Peter Neusel,West Germany,1,0,0,1,1964
Jürgen Oelke,West Germany,1,0,0,1,1964
Joachim Werner,West Germany,1,0,0,1,1964
Boris Dubrovsky,Soviet Union,1,0,0,1,1964
Vyacheslav Ivanov,Soviet Union,1,0,0,1,1964
Oleg Tyurin,Soviet Union,1,0,0,1,1964
Róbert Zimonyi,United States,1,0,0,1,1964
Galina Prozumenshchikova-Stepanova,Ukraine,1,0,0,1,1964
Ivans Bugajenkovs,Soviet Union,1,0,0,1,1964
Nikolay Burobin,Soviet Union,1,0,0,1,1964
Valery Kalachikhin,Soviet Union,1,0,0,1,1964
Vazha K'ach'arava,Soviet Union,1,0,0,1,1964
Vitaly Kovalenko,Soviet Union,1,0,0,1,1964
Georgy Mondzolevsky,Soviet Union,1,0,0,1,1964
Yury Poyarkov,Ukraine,1,0,0,1,1964
Eduard Sibiryakov,Soviet Union,1,0,0,1,1964
Yury Chesnokov,Soviet Union,1,0,0,1,1964
Yury Vengerovsky,Ukraine,1,0,0,1,1964
Dmitry Voskoboynikov,Soviet Union,1,0,0,1,1964
Hans Zdražila,Czechoslovakia,1,0,0,1,1964
Vladimir Golovanov,Soviet Union,1,0,0,1,1964
Rudolf Plyukfelder,Soviet Union,1,0,0,1,1964
Leonid Zhabotinsky,Ukraine,1,0,0,1,1964
Aleksey Vakhonin,Soviet Union,1,0,0,1,1964
Aleksandr Ivanitsky,Soviet Union,1,0,0,1,1964
Anatoly Kolesov,Russian Federation,1,0,0,1,1964
Aliaksandr Miadved,Soviet Union,1,0,0,1,1964
Branislav Simić,Yugoslavia,1,0,0,1,1964
Durward Knowles,The Bahamas,1,0,0,1,1964
Willi Kuhweide,West Germany,1,0,0,1,1964
Karin Richert-Balzer,Germany,1,0,0,1,1964
Halina Richter-Górecka-Herrmann,West Germany,1,0,0,1,1964
Willi Holdorf,West Germany,1,0,0,1,1964
Irina Press,Soviet Union,1,0,0,1,1964
Valery Brumel,Soviet Union,1,0,0,1,1964
Romuald Klim,Soviet Union,1,0,0,1,1964
Viktor Lisitsky,Soviet Union,0,4,0,4,1964
Hans-Joachim Klein,West Germany,0,3,1,4,1964
Frank Wiegand,Germany,0,3,0,3,1964
Yury Titov,Soviet Union,0,2,0,2,1964
Horst-Günter Gregor,Germany,0,2,0,2,1964
Holger Zander,West Germany,0,1,1,2,1964
Helga Volz-Mees,West Germany,0,1,1,2,1964
Yury Tsapenko,Soviet Union,0,1,1,2,1964
Gerhard Hetz,West Germany,0,1,1,2,1964
Hans Huber,West Germany,0,1,0,1,1964
Emil Schulz,West Germany,0,1,0,1,1964
Armenak Alachachyan,Soviet Union,0,1,0,1,1964
Nikolay Bagley,Ukraine,0,1,0,1,1964
Juris Kalniņš,Soviet Union,0,1,0,1,1964
Yury Korneyev,Soviet Union,0,1,0,1,1964
Jānis Krūmiņš,Soviet Union,0,1,0,1,1964
Vyacheslav Khrynin,Soviet Union,0,1,0,1,1964
Jaak Lipso,Soviet Union,0,1,0,1,1964
Levan Moseshvili,Soviet Union,0,1,0,1,1964
Valdis Muižnieks,Soviet Union,0,1,0,1,1964
Aleksandr Petrov,Soviet Union,0,1,0,1,1964
Aleksandr Travin,Soviet Union,0,1,0,1,1964
Gennady Volnov,Soviet Union,0,1,0,1,1964
Vilikton Barannikov,Soviet Union,0,1,0,1,1964
Yevgeny Frolov,Soviet Union,0,1,0,1,1964
Aleksey Kiselyov,Soviet Union,0,1,0,1,1964
Ričardas Tamulis,Soviet Union,0,1,0,1,1964
Paul Hoekstra,Netherlands,0,1,0,1,1964
Berni Schulze,West Germany,0,1,0,1,1964
Friedhelm Wentzke,West Germany,0,1,0,1,1964
Imants Bodnieks,Soviet Union,0,1,0,1,1964
Viktor Logunov,Soviet Union,0,1,0,1,1964
Galina Gorokhova,Soviet Union,0,1,0,1,1964
Tatyana Petrenko-Samusenko,Soviet Union,0,1,0,1,1964
Valentina Prudskova,Soviet Union,0,1,0,1,1964
Valentina Rastvorova,Ukraine,0,1,0,1,1964
Lyudmila Shishova,Soviet Union,0,1,0,1,1964
Jan Brumovský,Slovakia,0,1,0,1,1964
Ľudovít Cvetler,Slovakia,0,1,0,1,1964
Ján Geleta,Slovakia,0,1,0,1,1964
František Knebort,Czechoslovakia,0,1,0,1,1964
Karel Knesl,Czechoslovakia,0,1,0,1,1964
Karel Lichtnégl,Czechoslovakia,0,1,0,1,1964
Vojtech Masný,Slovakia,0,1,0,1,1964
Štefan Matlák,Slovakia,0,1,0,1,1964
Ivan Mráz,Slovakia,0,1,0,1,1964
Karel Nepomucký,Czechoslovakia,0,1,0,1,1964
Zdeněk Pičman,Czechoslovakia,0,1,0,1,1964
František Schmucker,Slovakia,0,1,0,1,1964
Anton Švajlen,Slovakia,0,1,0,1,1964
Anton Urban,Slovakia,0,1,0,1,1964
František Valošek,Czechoslovakia,0,1,0,1,1964
Josef Vojta,Czechoslovakia,0,1,0,1,1964
Vladimír Weiss,Slovakia,0,1,0,1,1964
Birgit Radochla,Germany,0,1,0,1,1964
Hana Růžičková,Czechoslovakia,0,1,0,1,1964
Marianna Némethová-Krajčírová,Slovakia,0,1,0,1,1964
Jána Kubičková-Posnerová,Slovakia,0,1,0,1,1964
Jaroslava Sedláčková,Czechoslovakia,0,1,0,1,1964
Adolfína Tkačíková-Tačová,Czechoslovakia,0,1,0,1,1964
Sergey Diomidov,Uzbekistan,0,1,0,1,1964
Viktor Leontyev,Soviet Union,0,1,0,1,1964
Wolfgang Hofmann,West Germany,0,1,0,1,1964
Achim Hill,Germany,0,1,0,1,1964
Klaus Aeffke,West Germany,0,1,0,1,1964
Thomas Ahrens,West Germany,0,1,0,1,1964
Klaus Behrens,West Germany,0,1,0,1,1964
Klaus Bittner,West Germany,0,1,0,1,1964
Horst Meyer,West Germany,0,1,0,1,1964
Jürgen Plagemann,West Germany,0,1,0,1,1964
Jürgen Schröder,West Germany,0,1,0,1,1964
Moritz von Groddeck,West Germany,0,1,0,1,1964
Hans-Jürgen Wallbrecht,West Germany,0,1,0,1,1964
Shota Kveliashvili,Soviet Union,0,1,0,1,1964
Pāvels Seničevs,Soviet Union,0,1,0,1,1964
Egon Henninger,Germany,0,1,0,1,1964
Uwe Jacobsen,West Germany,0,1,0,1,1964
Ernst-Joachim Küppers,West Germany,0,1,0,1,1964
Horst Löffler,West Germany,0,1,0,1,1964
Georgy Prokopenko,Ukraine,0,1,0,1,1964
Milan Čuda,Czechoslovakia,0,1,0,1,1964
Bohumil Golián,Slovakia,0,1,0,1,1964
Zdeněk Humhal,Czechoslovakia,0,1,0,1,1964
Petr Kop,Czechoslovakia,0,1,0,1,1964
Josef Musil,Czechoslovakia,0,1,0,1,1964
Karel Paulus,Czechoslovakia,0,1,0,1,1964
Boris Perušič,Czechoslovakia,0,1,0,1,1964
Pavel Schenk,Czechoslovakia,0,1,0,1,1964
Václav Šmídl,Czechoslovakia,0,1,0,1,1964
Josef Šorm,Czechoslovakia,0,1,0,1,1964
Ladislav Toman,Czechoslovakia,0,1,0,1,1964
Nelli Abramova,Soviet Union,0,1,0,1,1964
Astra Biltauere,Soviet Union,0,1,0,1,1964
Lyudmila Buldakova,Soviet Union,0,1,0,1,1964
Lyudmila Gureyeva,Ukraine,0,1,0,1,1964
Valentina Kamenyok-Vinogradova,Soviet Union,0,1,0,1,1964
Marita Katusheva,Soviet Union,0,1,0,1,1964
Ninel Lukanina,Soviet Union,0,1,0,1,1964
Valentina Mishak,Ukraine,0,1,0,1,1964
Tatyana Roshchina,Soviet Union,0,1,0,1,1964
Antonina Ryzhova,Soviet Union,0,1,0,1,1964
Inna Ryskal,Soviet Union,0,1,0,1,1964
Tamara Tikhonina,Soviet Union,0,1,0,1,1964
Ozren Bonačić,Yugoslavia,0,1,0,1,1964
Zoran Janković,Yugoslavia,0,1,0,1,1964
Milan Muškatirović,Yugoslavia,0,1,0,1,1964
Ante Nardeli,Yugoslavia,0,1,0,1,1964
Frane Nonković,Yugoslavia,0,1,0,1,1964
Vinko Rosić,Yugoslavia,0,1,0,1,1964
Mirko Sandić,Yugoslavia,0,1,0,1,1964
Zlatko Šimenc,Yugoslavia,0,1,0,1,1964
Božidar Stanišić,Yugoslavia,0,1,0,1,1964
Karlo Stipanić,Yugoslavia,0,1,0,1,1964
Ivo Trumbić,Yugoslavia,0,1,0,1,1964
Vladimir Kaplunov,Soviet Union,0,1,0,1,1964
Viktor Kurentsov,Soviet Union,0,1,0,1,1964
Yury Vlasov,Soviet Union,0,1,0,1,1964
Klaus Rost,West Germany,0,1,0,1,1964
Jiří Kormaník,Czechoslovakia,0,1,0,1,1964
Anatoly Roshchin,Soviet Union,0,1,0,1,1964
Roman Rurua,Soviet Union,0,1,0,1,1964
Guram Sagharadze,Soviet Union,0,1,0,1,1964
Vladlen Trostyansky,Ukraine,0,1,0,1,1964
Peter Ahrendt,Germany,0,1,0,1,1964
Wilfried Lorenz,West Germany,0,1,0,1,1964
Ulrich Mense,Germany,0,1,0,1,1964
Renate Boy-Garisch-Culmberger,Germany,0,1,0,1,1964
Ingrid Lotz,Germany,0,1,0,1,1964
Dieter Lindner,Germany,0,1,0,1,1964
Harald Norpoth,West Germany,0,1,0,1,1964
Wolfgang Reinhardt,West Germany,0,1,0,1,1964
Ludvík Daněk,Czechoslovakia,0,1,0,1,1964
Josef Odložil,Czechoslovakia,0,1,0,1,1964
Rein Aun,Soviet Union,0,1,0,1,1964
Oleg Fedoseyev,Soviet Union,0,1,0,1,1964
Sergey Filatov,Soviet Union,0,0,2,2,1964
Fritz Ligges,West Germany,0,0,2,2,1964
Svetlana Babanina,Uzbekistan,0,0,2,2,1964
Heinz Schulz,Germany,0,0,1,1,1964
Vadim Yemelyanov,Soviet Union,0,0,1,1,1964
Stanislav Sorokin,Soviet Union,0,0,1,1,1964
Heinz Büker,West Germany,0,0,1,1,1964
Yevgeny Penyayev,Soviet Union,0,0,1,1,1964
Karl-Heinz Fuhrmann,Germany,0,0,1,1,1964
Ivan Kalita,Soviet Union,0,0,1,1,1964
Horst Karsten,West Germany,0,0,1,1,1964
Ivan Kizimov,Soviet Union,0,0,1,1,1964
Gerhard Schulz,Germany,0,0,1,1,1964
Willi Fuggerer,West Germany,0,0,1,1,1964
Klaus Kobusch,West Germany,0,0,1,1,1964
Heidi Schmid,West Germany,0,0,1,1,1964
Gundi Theuerkauff,West Germany,0,0,1,1,1964
Romi Weiß-Scherberger,West Germany,0,0,1,1,1964
Guram Kostava,Soviet Union,0,0,1,1,1964
Wolfgang Barthels,Germany,0,0,1,1,1964
Bernd Bauchspieß,Germany,0,0,1,1,1964
Dieter Engelhardt,Germany,0,0,1,1,1964
Henning Frenzel,Germany,0,0,1,1,1964
Otto Fräßdorf,Germany,0,0,1,1,1964
Manfred Geisler,Germany,0,0,1,1,1964
Jürgen Heinsch,Germany,0,0,1,1,1964
Gerhard Körner,Germany,0,0,1,1,1964
Klaus Lisiewicz,Germany,0,0,1,1,1964
Jürgen Nöldner,Germany,0,0,1,1,1964
Herbert Pankau,Germany,0,0,1,1,1964
Peter Rock,Germany,0,0,1,1,1964
Klaus-Dieter Seehaus,Germany,0,0,1,1,1964
Hermann Stöcker,Germany,0,0,1,1,1964
Werner Unger,Germany,0,0,1,1,1964
Klaus Urbanczyk,Germany,0,0,1,1,1964
Eberhard Vogel,Germany,0,0,1,1,1964
Manfred Walter,Germany,0,0,1,1,1964
Horst Weigang,Germany,0,0,1,1,1964
Siegfried Fülle,Germany,0,0,1,1,1964
Erwin Koppe,Germany,0,0,1,1,1964
Klaus Köste,Germany,0,0,1,1,1964
Peter Weber,Germany,0,0,1,1,1964
Philipp Fürst,West Germany,0,0,1,1,1964
Günter Lyhs,West Germany,0,0,1,1,1964
Ārons Boguļubovs,Soviet Union,0,0,1,1,1964
Klaus Glahn,West Germany,0,0,1,1,1964
Anzor K'ik'nadze,Soviet Union,0,0,1,1,1964
Oleg Stepanov,Soviet Union,0,0,1,1,1964
Parnaoz Chik'viladze,Soviet Union,0,0,1,1,1964
Wolfgang Hottenrott,West Germany,0,0,1,1,1964
Michael Schwan,West Germany,0,0,1,1,1964
Vladimír Andrs,Czechoslovakia,0,0,1,1,1964
Petr Čermák,Czechoslovakia,0,0,1,1,1964
Pavel Hofmann,Czechoslovakia,0,0,1,1,1964
Bohumil Janoušek,Czechoslovakia,0,0,1,1,1964
Miroslav Koníček,Czechoslovakia,0,0,1,1,1964
Jiří Lundák,Czechoslovakia,0,0,1,1,1964
Jan Mrvík,Czechoslovakia,0,0,1,1,1964
Richard Nový,Czechoslovakia,0,0,1,1,1964
Luděk Pojezný,Czechoslovakia,0,0,1,1,1964
Július Toček,Slovakia,0,0,1,1,1964
Josef Věntus,Czechoslovakia,0,0,1,1,1964
Lubomír Nácovský,Czechoslovakia,0,0,1,1,1964
Galina Alekseyeva,Soviet Union,0,0,1,1,1964
Tatyana Devyatova,Ukraine,0,0,1,1,1964
Tatyana Savelyeva,Soviet Union,0,0,1,1,1964
Nataliya Ustinova,Uzbekistan,0,0,1,1,1964
Sadatoshi Sugawara,Kenya,0,0,1,1,1964
Viktor Ageyev,Soviet Union,0,0,1,1,1964
Zenon Bortkevich,Soviet Union,0,0,1,1,1964
Igor Grabovsky,Soviet Union,0,0,1,1,1964
Boris Grishin,Soviet Union,0,0,1,1,1964
Eduard Yegorov,Soviet Union,0,0,1,1,1964
Nikolay Kalashnikov,Soviet Union,0,0,1,1,1964
Nikolay Kuznetsov,Soviet Union,0,0,1,1,1964
Vladimir Kuznetsov,Soviet Union,0,0,1,1,1964
Leonid Osipov,Soviet Union,0,0,1,1,1964
Boris Popov,Soviet Union,0,0,1,1,1964
Vladimir Semyonov,Soviet Union,0,0,1,1,1964
Lothar Metz,Germany,0,0,1,1,1964
Wilfried Dietrich,West Germany,0,0,1,1,1964
Heinz Kiehl,West Germany,0,0,1,1,1964
Davit Gvantseladze,Soviet Union,0,0,1,1,1964
Aydın İbrahimov,Soviet Union,0,0,1,1,1964
Nodar Khokhashvili,Soviet Union,0,0,1,1,1964
Branko Martinović,Yugoslavia,0,0,1,1,1964
Uwe Beyer,West Germany,0,0,1,1,1964
Klaus Lehnertz,West Germany,0,0,1,1,1964
Hans-Joachim Walde,West Germany,0,0,1,1,1964
Galina Bystrova,Soviet Union,0,0,1,1,1964
Taisiya Chenchik,Soviet Union,0,0,1,1,1964
Yelena Gorchakova,Soviet Union,0,0,1,1,1964
Tatyana Shchelkanova,Soviet Union,0,0,1,1,1964
Galina Zybina,Soviet Union,0,0,1,1,1964
Ivan Belyayev,Ukraine,0,0,1,1,1964
Vladimir Golubnichy,Ukraine,0,0,1,1,1964
Viktor Kravchenko,Soviet Union,0,0,1,1,1964
Jānis Lūsis,Soviet Union,0,0,1,1,1964
Anatoly Mikhaylov,Soviet Union,0,0,1,1,1964
Igor Ter-Ovanesyan,Soviet Union,0,0,1,1,1964
Věra Čáslavská,Czechoslovakia,4,2,0,6,1968
Mikhail Voronin,Soviet Union,2,4,1,7,1968
Nataliya Kuchinskaya,Soviet Union,2,0,2,4,1968
Larisa Petrik,Soviet Union,2,0,1,3,1968
Yelena Novikova-Belova,Soviet Union,2,0,0,2,1968
Zinaida Voronina,Soviet Union,1,1,2,4,1968
Aleksandr Shaparenko,Ukraine,1,1,0,2,1968
Ivan Kizimov,Soviet Union,1,1,0,2,1968
Josef Neckermann,West Germany,1,1,0,2,1968
Mark Rakita,Soviet Union,1,1,0,2,1968
Đurđica Bjedov,Yugoslavia,1,1,0,2,1968
Lyudmila Khvedosyuk-Pinayeva,Soviet Union,1,0,1,2,1968
Reiner Klimke,West Germany,1,0,1,2,1968
Boris Lagutin,Soviet Union,1,0,0,1,1968
Danas Pozniakas,Soviet Union,1,0,0,1,1968
Valerian Sokolov,Soviet Union,1,0,0,1,1968
Roswitha Esser,West Germany,1,0,0,1,1968
Annemarie Zimmermann,West Germany,1,0,0,1,1968
Vladimir Morozov,Ukraine,1,0,0,1,1968
Liselott Linsenhoff,West Germany,1,0,0,1,1968
Galina Gorokhova,Soviet Union,1,0,0,1,1968
Tatyana Petrenko-Samusenko,Soviet Union,1,0,0,1,1968
Svetlana Tširkova,Soviet Union,1,0,0,1,1968
Aleksandra Zabelina,Soviet Union,1,0,0,1,1968
Umyar Mavlikhanov,Soviet Union,1,0,0,1,1968
Vladimir Nazlymov,Soviet Union,1,0,0,1,1968
Viktor Sidyak,Soviet Union,1,0,0,1,1968
Eduard Vinokurov,Soviet Union,1,0,0,1,1968
Lyubov Burda,Soviet Union,1,0,0,1,1968
Olga Karasyova,Soviet Union,1,0,0,1,1968
Lyudmila Turishcheva,Soviet Union,1,0,0,1,1968
Miroslav Cerar,Yugoslavia,1,0,0,1,1968
Egbert Hirschfelder,West Germany,1,0,0,1,1968
Wolfgang Hottenrott,West Germany,1,0,0,1,1968
Horst Meyer,West Germany,1,0,0,1,1968
Anatoly Sass,Soviet Union,1,0,0,1,1968
Aleksandr Timoshinin,Soviet Union,1,0,0,1,1968
Bernd Klingner,West Germany,1,0,0,1,1968
Jan Kůrka,Czechoslovakia,1,0,0,1,1968
Grigory Kosykh,Soviet Union,1,0,0,1,1968
Yevgeny Petrov,Soviet Union,1,0,0,1,1968
Milena Duchková,Czechoslovakia,1,0,0,1,1968
Lyudmila Buldakova,Soviet Union,1,0,0,1,1968
Vera Galushka-Duyunova,Uzbekistan,1,0,0,1,1968
Valentina Kamenyok-Vinogradova,Soviet Union,1,0,0,1,1968
Vera Lantratova,Soviet Union,1,0,0,1,1968
Galina Leontyeva,Soviet Union,1,0,0,1,1968
Lyudmila Mikhaylovskaya,Soviet Union,1,0,0,1,1968
Tatyana Ponyayeva-Tretyakova,Soviet Union,1,0,0,1,1968
Inna Ryskal,Soviet Union,1,0,0,1,1968
Roza Salikhova,Soviet Union,1,0,0,1,1968
Tatyana Sarycheva,Soviet Union,1,0,0,1,1968
Nina Smoleyeva,Soviet Union,1,0,0,1,1968
Oļegs Antropovs,Soviet Union,1,0,0,1,1968
Vladimir Belyayev,Ukraine,1,0,0,1,1968
Ivans Bugajenkovs,Soviet Union,1,0,0,1,1968
Vladimir Ivanov,Ukraine,1,0,0,1,1968
Valery Kravchenko,Soviet Union,1,0,0,1,1968
Yevgeny Lapinsky,Ukraine,1,0,0,1,1968
Vasilijus Matuševas,Soviet Union,1,0,0,1,1968
Viktor Mikhalchuk,Ukraine,1,0,0,1,1968
Georgy Mondzolevsky,Soviet Union,1,0,0,1,1968
Yury Poyarkov,Ukraine,1,0,0,1,1968
Eduard Sibiryakov,Soviet Union,1,0,0,1,1968
Boris Tereshchuk,Ukraine,1,0,0,1,1968
Ozren Bonačić,Yugoslavia,1,0,0,1,1968
Dejan Dabović,Yugoslavia,1,0,0,1,1968
Zdravko Hebel,Yugoslavia,1,0,0,1,1968
Zoran Janković,Yugoslavia,1,0,0,1,1968
Ronald Lopatny,Yugoslavia,1,0,0,1,1968
Uroš Marović,Yugoslavia,1,0,0,1,1968
Đorđe Perišić,Serbia and Montenegro,1,0,0,1,1968
Miroslav Poljak,Yugoslavia,1,0,0,1,1968
Mirko Sandić,Yugoslavia,1,0,0,1,1968
Karlo Stipanić,Yugoslavia,1,0,0,1,1968
Ivo Trumbić,Yugoslavia,1,0,0,1,1968
Viktor Kurentsov,Soviet Union,1,0,0,1,1968
Boris Selitsky,Soviet Union,1,0,0,1,1968
Leonid Zhabotinsky,Ukraine,1,0,0,1,1968
Lothar Metz,Germany,1,0,0,1,1968
Rudolf Vesper,Germany,1,0,0,1,1968
Boris Gurevich,Ukraine,1,0,0,1,1968
Aliaksandr Miadved,Soviet Union,1,0,0,1,1968
Roman Rurua,Soviet Union,1,0,0,1,1968
Valentin Mankin,Ukraine,1,0,0,1,1968
Margitta Helmbold-Gummel,Germany,1,0,0,1,1968
Christoph Höhne,Germany,1,0,0,1,1968
Ingrid Mickler-Becker,West Germany,1,0,0,1,1968
Miloslava Hübnerová-Rezková,Czechoslovakia,1,0,0,1,1968
Vladimir Golubnichy,Ukraine,1,0,0,1,1968
Jānis Lūsis,Soviet Union,1,0,0,1,1968
Viktor Saneyev,Soviet Union,1,0,0,1,1968
Vladimir Kosinsky,Soviet Union,0,2,1,3,1968
Grigory Kriss,Ukraine,0,2,0,2,1968
Leonid Ilyichov,Soviet Union,0,1,2,3,1968
Sergey Diomidov,Uzbekistan,0,1,1,2,1968
Viktor Klimenko,Soviet Union,0,1,1,2,1968
Pavel Lednyov,Soviet Union,0,1,1,2,1968
Galina Prozumenshchikova-Stepanova,Ukraine,0,1,1,2,1968
Semyon Belits-Geyman,Soviet Union,0,1,1,2,1968
Georgijs Kuļikovs,Soviet Union,0,1,1,2,1968
Dragutin Čermak,Yugoslavia,0,1,0,1,1968
Nikola Plećaš,Yugoslavia,0,1,0,1,1968
Krešimir Ćosić,Yugoslavia,0,1,0,1,1968
Vladimir Cvetković,Yugoslavia,0,1,0,1,1968
Ivo Daneu,Yugoslavia,0,1,0,1,1968
Radivoj Korać,Yugoslavia,0,1,0,1,1968
Trajko Rajković,Yugoslavia,0,1,0,1,1968
Dragoslav Ražnatović,Yugoslavia,0,1,0,1,1968
Petar Skansi,Yugoslavia,0,1,0,1,1968
Damir Šolman,Yugoslavia,0,1,0,1,1968
Aljoša Žorga,Yugoslavia,0,1,0,1,1968
Aleksey Kiselyov,Soviet Union,0,1,0,1,1968
Jonas Čepulis,Soviet Union,0,1,0,1,1968
Detlef Lewe,West Germany,0,1,0,1,1968
Yelena Petushkova,Soviet Union,0,1,0,1,1968
Ivan Kalita,Soviet Union,0,1,0,1,1968
Karl-Heinz Henrichs,West Germany,0,1,0,1,1968
Karl Link,West Germany,0,1,0,1,1968
Viktor Modzalevsky,Soviet Union,0,1,0,1,1968
Aleksey Nikanchikov,Soviet Union,0,1,0,1,1968
Viktor Putyatin,Ukraine,0,1,0,1,1968
Yury Sisikin,Soviet Union,0,1,0,1,1968
Yury Sharov,Soviet Union,0,1,0,1,1968
Yury Smolyakov,Soviet Union,0,1,0,1,1968
Vasily Stankovich,Ukraine,0,1,0,1,1968
German Sveshnikov,Soviet Union,0,1,0,1,1968
Iosif Vitebsky,Ukraine,0,1,0,1,1968
Marianna Némethová-Krajčírová,Slovakia,0,1,0,1,1968
Hana Lišková,Czechoslovakia,0,1,0,1,1968
Jána Kubičková-Posnerová,Slovakia,0,1,0,1,1968
Bohumila Řimnáčová,Czechoslovakia,0,1,0,1,1968
Miroslava Skleničková,Czechoslovakia,0,1,0,1,1968
Valery Ilyinykh,Soviet Union,0,1,0,1,1968
Valery Karasyov,Soviet Union,0,1,0,1,1968
Viktor Lisitsky,Soviet Union,0,1,0,1,1968
Boris Onishchenko,Ukraine,0,1,0,1,1968
Stasys Šaparnis,Soviet Union,0,1,0,1,1968
Valentin Kornev,Soviet Union,0,1,0,1,1968
Martina Grunert,Germany,0,1,0,1,1968
Horst-Günter Gregor,Germany,0,1,0,1,1968
Egon Henninger,Germany,0,1,0,1,1968
Frank Wiegand,Germany,0,1,0,1,1968
Tamara Fedosova-Pogozheva-Safonova,Soviet Union,0,1,0,1,1968
Nataliya Kuznetsova-Lobanova,Soviet Union,0,1,0,1,1968
Viktor Mazanov,Soviet Union,0,1,0,1,1968
Aleksey Barkalov,Ukraine,0,1,0,1,1968
Oleg Bovin,Soviet Union,0,1,0,1,1968
Aleksandr Dolgushin,Soviet Union,0,1,0,1,1968
Yury Grigorovsky,Soviet Union,0,1,0,1,1968
Boris Grishin,Soviet Union,0,1,0,1,1968
Vadim Gulyayev,Soviet Union,0,1,0,1,1968
Leonid Osipov,Soviet Union,0,1,0,1,1968
Vladimir Semyonov,Soviet Union,0,1,0,1,1968
Aleksandr Shidlovsky,Soviet Union,0,1,0,1,1968
Vyacheslav Skok,Soviet Union,0,1,0,1,1968
Givi Chikvanaia,Soviet Union,0,1,0,1,1968
Vladimir Belyayev,Ukraine,0,1,0,1,1968
Dito Shanidze,Soviet Union,0,1,0,1,1968
Jaan Talts,Soviet Union,0,1,0,1,1968
Vladimir Bakulin,Soviet Union,0,1,0,1,1968
Nikolay Yakovenko,Soviet Union,0,1,0,1,1968
Shota Lomidze,Soviet Union,0,1,0,1,1968
Valentin Olenik,Soviet Union,0,1,0,1,1968
Anatoly Roshchin,Soviet Union,0,1,0,1,1968
Stevan Horvat,Yugoslavia,0,1,0,1,1968
Klaus Beer,Germany,0,1,0,1,1968
Lothar Milde,Germany,0,1,0,1,1968
Hans-Joachim Walde,West Germany,0,1,0,1,1968
Antonina Okorokova-Lazareva,Soviet Union,0,1,0,1,1968
Romuald Klim,Soviet Union,0,1,0,1,1968
Vladimir Andreyev,Soviet Union,0,0,1,1,1968
Sergey Belov,Soviet Union,0,0,1,1,1968
Vadim Kapranov,Soviet Union,0,0,1,1,1968
Anatoli Krikun,Soviet Union,0,0,1,1,1968
Jaak Lipso,Soviet Union,0,0,1,1,1968
Modestas Paulauskas,Soviet Union,0,0,1,1,1968
Anatoly Polivoda,Ukraine,0,0,1,1,1968
Zurab Sak'andelidze,Soviet Union,0,0,1,1,1968
Yury Selikhov,Soviet Union,0,0,1,1,1968
Priit Tomson,Soviet Union,0,0,1,1,1968
Gennady Volnov,Soviet Union,0,0,1,1,1968
Vladimir Musalimov,Ukraine,0,0,1,1,1968
Zvonko Vujin,Yugoslavia,0,0,1,1,1968
Antonina Seredina,Soviet Union,0,0,1,1,1968
Vitaly Galkov,Soviet Union,0,0,1,1,1968
Naum Prokupets,Soviet Union,0,0,1,1,1968
Mikhail Zamotin,Soviet Union,0,0,1,1,1968
Alwin Schockemöhle,West Germany,0,0,1,1,1968
Hermann Schridde,West Germany,0,0,1,1,1968
Hans Günter Winkler,West Germany,0,0,1,1,1968
Ute Starke,Germany,0,0,1,1,1968
Siegfried Fülle,Germany,0,0,1,1,1968
Klaus Köste,Germany,0,0,1,1,1968
Peter Weber,Germany,0,0,1,1,1968
Antanas Bagdonavičius,Soviet Union,0,0,1,1,1968
Vytautas Briedis,Soviet Union,0,0,1,1,1968
Juozas Jagelavičius,Soviet Union,0,0,1,1,1968
Zigmas Jukna,Soviet Union,0,0,1,1,1968
Valentin Kravchuk,Ukraine,0,0,1,1,1968
Yury Lorentsson,Soviet Union,0,0,1,1,1968
Aleksandr Martyshkin,Soviet Union,0,0,1,1,1968
Vladimir Sterlik,Ukraine,0,0,1,1,1968
Viktor Suslin,Soviet Union,0,0,1,1,1968
Vitaly Parkhimovich,Soviet Union,0,0,1,1,1968
Renart Suleymanov,Soviet Union,0,0,1,1,1968
Heike Hustede-Nagel,West Germany,0,0,1,1,1968
Vladimir Bure,Soviet Union,0,0,1,1,1968
Yury Gromak,Ukraine,0,0,1,1,1968
Vladimir Nemshilov,Soviet Union,0,0,1,1,1968
Nikolay Pankin,Soviet Union,0,0,1,1,1968
Bohumil Golián,Slovakia,0,0,1,1,1968
Zdeněk Groessl,Czechoslovakia,0,0,1,1,1968
Petr Kop,Czechoslovakia,0,0,1,1,1968
Drahomír Koudelka,Czechoslovakia,0,0,1,1,1968
Josef Musil,Czechoslovakia,0,0,1,1,1968
Vladimír Petlák,Czechoslovakia,0,0,1,1,1968
Antonín Procházka,Czechoslovakia,0,0,1,1,1968
Pavel Schenk,Czechoslovakia,0,0,1,1,1968
Josef Smolka,Czechoslovakia,0,0,1,1,1968
František Sokol,Czechoslovakia,0,0,1,1,1968
Jiří Svoboda,Czechoslovakia,0,0,1,1,1968
Lubomír Zajíček,Czechoslovakia,0,0,1,1,1968
Wilfried Dietrich,West Germany,0,0,1,1,1968
Petr Kment,Czechoslovakia,0,0,1,1,1968
Miroslav Zeman,Czechoslovakia,0,0,1,1,1968
Ivan Kochergin,Soviet Union,0,0,1,1,1968
Branislav Simić,Yugoslavia,0,0,1,1,1968
Manfred Kinder,West Germany,0,0,1,1,1968
Ludvík Daněk,Czechoslovakia,0,0,1,1,1968
Galina Bukharina,Soviet Union,0,0,1,1,1968
Nataliya Pechonkina-Chistyakova,Soviet Union,0,0,1,1,1968
Nadezhda Chizhova,Soviet Union,0,0,1,1,1968
Lyudmila Ignatyeva-Samotyosova,Soviet Union,0,0,1,1,1968
Valentina Kozyr,Ukraine,0,0,1,1,1968
Vera Popkova,Ukraine,0,0,1,1,1968
Lyudmila Zharkova-Maslakova,Soviet Union,0,0,1,1,1968
Tatyana Talysheva,Soviet Union,0,0,1,1,1968
Valentin Gavrilov,Soviet Union,0,0,1,1,1968
Eduard Gushchin,Soviet Union,0,0,1,1,1968
Nikolay Smaga,Ukraine,0,0,1,1,1968
Olga Korbut,Soviet Union,3,1,0,4,1972
Lyudmila Turishcheva,Soviet Union,2,1,1,4,1972
Valery Borzov,Ukraine,2,1,0,3,1972
Viktor Klimenko,Soviet Union,1,2,0,3,1972
Tamara Lazakovich,Soviet Union,1,1,2,4,1972
Nikolay Andrianov,Soviet Union,1,1,1,3,1972
Liselott Linsenhoff,West Germany,1,1,0,2,1972
Yelena Petushkova,Soviet Union,1,1,0,2,1972
Viktor Sidyak,Soviet Union,1,1,0,2,1972
Boris Onishchenko,Ukraine,1,1,0,2,1972
Galina Gorokhova,Soviet Union,1,0,1,2,1972
Klaus Köste,Germany,1,0,1,2,1972
Pavel Lednyov,Soviet Union,1,0,1,2,1972
Ivan Yedeshko,Soviet Union,1,0,0,1,1972
Aleksandr Belov,Soviet Union,1,0,0,1,1972
Sergey Belov,Soviet Union,1,0,0,1,1972
Aleksandr Boloshev,Soviet Union,1,0,0,1,1972
Ivan Dvorny,Soviet Union,1,0,0,1,1972
Mikheil Korkia,Soviet Union,1,0,0,1,1972
Modestas Paulauskas,Soviet Union,1,0,0,1,1972
Anatoly Polivoda,Ukraine,1,0,0,1,1972
Zurab Sak'andelidze,Soviet Union,1,0,0,1,1972
Alzhan Zharmukhamedov,Soviet Union,1,0,0,1,1972
Gennady Volnov,Soviet Union,1,0,0,1,1972
Boris Kuznetsov,Soviet Union,1,0,0,1,1972
Vyacheslav Lemeshev,Soviet Union,1,0,0,1,1972
Mate Parlov,Yugoslavia,1,0,0,1,1972
Yekaterina Kuryshko,Ukraine,1,0,0,1,1972
Lyudmila Khvedosyuk-Pinayeva,Soviet Union,1,0,0,1,1972
Yuliya Ryabchinskaya,Ukraine,1,0,0,1,1972
Valery Didenko,Soviet Union,1,0,0,1,1972
Yury Filatov,Ukraine,1,0,0,1,1972
Nikolay Gorbachov,Soviet Union,1,0,0,1,1972
Vikt'or K'rat'asiuk'i,Soviet Union,1,0,0,1,1972
Yury Lobanov,Tajikistan,1,0,0,1,1972
Vladimir Morozov,Ukraine,1,0,0,1,1972
Aleksandr Shaparenko,Ukraine,1,0,0,1,1972
Yury Stetsenko,Ukraine,1,0,0,1,1972
Vladas Česiūnas,Soviet Union,1,0,0,1,1972
Ivan Kalita,Soviet Union,1,0,0,1,1972
Ivan Kizimov,Soviet Union,1,0,0,1,1972
Fritz Ligges,West Germany,1,0,0,1,1972
Hans Günter Winkler,West Germany,1,0,0,1,1972
Valery Yardy,Soviet Union,1,0,0,1,1972
Gennady Komnatov,Soviet Union,1,0,0,1,1972
Valery Likhachov,Soviet Union,1,0,0,1,1972
Boris Shukhov,Soviet Union,1,0,0,1,1972
Igor Tselovalnikov,Ukraine,1,0,0,1,1972
Carsten Keller,West Germany,1,0,0,1,1972
Michael Krause,West Germany,1,0,0,1,1972
Yelena Novikova-Belova,Soviet Union,1,0,0,1,1972
Tatyana Petrenko-Samusenko,Soviet Union,1,0,0,1,1972
Svetlana Tširkova,Soviet Union,1,0,0,1,1972
Aleksandra Zabelina,Soviet Union,1,0,0,1,1972
Lyubov Burda,Soviet Union,1,0,0,1,1972
Antanina Koshal,Soviet Union,1,0,0,1,1972
Elvira Saadi,Uzbekistan,1,0,0,1,1972
Abas Arslanagić,Yugoslavia,1,0,0,1,1972
Petar Fajfrić,Yugoslavia,1,0,0,1,1972
Hrvoje Horvat,Yugoslavia,1,0,0,1,1972
Milan Lazarević,Yugoslavia,1,0,0,1,1972
Zdravko Miljak,Yugoslavia,1,0,0,1,1972
Slobodan Mišković,Yugoslavia,1,0,0,1,1972
Branislav Pokrajac,Yugoslavia,1,0,0,1,1972
Miroslav Pribanić,Yugoslavia,1,0,0,1,1972
Albin Vidović,Yugoslavia,1,0,0,1,1972
Zoran Živković,Yugoslavia,1,0,0,1,1972
Zdenko Zorko,Yugoslavia,1,0,0,1,1972
Shota Chochishvili,Soviet Union,1,0,0,1,1972
Vladimir Shmelyov,Soviet Union,1,0,0,1,1972
Gennady Korshikov,Soviet Union,1,0,0,1,1972
Yury Malyshev,Soviet Union,1,0,0,1,1972
Aleksandr Timoshinin,Soviet Union,1,0,0,1,1972
Yakov Zheleznyak,Ukraine,1,0,0,1,1972
Vladimir Vasin,Soviet Union,1,0,0,1,1972
Lyudmila Borozna,Soviet Union,1,0,0,1,1972
Lyudmila Buldakova,Soviet Union,1,0,0,1,1972
Vera Galushka-Duyunova,Uzbekistan,1,0,0,1,1972
Tatyana Gonobobleva,Soviet Union,1,0,0,1,1972
Nataliya Kudreva,Soviet Union,1,0,0,1,1972
Galina Leontyeva,Soviet Union,1,0,0,1,1972
Tatyana Ponyayeva-Tretyakova,Soviet Union,1,0,0,1,1972
Inna Ryskal,Soviet Union,1,0,0,1,1972
Roza Salikhova,Soviet Union,1,0,0,1,1972
Tatyana Sarycheva,Soviet Union,1,0,0,1,1972
Nina Smoleyeva,Soviet Union,1,0,0,1,1972
Lyubov Tyurina,Soviet Union,1,0,0,1,1972
Anatoly Akimov,Soviet Union,1,0,0,1,1972
Aleksey Barkalov,Ukraine,1,0,0,1,1972
Aleksandr Dolgushin,Soviet Union,1,0,0,1,1972
Aleksandr Dreval,Soviet Union,1,0,0,1,1972
Vadim Gulyayev,Soviet Union,1,0,0,1,1972
Aleksandr Kabanov,Soviet Union,1,0,0,1,1972
Nikolay Melnikov,Soviet Union,1,0,0,1,1972
Leonid Osipov,Soviet Union,1,0,0,1,1972
Aleksandr Shidlovsky,Soviet Union,1,0,0,1,1972
Vladimir Zhmudsky,Soviet Union,1,0,0,1,1972
Vyacheslav Sobchenko,Soviet Union,1,0,0,1,1972
Vasily Alekseyev,Soviet Union,1,0,0,1,1972
Mukharby Kirzhinov,Soviet Union,1,0,0,1,1972
Jaan Talts,Soviet Union,1,0,0,1,1972
Vítězslav Mácha,Czechoslovakia,1,0,0,1,1972
Zagalav Abdulbekov,Soviet Union,1,0,0,1,1972
Roman Dmitriyev,Soviet Union,1,0,0,1,1972
Rustem Kazakov,Uzbekistan,1,0,0,1,1972
Shamil Khisamutdinov,Soviet Union,1,0,0,1,1972
Aliaksandr Miadved,Soviet Union,1,0,0,1,1972
Valery Rezantsev,Soviet Union,1,0,0,1,1972
Anatoly Roshchin,Soviet Union,1,0,0,1,1972
Ivan Yarygin,Soviet Union,1,0,0,1,1972
Levan Tediashvili,Soviet Union,1,0,0,1,1972
Vitaly Dyrdyra,Ukraine,1,0,0,1,1972
Valentin Mankin,Ukraine,1,0,0,1,1972
Ingrid Mickler-Becker,West Germany,1,0,0,1,1972
Ludvík Daněk,Czechoslovakia,1,0,0,1,1972
Lyudmila Bragina,Soviet Union,1,0,0,1,1972
Nadezhda Chizhova,Soviet Union,1,0,0,1,1972
Faina Melnik,Soviet Union,1,0,0,1,1972
Nikolay Avilov,Ukraine,1,0,0,1,1972
Anatoly Bondarchuk,Ukraine,1,0,0,1,1972
Viktor Saneyev,Soviet Union,1,0,0,1,1972
Jüri Tarmak,Soviet Union,1,0,0,1,1972
Mikhail Voronin,Soviet Union,0,2,0,2,1972
Vladimir Bure,Soviet Union,0,1,2,3,1972
Josef Neckermann,West Germany,0,1,1,2,1972
Vladimir Nazlymov,Soviet Union,0,1,1,2,1972
Vladimír Petříček,Czechoslovakia,0,1,1,2,1972
Galina Prozumenshchikova-Stepanova,Ukraine,0,1,1,2,1972
Igor Grivennikov,Soviet Union,0,1,1,2,1972
Viktor Mazanov,Soviet Union,0,1,1,2,1972
Viktor Bazhenov,Soviet Union,0,1,0,1,1972
Vladimir Denisov,Soviet Union,0,1,0,1,1972
Anatoly Koteshev,Soviet Union,0,1,0,1,1972
Viktor Putyatin,Ukraine,0,1,0,1,1972
Mark Rakita,Soviet Union,0,1,0,1,1972
Leonid Romanov,Soviet Union,0,1,0,1,1972
Vasily Stankovich,Ukraine,0,1,0,1,1972
Eduard Vinokurov,Soviet Union,0,1,0,1,1972
Aleksandr Maleyev,Soviet Union,0,1,0,1,1972
Edvard Mikayelyan,Soviet Union,0,1,0,1,1972
Vladimir Shchukin,Soviet Union,0,1,0,1,1972
Ladislav Beneš,Czechoslovakia,0,1,0,1,1972
František Brůna,Czechoslovakia,0,1,0,1,1972
Vladimír Haber,Czechoslovakia,0,1,0,1,1972
Vladimír Jarý,Czechoslovakia,0,1,0,1,1972
Jiří Kavan,Czechoslovakia,0,1,0,1,1972
Arnošt Klimčík,Czechoslovakia,0,1,0,1,1972
Jaroslav Konečný,Czechoslovakia,0,1,0,1,1972
František Králík,Czechoslovakia,0,1,0,1,1972
Jindřich Krepindl,Czechoslovakia,0,1,0,1,1972
Vincent Lafko,Slovakia,0,1,0,1,1972
Andrej Lukošík,Slovakia,0,1,0,1,1972
Pavel Mikeš,Czechoslovakia,0,1,0,1,1972
Peter Pospíšil,Slovakia,0,1,0,1,1972
Ivan Satrapa,Czechoslovakia,0,1,0,1,1972
Zdeněk Škára,Czechoslovakia,0,1,0,1,1972
Jaroslav Škarvan,Czechoslovakia,0,1,0,1,1972
Klaus Glahn,West Germany,0,1,0,1,1972
Vitaly Kuznetsov,Soviet Union,0,1,0,1,1972
Oldřich Svojanovský,Czechoslovakia,0,1,0,1,1972
Pavel Svojanovský,Czechoslovakia,0,1,0,1,1972
Ladislav Falta,Czechoslovakia,0,1,0,1,1972
Boris Melnik,Ukraine,0,1,0,1,1972
Yevgeny Petrov,Soviet Union,0,1,0,1,1972
Klaus Katzur,Germany,0,1,0,1,1972
Klaus Steinbach,West Germany,0,1,0,1,1972
Milena Duchková,Czechoslovakia,0,1,0,1,1972
Viktor Aboimov,Soviet Union,0,1,0,1,1972
Dito Shanidze,Soviet Union,0,1,0,1,1972
Arsen Alakhverdiyev,Soviet Union,0,1,0,1,1972
Nikolay Yakovenko,Soviet Union,0,1,0,1,1972
Anatoly Nazarenko,Soviet Union,0,1,0,1,1972
Gennady Strakhov,Soviet Union,0,1,0,1,1972
Josip Čorak,Yugoslavia,0,1,0,1,1972
Margitta Helmbold-Gummel,Germany,0,1,0,1,1972
Nijolė Sabaitė,Soviet Union,0,1,0,1,1972
Yevgeny Arzhanov,Ukraine,0,1,0,1,1972
Vladimir Golubnichy,Ukraine,0,1,0,1,1972
Aleksandr Kornelyuk,Soviet Union,0,1,0,1,1972
Leonid Litvinenko,Ukraine,0,1,0,1,1972
Vladimir Lovetsky,Soviet Union,0,1,0,1,1972
Jānis Lūsis,Soviet Union,0,1,0,1,1972
Juris Silovs,Soviet Union,0,1,0,1,1972
Veniamin Soldatenko,Soviet Union,0,1,0,1,1972
Emma Gapchenko,Soviet Union,0,0,1,1,1972
Zvonko Vujin,Yugoslavia,0,0,1,1,1972
Detlef Lewe,West Germany,0,0,1,1,1972
Horst Karsten,West Germany,0,0,1,1,1972
Omar Pkhak'adze,Soviet Union,0,0,1,1,1972
Grigory Kriss,Ukraine,0,0,1,1,1972
Viktor Modzalevsky,Soviet Union,0,0,1,1,1972
Sergey Paramonov,Ukraine,0,0,1,1,1972
Igor Valetov,Soviet Union,0,0,1,1,1972
Georgi Zažitski,Soviet Union,0,0,1,1,1972
Eberhard Vogel,Germany,0,0,1,1,1972
Arkadi Andriasyan,Soviet Union,0,0,1,1,1972
Oleg Blokhin,Ukraine,0,0,1,1,1972
Revaz Dzodzuashvili,Soviet Union,0,0,1,1,1972
Yury Yeliseyev,Ukraine,0,0,1,1,1972
Gennady Yevryuzhikhin,Soviet Union,0,0,1,1,1972
Yury Istomin,Soviet Union,0,0,1,1,1972
Andrey Yakubik,Soviet Union,0,0,1,1,1972
Vladimir Kaplichny,Soviet Union,0,0,1,1,1972
Viktor Kolotov,Ukraine,0,0,1,1,1972
Anatoly Kuksov,Ukraine,0,0,1,1,1972
Murtaz Khurtsilava,Soviet Union,0,0,1,1,1972
Yevgeny Lovchev,Soviet Union,0,0,1,1,1972
Sergey Olshansky,Soviet Union,0,0,1,1,1972
Vladimir Onishchenko,Ukraine,0,0,1,1,1972
Vladimir Pilguy,Soviet Union,0,0,1,1,1972
Yevgeny Rudakov,Ukraine,0,0,1,1,1972
Yozhef Sabo,Ukraine,0,0,1,1,1972
Vyacheslav Semyonov,Ukraine,0,0,1,1,1972
Hovhannes Zanazanyan,Soviet Union,0,0,1,1,1972
Simion Schobel,West Germany,0,0,1,1,1972
Anatoly Novikov,Ukraine,0,0,1,1,1972
Givi Onashvili,Soviet Union,0,0,1,1,1972
Angelo Parisi,Great Britain,0,0,1,1,1972
Vladimír Jánoš,Czechoslovakia,0,0,1,1,1972
Otakar Mareček,Czechoslovakia,0,0,1,1,1972
Karel Neffe,Czechoslovakia,0,0,1,1,1972
František Provazník,Czechoslovakia,0,0,1,1,1972
Viktor Torshin,Soviet Union,0,0,1,1,1972
Georgijs Kuļikovs,Soviet Union,0,0,1,1,1972
Viktor Borshch,Soviet Union,0,0,1,1,1972
Vyacheslav Domani,Soviet Union,0,0,1,1,1972
Vladimir Kondra,Soviet Union,0,0,1,1,1972
Valery Kravchenko,Soviet Union,0,0,1,1,1972
Yevgeny Lapinsky,Ukraine,0,0,1,1,1972
Vladimir Patkin,Soviet Union,0,0,1,1,1972
Yury Poyarkov,Ukraine,0,0,1,1,1972
Vladimir Putyatov,Soviet Union,0,0,1,1,1972
Aleksandr Saprykin,Soviet Union,0,0,1,1,1972
Yury Starunsky,Soviet Union,0,0,1,1,1972
Yefim Chulak,Soviet Union,0,0,1,1,1972
Leonid Zayko,Soviet Union,0,0,1,1,1972
Gennady Chetin,Soviet Union,0,0,1,1,1972
Ruslan Ashuraliyev,Soviet Union,0,0,1,1,1972
Milan Nenadić,Yugoslavia,0,0,1,1,1972
Willi Kuhweide,West Germany,0,0,1,1,1972
Karsten Meyer,West Germany,0,0,1,1,1972
Viktor Potapov,Soviet Union,0,0,1,1,1972
Karin Richert-Balzer,Germany,0,0,1,1,1972
Hans-Georg Reimann,Germany,0,0,1,1,1972
Eva Šuranová,Slovakia,0,0,1,1,1972
Vasily Khmelevsky,Soviet Union,0,0,1,1,1972
Nikolay Andrianov,Soviet Union,4,2,1,7,1976
Nelli Kim,Soviet Union,3,1,0,4,1976
Sergey Petrenko,Ukraine,2,0,0,2,1976
Aleksandr Vinogradov,Soviet Union,2,0,0,2,1976
Viktor Krovopuskov,Soviet Union,2,0,0,2,1976
Tatyana Kazankina,Soviet Union,2,0,0,2,1976
Lyudmila Turishcheva,Soviet Union,1,2,1,4,1976
Sergey Nagorny,Ukraine,1,1,0,2,1976
Vladimir Romanovsky,Soviet Union,1,1,0,2,1976
Harry Boldt,West Germany,1,1,0,2,1976
Alwin Schockemöhle,West Germany,1,1,0,2,1976
Vladimir Nazlymov,Soviet Union,1,1,0,2,1976
Olga Korbut,Soviet Union,1,1,0,2,1976
Matija Ljubek,Yugoslavia,1,0,1,2,1976
Reiner Klimke,West Germany,1,0,1,2,1976
Yelena Novikova-Belova,Soviet Union,1,0,1,2,1976
Viktor Sidyak,Soviet Union,1,0,1,2,1976
Marina Koshevaya,Soviet Union,1,0,1,2,1976
Olga Barysheva-Korostelyova,Soviet Union,1,0,0,1,1976
Tamāra Dauniene,Soviet Union,1,0,0,1,1976
Nelli Feryabnikova,Soviet Union,1,0,0,1,1976
Nataliya Klimova,Ukraine,1,0,0,1,1976
Raïsa Kurv'iakova,Ukraine,1,0,0,1,1976
Tatyana Ovechkina,Soviet Union,1,0,0,1,1976
Angelė Rupšienė,Soviet Union,1,0,0,1,1976
Uļjana Semjonova,Soviet Union,1,0,0,1,1976
Nadezhda Shuvayeva-Olkhova,Soviet Union,1,0,0,1,1976
Olga Sukharnova,Soviet Union,1,0,0,1,1976
Nadezhda Zakharova,Soviet Union,1,0,0,1,1976
Tatyana Zakharova-Nadyrova,Ukraine,1,0,0,1,1976
Nina Gopova-Trofimova,Soviet Union,1,0,0,1,1976
Galina Kreft-Alekseyeva,Soviet Union,1,0,0,1,1976
Aleksandr Degtyaryov,Soviet Union,1,0,0,1,1976
Yury Filatov,Ukraine,1,0,0,1,1976
Vladimir Morozov,Soviet Union,1,0,0,1,1976
Aleksandr Rogov,Soviet Union,1,0,0,1,1976
Sergey Chukhray,Ukraine,1,0,0,1,1976
Vladimir Kaminsky,Soviet Union,1,0,0,1,1976
Aavo Pikkuus,Soviet Union,1,0,0,1,1976
Valery Chaplygin,Soviet Union,1,0,0,1,1976
Anatoly Chukanov,Ukraine,1,0,0,1,1976
Anton Tkáč,Slovakia,1,0,0,1,1976
Nailya Gilyazova,Soviet Union,1,0,0,1,1976
Olga Knyazeva,Soviet Union,1,0,0,1,1976
Valentina Nikonova,Soviet Union,1,0,0,1,1976
Valentina Sidorova,Soviet Union,1,0,0,1,1976
Thomas Bach,West Germany,1,0,0,1,1976
Mikhail Burtsev,Soviet Union,1,0,0,1,1976
Eduard Vinokurov,Soviet Union,1,0,0,1,1976
Mariya Filatova,Soviet Union,1,0,0,1,1976
Svetlana Grozdova,Soviet Union,1,0,0,1,1976
Elvira Saadi,Uzbekistan,1,0,0,1,1976
Lyubov Berezhnaya-Odinokova,Ukraine,1,0,0,1,1976
Lyudmila Bobrus-Poradnik,Ukraine,1,0,0,1,1976
Tatyana Glushchenko,Ukraine,1,0,0,1,1976
Larisa Karlova,Ukraine,1,0,0,1,1976
Mariya Litoshenko,Ukraine,1,0,0,1,1976
Nina Lobova,Ukraine,1,0,0,1,1976
Tatyana Makarets-Kochergina,Ukraine,1,0,0,1,1976
Lyudmila Panchuk,Ukraine,1,0,0,1,1976
Nataliya Sherstyuk-Timoshkina,Ukraine,1,0,0,1,1976
Rafiga Shabanova,Soviet Union,1,0,0,1,1976
Lyudmila Shubina,Soviet Union,1,0,0,1,1976
Aldona Česaitytė-Nenėnienė,Soviet Union,1,0,0,1,1976
Zinaida Turchina,Ukraine,1,0,0,1,1976
Galina Zakharova,Ukraine,1,0,0,1,1976
Aleksandre Anp'ilogovi,Soviet Union,1,0,0,1,1976
Anatoly Fedyukin,Soviet Union,1,0,0,1,1976
Valery Gassy,Soviet Union,1,0,0,1,1976
Vasily Ilyin,Soviet Union,1,0,0,1,1976
Mikhail Ishchenko,Ukraine,1,0,0,1,1976
Yury Kidyayev,Soviet Union,1,0,0,1,1976
Yury Klimov,Soviet Union,1,0,0,1,1976
Vladimir Kravtsov,Soviet Union,1,0,0,1,1976
Sergey Kushniryuk,Ukraine,1,0,0,1,1976
Yury Lagutin,Ukraine,1,0,0,1,1976
Vladimir Maksimov,Soviet Union,1,0,0,1,1976
Aleksandr Rezanov,Ukraine,1,0,0,1,1976
Yevgeny Chernyshov,Soviet Union,1,0,0,1,1976
Nikolay Tomin,Ukraine,1,0,0,1,1976
Vladimir Nevzorov,Soviet Union,1,0,0,1,1976
Karl-Heinz Danielowski,Germany,1,0,0,1,1976
Aleksandr Lukyanov,Soviet Union,1,0,0,1,1976
Nikolay Ivanov,Soviet Union,1,0,0,1,1976
Vladimir Yeshinov,Soviet Union,1,0,0,1,1976
Aleksandr Klepikov,Soviet Union,1,0,0,1,1976
Mikhail Kuznetsov,Soviet Union,1,0,0,1,1976
Aleksandr Sema,Soviet Union,1,0,0,1,1976
Josef Panáček,Czechoslovakia,1,0,0,1,1976
Aleksandr Gazov,Soviet Union,1,0,0,1,1976
Yelena Vaytsekhovskaya,Soviet Union,1,0,0,1,1976
Vasily Alekseyev,Soviet Union,1,0,0,1,1976
Nikolay Kolesnikov,Soviet Union,1,0,0,1,1976
Pyotr Korol,Ukraine,1,0,0,1,1976
David Rigert,Soviet Union,1,0,0,1,1976
Valery Shary,Soviet Union,1,0,0,1,1976
Aleksandr Voronin,Soviet Union,1,0,0,1,1976
Yury Zaytsev,Soviet Union,1,0,0,1,1976
Soslan Andiyev,Soviet Union,1,0,0,1,1976
Nikolay Balboshin,Soviet Union,1,0,0,1,1976
Anatoly Bykov,Soviet Union,1,0,0,1,1976
Vladimir Yumin,Soviet Union,1,0,0,1,1976
Aleksandr Kolchinsky,Ukraine,1,0,0,1,1976
Vitaly Konstantinov,Soviet Union,1,0,0,1,1976
Suren Nalbandyan,Soviet Union,1,0,0,1,1976
Pavel Pinigin,Soviet Union,1,0,0,1,1976
Valery Rezantsev,Soviet Union,1,0,0,1,1976
Ivan Yarygin,Soviet Union,1,0,0,1,1976
Aleksey Shumakov,Soviet Union,1,0,0,1,1976
Levan Tediashvili,Soviet Union,1,0,0,1,1976
Momir Petković,Yugoslavia,1,0,0,1,1976
Jochen Schümann,Germany,1,0,0,1,1976
Udo Beyer,Germany,1,0,0,1,1976
Viktor Saneyev,Soviet Union,1,0,0,1,1976
Aleksandr Dityatin,Soviet Union,0,2,0,2,1976
Vladimir Marchenko,Soviet Union,0,2,0,2,1976
Jan Bártů,Czechoslovakia,0,1,1,2,1976
Lyubov Rusanova,Soviet Union,0,1,1,2,1976
Vladimir Raskatov,Ukraine,0,1,1,2,1976
Valentina Kovpan,Ukraine,0,1,0,1,1976
Mirza Delibašić,Yugoslavia,0,1,0,1,1976
Krešimir Ćosić,Yugoslavia,0,1,0,1,1976
Dražen Dalipagić,Yugoslavia,0,1,0,1,1976
Blagoja Georgievski,Yugoslavia,0,1,0,1,1976
Vinko Jelovac,Yugoslavia,0,1,0,1,1976
Željko Jerkov,Yugoslavia,0,1,0,1,1976
Dragan Kićanović,Serbia and Montenegro,0,1,0,1,1976
Andro Knego,Yugoslavia,0,1,0,1,1976
Zoran Slavnić,Yugoslavia,0,1,0,1,1976
Damir Šolman,Yugoslavia,0,1,0,1,1976
Rajko Žižić,Yugoslavia,0,1,0,1,1976
Rufat Riskiyev,Uzbekistan,0,1,0,1,1976
Tadija Kačar,Yugoslavia,0,1,0,1,1976
Tatyana Korshunova,Soviet Union,0,1,0,1,1976
Vasily Yurchenko,Ukraine,0,1,0,1,1976
Herbert Blöcker,West Germany,0,1,0,1,1976
Hans Günter Winkler,West Germany,0,1,0,1,1976
Vladimir Osokin,Soviet Union,0,1,0,1,1976
Vitaly Petrakov,Soviet Union,0,1,0,1,1976
Aleksandr Perov,Soviet Union,0,1,0,1,1976
Viktor Sokolov,Soviet Union,0,1,0,1,1976
Barry Dancer,Great Britain,0,1,0,1,1976
Terry Walsh,Malaysia,0,1,0,1,1976
Jiří Adam,Czechoslovakia,0,1,0,1,1976
Aleksandr Romankov,Soviet Union,0,1,0,1,1976
Henryk Kasperczak,Tunisia,0,1,0,1,1976
Gennady Krysin,Soviet Union,0,1,0,1,1976
Vladimir Markelov,Soviet Union,0,1,0,1,1976
Vladimir Tikhonov,Soviet Union,0,1,0,1,1976
Ramaz Kharshiladze,Soviet Union,0,1,0,1,1976
Bohumil Starnovský,Czechoslovakia,0,1,0,1,1976
Pavel Lednyov,Soviet Union,0,1,0,1,1976
Larisa Aleksandrova-Popova,Soviet Union,0,1,0,1,1976
Mira Bryunina,Soviet Union,0,1,0,1,1976
Olga Guzenko,Ukraine,0,1,0,1,1976
Galina Yermolayeva,Soviet Union,0,1,0,1,1976
Olga Kolkova,Ukraine,0,1,0,1,1976
Anna Kondrashina,Soviet Union,0,1,0,1,1976
Klavdija Koženkova,Soviet Union,0,1,0,1,1976
Olga Pugovskaya,Ukraine,0,1,0,1,1976
Nadezhda Rozgon,Ukraine,0,1,0,1,1976
Nadezhda Roshchina,Soviet Union,0,1,0,1,1976
Nelli Tarakanova,Ukraine,0,1,0,1,1976
Lyubov Talalayeva,Soviet Union,0,1,0,1,1976
Nadezhda Chernyshova,Soviet Union,0,1,0,1,1976
Yelena Zubko,Ukraine,0,1,0,1,1976
Dmitry Bekhterev,Soviet Union,0,1,0,1,1976
Vytautas Butkus,Soviet Union,0,1,0,1,1976
Yevgeny Duleyev,Soviet Union,0,1,0,1,1976
Yury Yakimov,Soviet Union,0,1,0,1,1976
Aivars Lazdenieks,Soviet Union,0,1,0,1,1976
Yury Lorentsson,Soviet Union,0,1,0,1,1976
Yury Shurkalov,Soviet Union,0,1,0,1,1976
Aleksandr Kedyarov,Soviet Union,0,1,0,1,1976
Marina Yurchenya,Ukraine,0,1,0,1,1976
Andrey Bogdanov,Soviet Union,0,1,0,1,1976
Sergey Koplyakov,Soviet Union,0,1,0,1,1976
Andrey Krylov,Soviet Union,0,1,0,1,1976
Larisa Bergen,Soviet Union,0,1,0,1,1976
Zoya Yusova,Soviet Union,0,1,0,1,1976
Olga Kozakova,Ukraine,0,1,0,1,1976
Nataliya Kushnir,Soviet Union,0,1,0,1,1976
Nina Muradyan,Soviet Union,0,1,0,1,1976
Liliya Osadchaya,Ukraine,0,1,0,1,1976
Anna Rostova,Ukraine,0,1,0,1,1976
Lyubov Rudovskaya,Ukraine,0,1,0,1,1976
Inna Ryskal,Soviet Union,0,1,0,1,1976
Lyudmila Shchetinina,Soviet Union,0,1,0,1,1976
Nina Smoleyeva,Soviet Union,0,1,0,1,1976
Lyudmila Chernyshova,Soviet Union,0,1,0,1,1976
Vladimir Dorokhov,Soviet Union,0,1,0,1,1976
Aleksandr Yermilov,Soviet Union,0,1,0,1,1976
Vladimir Kondra,Soviet Union,0,1,0,1,1976
Oleg Moliboga,Ukraine,0,1,0,1,1976
Anatoly Polishchuk,Ukraine,0,1,0,1,1976
Aleksandr Savin,Soviet Union,0,1,0,1,1976
Pāvels Seļivanovs,Soviet Union,0,1,0,1,1976
Yury Starunsky,Soviet Union,0,1,0,1,1976
Vladimir Chernyshov,Soviet Union,0,1,0,1,1976
Yefim Chulak,Soviet Union,0,1,0,1,1976
Vladimir Ulanov,Soviet Union,0,1,0,1,1976
Vyacheslav Zaytsev,Soviet Union,0,1,0,1,1976
Vardan Militosyan,Soviet Union,0,1,0,1,1976
Vítězslav Mácha,Czechoslovakia,0,1,0,1,1976
Nelson Davidyan,Ukraine,0,1,0,1,1976
Roman Dmitriyev,Soviet Union,0,1,0,1,1976
Aleksandr Ivanov,Soviet Union,0,1,0,1,1976
Viktor Novozhilov,Soviet Union,0,1,0,1,1976
Vladimir Cheboksarov,Soviet Union,0,1,0,1,1976
Ivica Frgić,Yugoslavia,0,1,0,1,1976
Vladislav Akimenko,Ukraine,0,1,0,1,1976
Andrey Balashov,Soviet Union,0,1,0,1,1976
Valentin Mankin,Ukraine,0,1,0,1,1976
Hans-Georg Reimann,Germany,0,1,0,1,1976
Marion Becker,West Germany,0,1,0,1,1976
Tatyana Anisimova,Soviet Union,0,1,0,1,1976
Nadezhda Chizhova,Soviet Union,0,1,0,1,1976
Yevgeny Mironov,Soviet Union,0,1,0,1,1976
Aleksey Spiridonov,Soviet Union,0,1,0,1,1976
Valery Borzov,Ukraine,0,0,2,2,1976
Zebiniso Rustamova,Tajikistan,0,0,1,1,1976
Ivan Yedeshko,Soviet Union,0,0,1,1,1976
Vladimir Arzamaskov,Soviet Union,0,0,1,1,1976
Aleksandr Belov,Soviet Union,0,0,1,1,1976
Sergey Belov,Soviet Union,0,0,1,1,1976
Mikheil Korkia,Soviet Union,0,0,1,1,1976
Andrey Makeyev,Soviet Union,0,0,1,1,1976
Valery Miloserdov,Soviet Union,0,0,1,1,1976
Anatoly Myshkin,Soviet Union,0,0,1,1,1976
Aleksandr Salnikov,Ukraine,0,0,1,1,1976
Alzhan Zharmukhamedov,Soviet Union,0,0,1,1,1976
Vladimir Zhigily,Soviet Union,0,0,1,1,1976
Viktor Rybakov,Soviet Union,0,0,1,1,1976
Viktor Savchenko,Ukraine,0,0,1,1,1976
Vasily Solomin,Soviet Union,0,0,1,1,1976
Davit Torosyan,Soviet Union,0,0,1,1,1976
Ace Rusevski,Yugoslavia,0,0,1,1,1976
Vladimir Astapovsky,Soviet Union,0,0,1,1,1976
Oleg Blokhin,Ukraine,0,0,1,1,1976
Leonid Buryak,Ukraine,0,0,1,1,1976
Vladimir Fyodorov,Uzbekistan,0,0,1,1,1976
Mikhail Fomenko,Ukraine,0,0,1,1,1976
Viktor Kolotov,Ukraine,0,0,1,1,1976
Anatoly Konkov,Ukraine,0,0,1,1,1976
Viktor Matviyenko,Ukraine,0,0,1,1,1976
Aleksandr Minayev,Soviet Union,0,0,1,1,1976
Leonid Nazarenko,Soviet Union,0,0,1,1,1976
Vladimir Onishchenko,Ukraine,0,0,1,1,1976
Stefan Reshko,Ukraine,0,0,1,1,1976
Vladimir Troshkin,Ukraine,0,0,1,1,1976
Vladimir Veremeyev,Ukraine,0,0,1,1,1976
Viktor Zvyagintsev,Ukraine,0,0,1,1,1976
Shota Chochishvili,Soviet Union,0,0,1,1,1976
Slavko Obadov,Yugoslavia,0,0,1,1,1976
Jaroslav Hellebrand,Czechoslovakia,0,0,1,1,1976
Vladek Lacina,Czechoslovakia,0,0,1,1,1976
Zdeněk Pecka,Czechoslovakia,0,0,1,1,1976
Oldřich Svojanovský,Czechoslovakia,0,0,1,1,1976
Pavel Svojanovský,Czechoslovakia,0,0,1,1,1976
Ludvík Vébr,Czechoslovakia,0,0,1,1,1976
Václav Vochoska,Czechoslovakia,0,0,1,1,1976
Yelena Antonova,Soviet Union,0,0,1,1,1976
Eleonora Kaminskaitė,Soviet Union,0,0,1,1,1976
Lyudmila Krokhina,Soviet Union,0,0,1,1,1976
Lidiya Krylova,Soviet Union,0,0,1,1,1976
Galina Mishenina,Soviet Union,0,0,1,1,1976
Anna Pasokha,Soviet Union,0,0,1,1,1976
Genovaitė Ramoškienė,Soviet Union,0,0,1,1,1976
Nadezhda Sevostiyanova,Soviet Union,0,0,1,1,1976
Raul Arnemann,Soviet Union,0,0,1,1,1976
Valery Dolinin,Soviet Union,0,0,1,1,1976
Anushavan Gassan-Dzhalilov,Soviet Union,0,0,1,1,1976
Nikolay Kuznetsov,Soviet Union,0,0,1,1,1976
Gennady Lushchikov,Soviet Union,0,0,1,1,1976
Klaus Steinbach,West Germany,0,0,1,1,1976
Vladimir Aleynik,Soviet Union,0,0,1,1,1976
Arvydas Juozaitis,Soviet Union,0,0,1,1,1976
Aleksandr Kosenkov,Soviet Union,0,0,1,1,1976
Andrey Smirnov,Soviet Union,0,0,1,1,1976
Farkhat Mustafin,Soviet Union,0,0,1,1,1976
Helena Fibingerová,Czechoslovakia,0,0,1,1,1976
Lyudmila Aksyonova,Ukraine,0,0,1,1,1976
Lidiya Alfeyeva,Soviet Union,0,0,1,1,1976
Vera Anisimova,Soviet Union,0,0,1,1,1976
Nadezhda Besfamilnaya,Soviet Union,0,0,1,1,1976
Inta Kļimoviča,Soviet Union,0,0,1,1,1976
Nadezhda Kolesnikova-Ilyina,Soviet Union,0,0,1,1,1976
Nataliya Sokolova,Soviet Union,0,0,1,1,1976
Nataliya Lebedeva,Soviet Union,0,0,1,1,1976
Tatyana Prorochenko,Ukraine,0,0,1,1,1976
Lyudmila Zharkova-Maslakova,Soviet Union,0,0,1,1,1976
Aleksandr Aksinin,Soviet Union,0,0,1,1,1976
Nikolay Avilov,Ukraine,0,0,1,1,1976
Aleksandr Baryshnikov,Soviet Union,0,0,1,1,1976
Anatoly Bondarchuk,Ukraine,0,0,1,1,1976
Yevgeny Gavrilenko,Soviet Union,0,0,1,1,1976
Nikolay Kolesnikov,Soviet Union,0,0,1,1,1976
Juris Silovs,Soviet Union,0,0,1,1,1976
Aleksandr Dityatin,Soviet Union,3,4,1,8,1980
Vladimir Parfenovich,Soviet Union,3,0,0,3,1980
Vladimir Salnikov,Soviet Union,3,0,0,3,1980
Nikolay Andrianov,Soviet Union,2,2,1,5,1980
Yelena Davydova,Russian Federation,2,1,0,3,1980
Aleksandr Tkachov,Soviet Union,2,1,0,3,1980
Sergey Koplyakov,Soviet Union,2,1,0,3,1980
Nataliya Shaposhnikova,Soviet Union,2,0,2,4,1980
Sergey Chukhray,Ukraine,2,0,0,2,1980
Viktor Krovopuskov,Soviet Union,2,0,0,2,1980
Nelli Kim,Soviet Union,2,0,0,2,1980
Anatoly Starostin,Soviet Union,2,0,0,2,1980
Viktor Markin,Soviet Union,2,0,0,2,1980
Andrey Krylov,Soviet Union,1,2,0,3,1980
Vladimir Smirnov,Ukraine,1,1,1,3,1980
Sergey Postrekhin,Ukraine,1,1,0,2,1980
Aleksandr Blinov,Soviet Union,1,1,0,2,1980
Nikolay Korolkov,Soviet Union,1,1,0,2,1980
Yury Kovshov,Uzbekistan,1,1,0,2,1980
Mikhail Burtsev,Soviet Union,1,1,0,2,1980
Angelo Parisi,Great Britain,1,1,0,2,1980
Sergey Fesenko,Ukraine,1,1,0,2,1980
Vera Komisova,Soviet Union,1,1,0,2,1980
Yury Salnikov,Soviet Union,1,0,1,2,1980
Viktor Ugryumov,Soviet Union,1,0,1,2,1980
Mariya Filatova,Soviet Union,1,0,1,2,1980
Pavel Lednyov,Soviet Union,1,0,1,2,1980
Ivar Stukolkin,Soviet Union,1,0,1,2,1980
Nadezhda Olizarenko,Ukraine,1,0,1,2,1980
Ketevan Losaberidze,Soviet Union,1,0,0,1,1980
Mirza Delibašić,Yugoslavia,1,0,0,1,1980
Mihovil Nakić-Vojnović,Yugoslavia,1,0,0,1,1980
Olga Barysheva-Korostelyova,Soviet Union,1,0,0,1,1980
Vida Beselienė,Soviet Union,1,0,0,1,1980
Nelli Feryabnikova,Soviet Union,1,0,0,1,1980
Tatyana Ivinskaya,Soviet Union,1,0,0,1,1980
Tatyana Ovechkina,Soviet Union,1,0,0,1,1980
Lyudmila Rogozhina,Soviet Union,1,0,0,1,1980
Angelė Rupšienė,Soviet Union,1,0,0,1,1980
Uļjana Semjonova,Soviet Union,1,0,0,1,1980
Lyubov Sharmay,Soviet Union,1,0,0,1,1980
Nadezhda Shuvayeva-Olkhova,Soviet Union,1,0,0,1,1980
Olga Sukharnova,Soviet Union,1,0,0,1,1980
Tatyana Zakharova-Nadyrova,Ukraine,1,0,0,1,1980
Krešimir Ćosić,Yugoslavia,1,0,0,1,1980
Dražen Dalipagić,Yugoslavia,1,0,0,1,1980
Željko Jerkov,Yugoslavia,1,0,0,1,1980
Dragan Kićanović,Serbia and Montenegro,1,0,0,1,1980
Andro Knego,Yugoslavia,1,0,0,1,1980
Duje Krstulović,Yugoslavia,1,0,0,1,1980
Ratko Radovanović,Yugoslavia,1,0,0,1,1980
Branko Skroče,Yugoslavia,1,0,0,1,1980
Zoran Slavnić,Yugoslavia,1,0,0,1,1980
Rajko Žižić,Yugoslavia,1,0,0,1,1980
Shamil Sabirov,Soviet Union,1,0,0,1,1980
Slobodan Kačar,Yugoslavia,1,0,0,1,1980
Birgit Fischer-Schmidt,Germany,1,0,0,1,1980
Vera Misevich,Ukraine,1,0,0,1,1980
Viktor Asmayev,Soviet Union,1,0,0,1,1980
Viktor Poganovsky,Ukraine,1,0,0,1,1980
Sergey Rogozhin,Soviet Union,1,0,0,1,1980
Vyacheslav Chukanov,Soviet Union,1,0,0,1,1980
Valery Volkov,Soviet Union,1,0,0,1,1980
Anatoly Yarkin,Soviet Union,1,0,0,1,1980
Yury Kashirin,Soviet Union,1,0,0,1,1980
Aleksandr Krasnov,Soviet Union,1,0,0,1,1980
Oleg Logvin,Soviet Union,1,0,0,1,1980
Viktor Manakov,Soviet Union,1,0,0,1,1980
Vladimir Osokin,Soviet Union,1,0,0,1,1980
Vitaly Petrakov,Soviet Union,1,0,0,1,1980
Sergey Shelpakov,Soviet Union,1,0,0,1,1980
Sergey Sukhoruchenkov,Soviet Union,1,0,0,1,1980
Vladimir Nazlymov,Soviet Union,1,0,0,1,1980
Viktor Sidyak,Soviet Union,1,0,0,1,1980
Jan Berger,Czechoslovakia,1,0,0,1,1980
František Kunzo,Slovakia,1,0,0,1,1980
Werner Lička,Czechoslovakia,1,0,0,1,1980
Luděk Macela,Czechoslovakia,1,0,0,1,1980
Josef Mazura,Czechoslovakia,1,0,0,1,1980
Petr Němec,Czechoslovakia,1,0,0,1,1980
Luboš Pokluda,Czechoslovakia,1,0,0,1,1980
Libor Radimec,Czechoslovakia,1,0,0,1,1980
Oldřich Rott,Czechoslovakia,1,0,0,1,1980
Zdeněk Rygel,Czechoslovakia,1,0,0,1,1980
Zdeněk Šreiner,Czechoslovakia,1,0,0,1,1980
František Štambacher,Czechoslovakia,1,0,0,1,1980
Jindřich Svoboda,Czechoslovakia,1,0,0,1,1980
Rostislav Václavíček,Czechoslovakia,1,0,0,1,1980
Ladislav Vízek,Czechoslovakia,1,0,0,1,1980
Stanislav Seman,Slovakia,1,0,0,1,1980
Yelena Naimushina,Soviet Union,1,0,0,1,1980
Stella Zakharova,Ukraine,1,0,0,1,1980
Eduard Azaryan,Soviet Union,1,0,0,1,1980
Bohdan Makuts,Ukraine,1,0,0,1,1980
Vladimir Markelov,Soviet Union,1,0,0,1,1980
Frank-Michael Wahl,Germany,1,0,0,1,1980
Lyubov Berezhnaya-Odinokova,Ukraine,1,0,0,1,1980
Lyudmila Bobrus-Poradnik,Ukraine,1,0,0,1,1980
Larisa Karlova,Ukraine,1,0,0,1,1980
Valentina Lutayeva,Ukraine,1,0,0,1,1980
Tatyana Makarets-Kochergina,Ukraine,1,0,0,1,1980
Irina Palchikova,Ukraine,1,0,0,1,1980
Yuliya Safina,Soviet Union,1,0,0,1,1980
Larisa Savkina,Soviet Union,1,0,0,1,1980
Nataliya Sherstyuk-Timoshkina,Ukraine,1,0,0,1,1980
Sigita Strečen-Mažeikaitė,Soviet Union,1,0,0,1,1980
Aldona Česaitytė-Nenėnienė,Soviet Union,1,0,0,1,1980
Zinaida Turchina,Ukraine,1,0,0,1,1980
Olga Zubareva,Ukraine,1,0,0,1,1980
Shota Khabareli,Soviet Union,1,0,0,1,1980
Nikolay Solodukhin,Soviet Union,1,0,0,1,1980
Yevgeny Lipeyev,Soviet Union,1,0,0,1,1980
Larisa Aleksandrova-Popova,Soviet Union,1,0,0,1,1980
Yelena Khloptseva,Soviet Union,1,0,0,1,1980
Aleksandr Melentyev,Soviet Union,1,0,0,1,1980
Igor Sokolov,Soviet Union,1,0,0,1,1980
Viktor Vlasov,Soviet Union,1,0,0,1,1980
Irina Kalinina,Soviet Union,1,0,0,1,1980
Lina Kačiušytė,Soviet Union,1,0,0,1,1980
Aleksandr Portnov,Soviet Union,1,0,0,1,1980
Aleksandr Sidorenko,Ukraine,1,0,0,1,1980
Robertas Žulpa,Soviet Union,1,0,0,1,1980
Yelena Akhaminova,Soviet Union,1,0,0,1,1980
Yelena Andreyuk,Soviet Union,1,0,0,1,1980
Svetlana Badulina,Soviet Union,1,0,0,1,1980
Lyubov Kozyreva,Soviet Union,1,0,0,1,1980
Lidiya Loginova,Soviet Union,1,0,0,1,1980
Irina Makogonova,Soviet Union,1,0,0,1,1980
Svetlana Nikishina,Soviet Union,1,0,0,1,1980
Nadezhda Radzevich,Soviet Union,1,0,0,1,1980
Nataliya Razumova,Soviet Union,1,0,0,1,1980
Olga Solovova,Soviet Union,1,0,0,1,1980
Lyudmila Chernyshova,Soviet Union,1,0,0,1,1980
Vladimir Dorokhov,Soviet Union,1,0,0,1,1980
Aleksandr Yermilov,Soviet Union,1,0,0,1,1980
Vladimir Kondra,Soviet Union,1,0,0,1,1980
Valery Krivov,Ukraine,1,0,0,1,1980
Fyodor Lashchonov,Ukraine,1,0,0,1,1980
Viljar Loor,Soviet Union,1,0,0,1,1980
Oleg Moliboga,Ukraine,1,0,0,1,1980
Yury Panchenko,Ukraine,1,0,0,1,1980
Aleksandr Savin,Soviet Union,1,0,0,1,1980
Pāvels Seļivanovs,Soviet Union,1,0,0,1,1980
Vladimir Chernyshov,Soviet Union,1,0,0,1,1980
Vyacheslav Zaytsev,Soviet Union,1,0,0,1,1980
Vladimir Akimov,Soviet Union,1,0,0,1,1980
Aleksey Barkalov,Ukraine,1,0,0,1,1980
Yevgeny Grishin,Soviet Union,1,0,0,1,1980
Mikhail Ivanov,Soviet Union,1,0,0,1,1980
Aleksandr Kabanov,Soviet Union,1,0,0,1,1980
Sergey Kotenko,Soviet Union,1,0,0,1,1980
Giorgi Mshvenieradze,Soviet Union,1,0,0,1,1980
Mait Riisman,Soviet Union,1,0,0,1,1980
Erkin Shagayev,Uzbekistan,1,0,0,1,1980
Yevgeny Sharonov,Soviet Union,1,0,0,1,1980
Vyacheslav Sobchenko,Soviet Union,1,0,0,1,1980
Ota Zaremba,Czechoslovakia,1,0,0,1,1980
Viktor Mazin,Soviet Union,1,0,0,1,1980
Kanybek Osmonaliyev,Soviet Union,1,0,0,1,1980
Sultanbay Rakhmanov,Ukraine,1,0,0,1,1980
Leonid Taranenko,Soviet Union,1,0,0,1,1980
Yuri Vardanyan,Soviet Union,1,0,0,1,1980
Saypulla Absaidov,Soviet Union,1,0,0,1,1980
Magomedgasan Abushev,Soviet Union,1,0,0,1,1980
Soslan Andiyev,Soviet Union,1,0,0,1,1980
Anatoly Beloglazov,Soviet Union,1,0,0,1,1980
Sergey Beloglazov,Soviet Union,1,0,0,1,1980
Vakht'ang Blagidze,Soviet Union,1,0,0,1,1980
Aleksandr Kolchinsky,Ukraine,1,0,0,1,1980
Gennady Korban,Soviet Union,1,0,0,1,1980
Ilya Mate,Ukraine,1,0,0,1,1980
Sanasar Oganisyan,Soviet Union,1,0,0,1,1980
Shamil Serikov,Soviet Union,1,0,0,1,1980
Zhaksylyk Ushkempirov,Soviet Union,1,0,0,1,1980
Valentin Mankin,Ukraine,1,0,0,1,1980
Aleksandrs Muzičenko,Soviet Union,1,0,0,1,1980
Hartwig Gauder,Germany,1,0,0,1,1980
Irina Nazarova,Soviet Union,1,0,0,1,1980
Tatyana Goyshchik,Soviet Union,1,0,0,1,1980
Tatyana Kazankina,Soviet Union,1,0,0,1,1980
Tatyana Kolpakova,Soviet Union,1,0,0,1,1980
Lyudmila Kondratyeva,Soviet Union,1,0,0,1,1980
Tatyana Prorochenko,Ukraine,1,0,0,1,1980
Nadezhda Tkachenko,Ukraine,1,0,0,1,1980
Nina Zyuskova,Ukraine,1,0,0,1,1980
Aleksandr Aksinin,Soviet Union,1,0,0,1,1980
Nikolay Chernetsky,Soviet Union,1,0,0,1,1980
Vladimir Kiselyov,Ukraine,1,0,0,1,1980
Dainis Kūla,Soviet Union,1,0,0,1,1980
Mikhail Linge,Soviet Union,1,0,0,1,1980
Vladimir Muravyov,Soviet Union,1,0,0,1,1980
Andrey Prokofyev,Soviet Union,1,0,0,1,1980
Viktor Rashchupkin,Soviet Union,1,0,0,1,1980
Nikolay Sidorov,Soviet Union,1,0,0,1,1980
Jaak Uudmäe,Soviet Union,1,0,0,1,1980
Remigijus Valiulis,Soviet Union,1,0,0,1,1980
Nikolay Alyokhin,Soviet Union,1,0,0,1,1980
Arsens Miskarovs,Soviet Union,0,2,1,3,1980
Viktor Kuznetsov,Soviet Union,0,2,0,2,1980
Nataliya Bochina,Soviet Union,0,2,0,2,1980
Olaf Heukrodt,Germany,0,1,1,2,1980
Ashot Karagyan,Soviet Union,0,1,1,2,1980
Aleksandr Romankov,Soviet Union,0,1,1,2,1980
Nataliya Kazak,Soviet Union,0,1,1,2,1980
Nina Cheremisina,Soviet Union,0,1,1,2,1980
Elvira Vasilkova,Soviet Union,0,1,1,2,1980
Nataliya Butuzova,Uzbekistan,0,1,0,1,1980
Boris Isachenko,Soviet Union,0,1,0,1,1980
Viktor Demyanenko,Soviet Union,0,1,0,1,1980
Serik Konakbayev,Soviet Union,0,1,0,1,1980
Aleksandr Koshkin,Soviet Union,0,1,0,1,1980
Viktor Miroshnichenko,Ukraine,0,1,0,1,1980
Viktor Savchenko,Ukraine,0,1,0,1,1980
Pyotr Zayev,Soviet Union,0,1,0,1,1980
Nina Gopova-Trofimova,Soviet Union,0,1,0,1,1980
Galina Kreft-Alekseyeva,Soviet Union,0,1,0,1,1980
Olaf Ludwig,Germany,0,1,0,1,1980
Aleksandr Panfilov,Uzbekistan,0,1,0,1,1980
Milada Blažková,Czechoslovakia,0,1,0,1,1980
Jiřina Čermáková,Czechoslovakia,0,1,0,1,1980
Jiřina Hájková,Czechoslovakia,0,1,0,1,1980
Berta Hrubá,Czechoslovakia,0,1,0,1,1980
Ida Hubáčková,Czechoslovakia,0,1,0,1,1980
Jiřina Kadlecová,Czechoslovakia,0,1,0,1,1980
Jarmila Králíčková,Czechoslovakia,0,1,0,1,1980
Jiřina Křížová,Czechoslovakia,0,1,0,1,1980
Alena Kyselicová,Slovakia,0,1,0,1,1980
Jana Lahodová,Czechoslovakia,0,1,0,1,1980
Květa Petříčková,Czechoslovakia,0,1,0,1,1980
Viera Podhányiová,Slovakia,0,1,0,1,1980
Iveta Šranková,Slovakia,0,1,0,1,1980
Marie Sýkorová,Czechoslovakia,0,1,0,1,1980
Marta Urbanová,Czechoslovakia,0,1,0,1,1980
Lenka Vymazalová,Czechoslovakia,0,1,0,1,1980
Nailya Gilyazova,Soviet Union,0,1,0,1,1980
Yelena Novikova-Belova,Soviet Union,0,1,0,1,1980
Valentina Sidorova,Soviet Union,0,1,0,1,1980
Larisa Tsagarayeva,Soviet Union,0,1,0,1,1980
Irina Ushakova,Soviet Union,0,1,0,1,1980
Marius Strzalka,Poland,0,1,0,1,1980
Vladimir Lapitsky,Soviet Union,0,1,0,1,1980
Sabirzhan Ruziyev,Uzbekistan,0,1,0,1,1980
Jasna Kolar-Merdan,Bosnia and Herzegovina,0,1,0,1,1980
Vesna Radović,Serbia,0,1,0,1,1980
Aleksandre Anp'ilogovi,Soviet Union,0,1,0,1,1980
Vladimir Belov,Soviet Union,0,1,0,1,1980
Anatoly Fedyukin,Soviet Union,0,1,0,1,1980
Mikhail Ishchenko,Ukraine,0,1,0,1,1980
Aleksandr Karshakevich,Soviet Union,0,1,0,1,1980
Yury Kidyayev,Soviet Union,0,1,0,1,1980
Vladimir Kravtsov,Soviet Union,0,1,0,1,1980
Sergey Kushniryuk,Ukraine,0,1,0,1,1980
Viktor Makhorin,Soviet Union,0,1,0,1,1980
Voldemaras Novickis,Soviet Union,0,1,0,1,1980
Vladimir Repyev,Soviet Union,0,1,0,1,1980
Yevgeny Chernyshov,Soviet Union,0,1,0,1,1980
Nikolay Tomin,Ukraine,0,1,0,1,1980
Aleksey Zhuk,Soviet Union,0,1,0,1,1980
Svetlana Anastasovski-Obućina,Yugoslavia,0,1,0,1,1980
Mirjana Đurica,Yugoslavia,0,1,0,1,1980
Katica Ileš,Yugoslavia,0,1,0,1,1980
Slavica Jeremić,Yugoslavia,0,1,0,1,1980
Vesna Milošević,Yugoslavia,0,1,0,1,1980
Mirjana Ognjenović,Yugoslavia,0,1,0,1,1980
Rada Savić,Yugoslavia,0,1,0,1,1980
Ana Titlić,Yugoslavia,0,1,0,1,1980
Biserka Višnjić,Yugoslavia,0,1,0,1,1980
Zorica Vojinović,Yugoslavia,0,1,0,1,1980
Tengiz Khubuluri,Soviet Union,0,1,0,1,1980
Aleksandr Lukyanov,Soviet Union,0,1,0,1,1980
Nina Frolova,Soviet Union,0,1,0,1,1980
Nadezhda Lyubimova,Soviet Union,0,1,0,1,1980
Antonina Makhina-Dumcheva-Zelikovich,Soviet Union,0,1,0,1,1980
Yelena Matiyevskaya,Soviet Union,0,1,0,1,1980
Mariya Pazyun,Ukraine,0,1,0,1,1980
Olga Pivovarova,Ukraine,0,1,0,1,1980
Nina Preobrazhenskaya,Ukraine,0,1,0,1,1980
Nadezhda Prishchepa,Ukraine,0,1,0,1,1980
Antonina Pustovit,Ukraine,0,1,0,1,1980
Tatyana Stetsenko,Ukraine,0,1,0,1,1980
Yelena Teryoshina,Ukraine,0,1,0,1,1980
Nina Umanets,Ukraine,0,1,0,1,1980
Olga Vasilchenko,Soviet Union,0,1,0,1,1980
Valentina Zhulina,Soviet Union,0,1,0,1,1980
Yevgeny Barbakov,Soviet Union,0,1,0,1,1980
Juris Bērziņš,Soviet Union,0,1,0,1,1980
Valery Dolinin,Soviet Union,0,1,0,1,1980
Nikolay Dovgan,Ukraine,0,1,0,1,1980
Artūrs Garonskis,Soviet Union,0,1,0,1,1980
Vasily Yakusha,Soviet Union,0,1,0,1,1980
Vitaly Yeliseyev,Soviet Union,0,1,0,1,1980
Aleksey Kamkin,Soviet Union,0,1,0,1,1980
Valery Kleshnyov,Soviet Union,0,1,0,1,1980
Dimants Krišjānis,Soviet Union,0,1,0,1,1980
Dzintars Krišjānis,Soviet Union,0,1,0,1,1980
Gennady Kryuchkin,Soviet Union,0,1,0,1,1980
Aleksandr Kulagin,Soviet Union,0,1,0,1,1980
Viktor Pereverzev,Soviet Union,0,1,0,1,1980
Yury Pimenov,Soviet Union,0,1,0,1,1980
Nikolay Pimenov,Soviet Union,0,1,0,1,1980
Yury Shapochka,Ukraine,0,1,0,1,1980
Žoržs Tikmers,Soviet Union,0,1,0,1,1980
Zoran Pančić,Yugoslavia,0,1,0,1,1980
Milorad Stanulov,Yugoslavia,0,1,0,1,1980
Rustam Yambulatov,Uzbekistan,0,1,0,1,1980
Silva Emirzyan,Soviet Union,0,1,0,1,1980
Svetlana Varganova,Soviet Union,0,1,0,1,1980
Vladimir Aleynik,Soviet Union,0,1,0,1,1980
Yevgeny Seredin,Soviet Union,0,1,0,1,1980
Aleksandr Chayev,Soviet Union,0,1,0,1,1980
Milivoj Bebić,Yugoslavia,0,1,0,1,1980
Zoran Gopčević,Yugoslavia,0,1,0,1,1980
Milorad Krivokapić,Yugoslavia,0,1,0,1,1980
Boško Lozica,Yugoslavia,0,1,0,1,1980
Zoran Mustur,Yugoslavia,0,1,0,1,1980
Damir Polić,Yugoslavia,0,1,0,1,1980
Zoran Roje,Yugoslavia,0,1,0,1,1980
Ratko Rudić,Croatia,0,1,0,1,1980
Slobodan Trifunović,Yugoslavia,0,1,0,1,1980
Luka Vezilić,Yugoslavia,0,1,0,1,1980
Igor Nikitin,Soviet Union,0,1,0,1,1980
Aleksandr Pervy,Ukraine,0,1,0,1,1980
Yurik Sarkisyan,Australia,0,1,0,1,1980
Magomedkhan Aratsilov,Soviet Union,0,1,0,1,1980
Anatoly Bykov,Soviet Union,0,1,0,1,1980
Igor Kanygin,Soviet Union,0,1,0,1,1980
Aleksandr Budnikov,Soviet Union,0,1,0,1,1980
Boris Budnikov,Soviet Union,0,1,0,1,1980
Nikolai Poljakov,Soviet Union,0,1,0,1,1980
Jarmila Kratochvílová,Czechoslovakia,0,1,0,1,1980
Imrich Bugár,Slovakia,0,1,0,1,1980
Vera Anisimova,Soviet Union,0,1,0,1,1980
Esfir Dolzhenko-Krachevskaya,Soviet Union,0,1,0,1,1980
Saida Gunba,Soviet Union,0,1,0,1,1980
Olga Rukavishnikova,Soviet Union,0,1,0,1,1980
Lyudmila Zharkova-Maslakova,Soviet Union,0,1,0,1,1980
Olga Syrovatskaya-Mineyeva,Soviet Union,0,1,0,1,1980
Vasily Arkhipenko,Ukraine,0,1,0,1,1980
Aleksandr Baryshnikov,Soviet Union,0,1,0,1,1980
Yury Kutsenko,Soviet Union,0,1,0,1,1980
Sergey Litvinov,Soviet Union,0,1,0,1,1980
Aleksandr Makarov,Soviet Union,0,1,0,1,1980
Pyotr Pochenchuk,Soviet Union,0,1,0,1,1980
Viktor Saneyev,Soviet Union,0,1,0,1,1980
Konstantin Volkov,Soviet Union,0,1,0,1,1980
Nik'oloz Deriugini,Soviet Union,0,0,1,1,1980
Mersada Bećirspahić,Yugoslavia,0,0,1,1,1980
Mira Bjedov,Yugoslavia,0,0,1,1,1980
Vesna Despotović,Yugoslavia,0,0,1,1,1980
Jelica Komnenović,Yugoslavia,0,0,1,1,1980
Biljana Majstorović,Yugoslavia,0,0,1,1,1980
Vukica Mitić,Yugoslavia,0,0,1,1,1980
Sanja Ožegović,Yugoslavia,0,0,1,1,1980
Sofija Pekić,Yugoslavia,0,0,1,1,1980
Jasmina Perazić,Yugoslavia,0,0,1,1,1980
Marija Tonković,Yugoslavia,0,0,1,1,1980
Aleksandr Belostenny,Ukraine,0,0,1,1,1980
Sergey Belov,Soviet Union,0,0,1,1,1980
Stanislav Yeryomin,Soviet Union,0,0,1,1,1980
Sergėjus Jovaiša,Soviet Union,0,0,1,1,1980
Andrey Lopatov,Soviet Union,0,0,1,1,1980
Valery Miloserdov,Soviet Union,0,0,1,1,1980
Anatoly Myshkin,Soviet Union,0,0,1,1,1980
Aleksandr Salnikov,Ukraine,0,0,1,1,1980
Sergey Tarakanov,Soviet Union,0,0,1,1,1980
Vladimir Zhigily,Soviet Union,0,0,1,1,1980
Ján Franek,Slovakia,0,0,1,1,1980
Viktor Rybakov,Soviet Union,0,0,1,1,1980
Antonina Melnikova,Soviet Union,0,0,1,1,1980
Vasily Yurchenko,Ukraine,0,0,1,1,1980
Yury Lobanov,Tajikistan,0,0,1,1,1980
Yury Barinov,Soviet Union,0,0,1,1,1980
Teodor Černý,Czechoslovakia,0,0,1,1,1980
Michal Klasa,Czechoslovakia,0,0,1,1,1980
Vlastibor Konečný,Czechoslovakia,0,0,1,1,1980
Sergey Kopylov,Soviet Union,0,0,1,1,1980
Alipi Kostadinov,Czechoslovakia,0,0,1,1,1980
Martin Penc,Czechoslovakia,0,0,1,1,1980
Jiří Pokorný,Czechoslovakia,0,0,1,1,1980
Jiří Škoda,Czechoslovakia,0,0,1,1,1980
Igor Sláma,Czechoslovakia,0,0,1,1,1980
Leyla Akhmerova,Uzbekistan,0,0,1,1,1980
Nataliya Buzunova,Soviet Union,0,0,1,1,1980
Nataliya Bykova,Soviet Union,0,0,1,1,1980
Alina Kham,Uzbekistan,0,0,1,1,1980
Nadya Filippova,Soviet Union,0,0,1,1,1980
Lyudmila Frolova,Soviet Union,0,0,1,1,1980
Lidiya Glubokova,Soviet Union,0,0,1,1,1980
Nelli Gorbyatkova,Uzbekistan,0,0,1,1,1980
Yelena Guryeva,Soviet Union,0,0,1,1,1980
Galina Inzhuvatova,Soviet Union,0,0,1,1,1980
Tatyana Yembakhtova,Uzbekistan,0,0,1,1,1980
Natella Krasnikova,Soviet Union,0,0,1,1,1980
Nadezhda Ovechkina,Soviet Union,0,0,1,1,1980
Tatyana Shvyganova,Soviet Union,0,0,1,1,1980
Galina Vyuzhanina,Soviet Union,0,0,1,1,1980
Valentina Zazdravnykh,Uzbekistan,0,0,1,1,1980
Sos Hayrapetyan,Soviet Union,0,0,1,1,1980
Minneula Azizov,Soviet Union,0,0,1,1,1980
Valery Belyakov,Soviet Union,0,0,1,1,1980
Viktor Deputatov,Soviet Union,0,0,1,1,1980
Aleksandr Goncharov,Soviet Union,0,0,1,1,1980
Aleksandr Gusev,Soviet Union,0,0,1,1,1980
Sergey Klevtsov,Soviet Union,0,0,1,1,1980
Vyacheslav Lampeyev,Soviet Union,0,0,1,1,1980
Aleksandr Myasnikov,Soviet Union,0,0,1,1,1980
Mikhail Nichepurenko,Soviet Union,0,0,1,1,1980
Leonid Pavlovsky,Soviet Union,0,0,1,1,1980
Sergey Pleshakov,Soviet Union,0,0,1,1,1980
Vladimir Pleshakov,Soviet Union,0,0,1,1,1980
Aleksandr Sychov,Soviet Union,0,0,1,1,1980
Oleg Zagorodnev,Soviet Union,0,0,1,1,1980
Farit Zigangirov,Soviet Union,0,0,1,1,1980
Aleksandr Abushakhmetov,Soviet Union,0,0,1,1,1980
Boris Lukomsky,Soviet Union,0,0,1,1,1980
Aleksandr Mozhayev,Soviet Union,0,0,1,1,1980
Sergey Andreyev,Soviet Union,0,0,1,1,1980
Sergey Baltacha,Ukraine,0,0,1,1,1980
Vladimir Bessonov,Ukraine,0,0,1,1,1980
Rinat Dasayev,Soviet Union,0,0,1,1,1980
Valery Gazzayev,Soviet Union,0,0,1,1,1980
Yury Gavrilov,Soviet Union,0,0,1,1,1980
Sergey Nikulin,Soviet Union,0,0,1,1,1980
Khoren Hovhannisyan,Soviet Union,0,0,1,1,1980
Vladimir Pilguy,Soviet Union,0,0,1,1,1980
Aleksandr Prokopenko,Soviet Union,0,0,1,1,1980
Oleg Romantsev,Soviet Union,0,0,1,1,1980
Sergey Shavlo,Soviet Union,0,0,1,1,1980
Tengiz Sulakvelidze,Soviet Union,0,0,1,1,1980
Revaz Chelebadze,Soviet Union,0,0,1,1,1980
Fyodor Cherenkov,Soviet Union,0,0,1,1,1980
Vagiz Khidiyatullin,Soviet Union,0,0,1,1,1980
Aleksandre Chivadze,Soviet Union,0,0,1,1,1980
Jiří Tabák,Czechoslovakia,0,0,1,1,1980
Aleksandrs Jackēvičs,Soviet Union,0,0,1,1,1980
Aramby Yemizh,Soviet Union,0,0,1,1,1980
Vladimír Kocman,Czechoslovakia,0,0,1,1,1980
Zdeněk Pecka,Czechoslovakia,0,0,1,1,1980
Václav Vochoska,Czechoslovakia,0,0,1,1,1980
Hryhoriy Dmytrenko,Ukraine,0,0,1,1,1980
Mariya Fadeyeva,Soviet Union,0,0,1,1,1980
Svetlana Semyonova,Soviet Union,0,0,1,1,1980
Galina Sovetnikova,Soviet Union,0,0,1,1,1980
Marina Studneva,Soviet Union,0,0,1,1,1980
Viktor Kakoshin,Ukraine,0,0,1,1,1980
Andrey Lugin,Soviet Union,0,0,1,1,1980
Igor Maystrenko,Soviet Union,0,0,1,1,1980
Aleksandr Mantsevich,Ukraine,0,0,1,1,1980
Jonas Narmontas,Soviet Union,0,0,1,1,1980
Jonas Pinskus,Soviet Union,0,0,1,1,1980
Andrey Tishchenko,Ukraine,0,0,1,1,1980
Aleksandr Tkachenko,Ukraine,0,0,1,1,1980
Zlatko Celent,Yugoslavia,0,0,1,1,1980
Duško Mrduljaš,Yugoslavia,0,0,1,1,1980
Josip Reić,Yugoslavia,0,0,1,1,1980
Jörg Damme,Germany,0,0,1,1,1980
Aleksandr Gazov,Soviet Union,0,0,1,1,1980
Yuliya Bogdanova,Soviet Union,0,0,1,1,1980
Alla Grishchenkova,Soviet Union,0,0,1,1,1980
Yelena Kruglova,Ukraine,0,0,1,1,1980
Nataliya Strunnikova,Soviet Union,0,0,1,1,1980
Liana Tsot'adze,Soviet Union,0,0,1,1,1980
Davit Hambardzumyan,Soviet Union,0,0,1,1,1980
Vladimir Dolgov,Ukraine,0,0,1,1,1980
Dušan Poliačik,Slovakia,0,0,1,1,1980
Dan Karabin,Slovakia,0,0,1,1,1980
Július Strnisko,Slovakia,0,0,1,1,1980
Sergey Kornilayev,Soviet Union,0,0,1,1,1980
Boris Kramarenko,Soviet Union,0,0,1,1,1980
Šaban Sejdi,Yugoslavia,0,0,1,1,1980
Andrey Balashov,Soviet Union,0,0,1,1,1980
Jüri Tamm,Soviet Union,0,0,1,1,1980
Udo Beyer,Germany,0,0,1,1,1980
Merlene Ottey-Page,Slovenia,0,0,1,1,1980
Olga Kuragina,Soviet Union,0,0,1,1,1980
Tatyana Lesovaya,Soviet Union,0,0,1,1,1980
Tatyana Providokhina,Soviet Union,0,0,1,1,1980
Tatyana Skachko,Ukraine,0,0,1,1,1980
Satymkul Dzhumanazarov,Soviet Union,0,0,1,1,1980
Yevgeny Ivchenko,Soviet Union,0,0,1,1,1980
Nikolay Kirov,Soviet Union,0,0,1,1,1980
Valery Podluzhny,Ukraine,0,0,1,1,1980
Aleksandr Puchkov,Soviet Union,0,0,1,1,1980
Sergey Zhelanov,Soviet Union,0,0,1,1,1980
Reiner Klimke,West Germany,2,0,0,2,1984
Matija Ljubek,Yugoslavia,1,1,0,2,1984
Mirko Nišović,Yugoslavia,1,1,0,2,1984
Jujie Luan,People's Republic of China,1,0,0,1,1984
Zita Funkenhauser,West Germany,1,0,0,1,1984
Elmar Borrmann,West Germany,1,0,0,1,1984
Slavica Djukić,Serbia,1,0,0,1,1984
Jasna Kolar-Merdan,Bosnia and Herzegovina,1,0,0,1,1984
Svetlana Anastasovski-Obućina,Yugoslavia,1,0,0,1,1984
Alenka Cuderman,Yugoslavia,1,0,0,1,1984
Dragica Đurić,Yugoslavia,1,0,0,1,1984
Mirjana Đurica,Yugoslavia,1,0,0,1,1984
Emilija Erčić,Yugoslavia,1,0,0,1,1984
Ljubinka Janković,Yugoslavia,1,0,0,1,1984
Ljiljana Mugoša,Yugoslavia,1,0,0,1,1984
Svetlana Mugoša-Antić,Montenegro,1,0,0,1,1984
Mirjana Ognjenović,Yugoslavia,1,0,0,1,1984
Zorica Pavićević,Yugoslavia,1,0,0,1,1984
Jasna Ptujec,Yugoslavia,1,0,0,1,1984
Biserka Višnjić,Yugoslavia,1,0,0,1,1984
Zlatan Arnautović,Yugoslavia,1,0,0,1,1984
Mirko Bašić,Yugoslavia,1,0,0,1,1984
Jovan Elezović,Yugoslavia,1,0,0,1,1984
Mile Isaković,Yugoslavia,1,0,0,1,1984
Pavao Jurina,Yugoslavia,1,0,0,1,1984
Milan Kalina,Yugoslavia,1,0,0,1,1984
Slobodan Kuzmanovski,Yugoslavia,1,0,0,1,1984
Dragan Mladenović,Yugoslavia,1,0,0,1,1984
Zdravko Rađenović,Serbia,1,0,0,1,1984
Momir Rnić,Yugoslavia,1,0,0,1,1984
Branko Štrbac,Yugoslavia,1,0,0,1,1984
Veselin Vujović,Serbia,1,0,0,1,1984
Veselin Vuković,Yugoslavia,1,0,0,1,1984
Zdravko Zovko,Yugoslavia,1,0,0,1,1984
Lang Ping,United States,1,0,0,1,1984
Perica Bukić,Yugoslavia,1,0,0,1,1984
Dragan Andrić,Serbia,1,0,0,1,1984
Milivoj Bebić,Yugoslavia,1,0,0,1,1984
Veselin Đuho,Yugoslavia,1,0,0,1,1984
Milorad Krivokapić,Yugoslavia,1,0,0,1,1984
Deni Lušić,Yugoslavia,1,0,0,1,1984
Igor Milanović,Serbia and Montenegro,1,0,0,1,1984
Tomislav Paškvalin,Yugoslavia,1,0,0,1,1984
Zoran Petrović,Yugoslavia,1,0,0,1,1984
Zoran Roje,Yugoslavia,1,0,0,1,1984
Goran Sukno,Yugoslavia,1,0,0,1,1984
Božo Vuletić,Yugoslavia,1,0,0,1,1984
Šaban Trstena,Yugoslavia,1,0,0,1,1984
Vlado Lisjak,Yugoslavia,1,0,0,1,1984
Rod Davis,United States,1,0,0,1,1984
Dietmar Mögenburg,West Germany,1,0,0,1,1984
Andrija Popović,Yugoslavia,1,0,0,1,1984
Redžep Redžepovski,Yugoslavia,0,1,0,1,1984
Milan Janić,Yugoslavia,0,1,0,1,1984
Carsten Fischer,West Germany,0,1,0,1,1984
Volker Fried,West Germany,0,1,0,1,1984
Andreas Keller,West Germany,0,1,0,1,1984
Monika Weber-Koszto,Romania,0,1,0,1,1984
Jochen Fraatz,West Germany,0,1,0,1,1984
Martin Schwalb,West Germany,0,1,0,1,1984
Andreas Thiel,West Germany,0,1,0,1,1984
Angelo Parisi,Great Britain,0,1,0,1,1984
Refik Memišević,Yugoslavia,0,1,0,1,1984
Merlene Ottey-Page,Slovenia,0,0,2,2,1984
Emir Mutapčić,Yugoslavia,0,0,1,1,1984
Mihovil Nakić-Vojnović,Yugoslavia,0,0,1,1,1984
Dražen Dalipagić,Yugoslavia,0,0,1,1,1984
Sabit Hadžić,Yugoslavia,0,0,1,1,1984
Andro Knego,Yugoslavia,0,0,1,1,1984
Aleksandar Petrović,Yugoslavia,0,0,1,1,1984
Dražen Petrović,Yugoslavia,0,0,1,1,1984
Ratko Radovanović,Yugoslavia,0,0,1,1,1984
Ivan Sunara,Yugoslavia,0,0,1,1,1984
Branko Vukičević,Yugoslavia,0,0,1,1,1984
Rajko Žižić,Yugoslavia,0,0,1,1,1984
Nebojša Zorkić,Yugoslavia,0,0,1,1,1984
Aziz Salihu,Yugoslavia,0,0,1,1,1984
Josefa Idem-Guerrini,West Germany,0,0,1,1,1984
Philippe Boccara,United States,0,0,1,1,1984
Bettina Overesch-Böker-Hoy,West Germany,0,0,1,1,1984
Fritz Ligges,West Germany,0,0,1,1,1984
Franke Sloothaak,West Germany,0,0,1,1,1984
Mirsad Baljić,Yugoslavia,0,0,1,1,1984
Mehmed Baždarević,Yugoslavia,0,0,1,1,1984
Borislav Cvetković,Yugoslavia,0,0,1,1,1984
Stjepan Deverić,Yugoslavia,0,0,1,1,1984
Milko Ǵurovski,Yugoslavia,0,0,1,1,1984
Marko Elsner,Yugoslavia,0,0,1,1,1984
Nenad Gračan,Yugoslavia,0,0,1,1,1984
Tomislav Ivković,Yugoslavia,0,0,1,1,1984
Srečko Katanec,Yugoslavia,0,0,1,1,1984
Branko Miljuš,Yugoslavia,0,0,1,1,1984
Mitar Mrkela,Yugoslavia,0,0,1,1,1984
Jovica Nikolić,Yugoslavia,0,0,1,1,1984
Ivan Pudar,Yugoslavia,0,0,1,1,1984
Ljubomir Radanović,Yugoslavia,0,0,1,1,1984
Admir Smajić,Yugoslavia,0,0,1,1,1984
Dragan Stojković,Yugoslavia,0,0,1,1,1984
Wang Mingxing,Singapore,0,0,1,1,1984
Zoran Pančić,Yugoslavia,0,0,1,1,1984
Milorad Stanulov,Yugoslavia,0,0,1,1,1984
Stefan Pfeiffer,West Germany,0,0,1,1,1984
Armando Fernández,West Germany,0,0,1,1,1984
Frank Otto,West Germany,0,0,1,1,1984
Hagen Stamm,West Germany,0,0,1,1,1984
Dirk Theismann,West Germany,0,0,1,1,1984
Manfred Nerlinger,West Germany,0,0,1,1,1984
Šaban Sejdi,Yugoslavia,0,0,1,1,1984
Jožef Tertei,Yugoslavia,0,0,1,1,1984
Hans Fogh,Denmark,0,0,1,1,1984
Vladimir Artyomov,Soviet Union,4,1,0,5,1988
Dmitry Bilozerchev,Soviet Union,3,0,1,4,1988
Valery Lyukin,Soviet Union,2,2,0,4,1988
Sviatlana Bahinskaya,Soviet Union,2,1,1,4,1988
Yelena Shushunova,Soviet Union,2,1,1,4,1988
Birgit Fischer-Schmidt,Germany,2,1,0,3,1988
Katrin Meißner,Germany,2,0,1,3,1988
Daniela Hunger,Germany,2,0,1,3,1988
Manuela Stellmach,Germany,2,0,1,3,1988
Anke Nothnagel-von Seck,Germany,2,0,0,2,1988
Victor Reneischi,Soviet Union,2,0,0,2,1988
Nicolae Juravschi,Romania,2,0,0,2,1988
Nicole Uphoff-Becker,West Germany,2,0,0,2,1988
Gintautas Umaras,Soviet Union,2,0,0,2,1988
Anja Fichtel-Mauritz,West Germany,2,0,0,2,1988
Sergey Kharkov,Soviet Union,2,0,0,2,1988
Olga Bryzgina,Ukraine,2,0,0,2,1988
Chen Jing,People's Republic of China,1,1,0,2,1988
Olaf Heukrodt,Germany,1,1,0,2,1988
Arnd Schmitt,West Germany,1,1,0,2,1988
Nino Salukvadze,Soviet Union,1,1,0,2,1988
Silvia Sperber,West Germany,1,1,0,2,1988
Tatsiana Ledauskaya,Soviet Union,1,1,0,2,1988
Sabine Bau,West Germany,1,1,0,2,1988
Igor Polyansky,Soviet Union,1,0,2,3,1988
Steffi Graf,West Germany,1,0,1,2,1988
Miloslav Mečíř,Slovakia,1,0,1,2,1988
Zita Funkenhauser,West Germany,1,0,1,2,1988
Aleksandr Romankov,Soviet Union,1,0,1,2,1988
Jasna Šekarić,Serbia,1,0,1,2,1988
Olga Nazarova,Soviet Union,1,0,1,2,1988
Tatyana Samolenko-Dorovskikh,Ukraine,1,0,1,2,1988
Seiko Iseki,People's Republic of China,1,0,0,1,1988
Valdemaras Chomičius,Soviet Union,1,0,0,1,1988
Andreas Zülow,Germany,1,0,0,1,1988
Viktor Pankrashkin,Soviet Union,1,0,0,1,1988
Aleksandr Belostenny,Ukraine,1,0,0,1,1988
Valery Goborov,Ukraine,1,0,0,1,1988
Rimas Kurtinaitis,Soviet Union,1,0,0,1,1988
Šarūnas Marčiulionis,Soviet Union,1,0,0,1,1988
Igors Miglinieks,Soviet Union,1,0,0,1,1988
Arvydas Sabonis,Soviet Union,1,0,0,1,1988
Tiit Sokk,Soviet Union,1,0,0,1,1988
Sergey Tarakanov,Soviet Union,1,0,0,1,1988
Valery Tikhonenko,Soviet Union,1,0,0,1,1988
Aleksandr Volkov,Ukraine,1,0,0,1,1988
Vyacheslav Yanovsky,Soviet Union,1,0,0,1,1988
Ramona Portwich,Germany,1,0,0,1,1988
Ivans Klementjevs,Soviet Union,1,0,0,1,1988
Monica Theodorescu,West Germany,1,0,0,1,1988
Matthias Baumann,West Germany,1,0,0,1,1988
Ludger Beerbaum,West Germany,1,0,0,1,1988
Ralf Ehrenbrink,West Germany,1,0,0,1,1988
Reiner Klimke,West Germany,1,0,0,1,1988
Franke Sloothaak,West Germany,1,0,0,1,1988
Erika Salumäe,Soviet Union,1,0,0,1,1988
Vyacheslav Yekimov,Soviet Union,1,0,0,1,1988
Artūras Kasputis,Soviet Union,1,0,0,1,1988
Aleksandr Kirichenko,Soviet Union,1,0,0,1,1988
Olaf Ludwig,Germany,1,0,0,1,1988
Dmitry Nelyubin,Soviet Union,1,0,0,1,1988
Mindaugas Umaras,Soviet Union,1,0,0,1,1988
Ilgar Mamedov,Soviet Union,1,0,0,1,1988
Vladimer Aptsiauri,Soviet Union,1,0,0,1,1988
Anvar Ibragimov,Soviet Union,1,0,0,1,1988
Boris Koretsky,Soviet Union,1,0,0,1,1988
Aleksandr Borodyuk,Soviet Union,1,0,0,1,1988
Igor Doborovolsky,Soviet Union,1,0,0,1,1988
Sergey Fokin,Soviet Union,1,0,0,1,1988
Sergey Gorlukovich,Soviet Union,1,0,0,1,1988
Arvydas Janonis,Soviet Union,1,0,0,1,1988
Yevgeny Yarovenko,Soviet Union,1,0,0,1,1988
Dmitry Kharin,Soviet Union,1,0,0,1,1988
Gela K'et'ashvili,Soviet Union,1,0,0,1,1988
Yevgeny Kuznetsov,Soviet Union,1,0,0,1,1988
Vladimir Lyuty,Ukraine,1,0,0,1,1988
Viktor Losev,Soviet Union,1,0,0,1,1988
Aleksey Mikhaylichenko,Ukraine,1,0,0,1,1988
Arminas Narbekovas,Soviet Union,1,0,0,1,1988
Igor Ponomaryov,Soviet Union,1,0,0,1,1988
Yury Savichev,Soviet Union,1,0,0,1,1988
Igor Sklyarov,Soviet Union,1,0,0,1,1988
Vladimir Tatarchuk,Soviet Union,1,0,0,1,1988
Aleksey Cherednik,Ukraine,1,0,0,1,1988
Svetlana Baitova,Soviet Union,1,0,0,1,1988
Natālija Laščonova,Soviet Union,1,0,0,1,1988
Marina Lobach,Soviet Union,1,0,0,1,1988
Yelena Shevchenko,Soviet Union,1,0,0,1,1988
Olga Strazheva,Ukraine,1,0,0,1,1988
Lado Gogoladze,Soviet Union,1,0,0,1,1988
Vladimir Novikov,Soviet Union,1,0,0,1,1988
Valery Gopin,Soviet Union,1,0,0,1,1988
Andrey Lavrov,Soviet Union,1,0,0,1,1988
Vyacheslav Atavin,Soviet Union,1,0,0,1,1988
Aleksandr Karshakevich,Soviet Union,1,0,0,1,1988
Yury Nesterov,Soviet Union,1,0,0,1,1988
Voldemaras Novickis,Soviet Union,1,0,0,1,1988
Aleksandr Rymanov,Soviet Union,1,0,0,1,1988
Konstantin Sharovarov,Soviet Union,1,0,0,1,1988
Yury Shevtsov,Soviet Union,1,0,0,1,1988
Georgy Sviridenko,Soviet Union,1,0,0,1,1988
Igor Chumak,Soviet Union,1,0,0,1,1988
Andrey Tyumentsev,Soviet Union,1,0,0,1,1988
Aleksandr Tuchkin,Soviet Union,1,0,0,1,1988
Mikhail Vasilyev,Soviet Union,1,0,0,1,1988
Jana Sorgers,Germany,1,0,0,1,1988
Kathrin Haacker,Germany,1,0,0,1,1988
Kristina Mundt,Germany,1,0,0,1,1988
Daniela Neunast,Germany,1,0,0,1,1988
Birgit Peter,Germany,1,0,0,1,1988
Beate Schramm,Germany,1,0,0,1,1988
Birte Siech,Germany,1,0,0,1,1988
Annegret Strauch,Germany,1,0,0,1,1988
Ute Schell-Wagner-Stange,Germany,1,0,0,1,1988
Judith Zeidler,Germany,1,0,0,1,1988
Ralf Brudel,Germany,1,0,0,1,1988
Armin Eichholz,West Germany,1,0,0,1,1988
Manfred Klein,West Germany,1,0,0,1,1988
Thomas Lange,Germany,1,0,0,1,1988
Wolfgang Maennig,West Germany,1,0,0,1,1988
Bahne Rabe,West Germany,1,0,0,1,1988
Hendrik Reiher,Germany,1,0,0,1,1988
Ansgar Wessling,West Germany,1,0,0,1,1988
Iryna Shylava,Soviet Union,1,0,0,1,1988
Axel Wegner,Germany,1,0,0,1,1988
Afanasijs Kuzmins,Soviet Union,1,0,0,1,1988
Miroslav Varga,Czechoslovakia,1,0,0,1,1988
Dmytro Monakov,Ukraine,1,0,0,1,1988
Goran Maksimović,Serbia,1,0,0,1,1988
Vladimir Salnikov,Soviet Union,1,0,0,1,1988
Marina Nikulina-Pankova,Soviet Union,1,0,0,1,1988
Valentina Ogiyenko,Soviet Union,1,0,0,1,1988
Svetlana Korytova,Soviet Union,1,0,0,1,1988
Tatyana Kraynova,Soviet Union,1,0,0,1,1988
Olga Krivosheyeva,Soviet Union,1,0,0,1,1988
Marina Kumysh,Soviet Union,1,0,0,1,1988
Jelena Ovchinnikova-Čebukina,Kazakhstan,1,0,0,1,1988
Irina Parkhomchuk,Soviet Union,1,0,0,1,1988
Tatyana Sidorenko,Soviet Union,1,0,0,1,1988
Irina Smirnova-Ilchenko,Soviet Union,1,0,0,1,1988
Yelena Volkova,Soviet Union,1,0,0,1,1988
Perica Bukić,Yugoslavia,1,0,0,1,1988
Dubravko Šimenc,Yugoslavia,1,0,0,1,1988
Dragan Andrić,Serbia,1,0,0,1,1988
Mislav Bezmalinović,Yugoslavia,1,0,0,1,1988
Veselin Đuho,Yugoslavia,1,0,0,1,1988
Igor Gočanin,Yugoslavia,1,0,0,1,1988
Deni Lušić,Yugoslavia,1,0,0,1,1988
Igor Milanović,Serbia and Montenegro,1,0,0,1,1988
Tomislav Paškvalin,Yugoslavia,1,0,0,1,1988
Renco Posinković,Yugoslavia,1,0,0,1,1988
Goran Rađenović,Yugoslavia,1,0,0,1,1988
Aleksandar Šoštar,Serbia and Montenegro,1,0,0,1,1988
Mirko Vičević,Serbia and Montenegro,1,0,0,1,1988
Anatoly Khrapaty,Soviet Union,1,0,0,1,1988
Israil Arsamakov,Soviet Union,1,0,0,1,1988
Aliaksandr Kurlovich,Soviet Union,1,0,0,1,1988
Pavel Kuznetsov,Soviet Union,1,0,0,1,1988
Oksen Mirzoyan,Soviet Union,1,0,0,1,1988
Yury Zakharevich,Soviet Union,1,0,0,1,1988
Kamandar Madzhydau,Soviet Union,1,0,0,1,1988
Makharbek Khadartsev,Soviet Union,1,0,0,1,1988
Aleksandr Karelin,Soviet Union,1,0,0,1,1988
Sergey Beloglazov,Soviet Union,1,0,0,1,1988
Levon Julfalakyan,Soviet Union,1,0,0,1,1988
Davit Gobejishvili,Soviet Union,1,0,0,1,1988
Mikhail Mamiashvili,Soviet Union,1,0,0,1,1988
Arsen Fadzayev,Soviet Union,1,0,0,1,1988
Thomas Flach,Germany,1,0,0,1,1988
Bernd Jäkel,Germany,1,0,0,1,1988
Jochen Schümann,Germany,1,0,0,1,1988
Petra Meier-Felke,Germany,1,0,0,1,1988
Sigrun Wodars-Grau,Germany,1,0,0,1,1988
Martina Hellmann,Germany,1,0,0,1,1988
Jürgen Schult,Germany,1,0,0,1,1988
Ulf Timmermann,Germany,1,0,0,1,1988
Vitaly Savin,Soviet Union,1,0,0,1,1988
Jozef Pribilinec,Slovakia,1,0,0,1,1988
Olga Bondarenko,Soviet Union,1,0,0,1,1988
Lyudmila Dzhigalova,Ukraine,1,0,0,1,1988
Mariya Pinigina,Soviet Union,1,0,0,1,1988
Nataliya Lisovskaya,Soviet Union,1,0,0,1,1988
Gennady Avdeyenko,Ukraine,1,0,0,1,1988
Viktor Bryzgin,Ukraine,1,0,0,1,1988
Sergey Bubka,Ukraine,1,0,0,1,1988
Vyacheslav Ivanenko,Soviet Union,1,0,0,1,1988
Vladimir Krylov,Soviet Union,1,0,0,1,1988
Sergey Litvinov,Soviet Union,1,0,0,1,1988
Vladimir Muravyov,Soviet Union,1,0,0,1,1988
Viktor Denisov,Soviet Union,0,2,0,2,1988
Igor Nagayev,Ukraine,0,2,0,2,1988
Sylvio Kroll,Germany,0,2,0,2,1988
Ronald Weigel,Germany,0,2,0,2,1988
Sven Tippelt,Germany,0,1,2,3,1988
Gennady Prigoda,Soviet Union,0,1,2,3,1988
Heike Drechsler,Germany,0,1,2,3,1988
Stefan Pfeiffer,West Germany,0,1,1,2,1988
Steffen Zesner,Germany,0,1,1,2,1988
Nikolay Yevseyev,Soviet Union,0,1,1,2,1988
Zoran Primorac,Yugoslavia,0,1,0,1,1988
Jana Novotná,Czechoslovakia,0,1,0,1,1988
Helena Suková,Czechoslovakia,0,1,0,1,1988
Ilija Lupulesku,Serbia,0,1,0,1,1988
Andreas Tews,Germany,0,1,0,1,1988
Anđelija Arbutina,Yugoslavia,0,1,0,1,1988
Vesna Bajkuša,Yugoslavia,0,1,0,1,1988
Polona Dornik,Yugoslavia,0,1,0,1,1988
Slađana Golić,Yugoslavia,0,1,0,1,1988
Kornelija Kvesić,Yugoslavia,0,1,0,1,1988
Mara Lakić,Yugoslavia,0,1,0,1,1988
Žana Lelas,Yugoslavia,0,1,0,1,1988
Bojana Milošević,Yugoslavia,0,1,0,1,1988
Razija Mujanović,Yugoslavia,0,1,0,1,1988
Danira Nakić,Yugoslavia,0,1,0,1,1988
Stojna Vangelovska,Yugoslavia,0,1,0,1,1988
Eleonora Vild,Yugoslavia,0,1,0,1,1988
Franjo Arapović,Yugoslavia,0,1,0,1,1988
Zoran Čutura,Yugoslavia,0,1,0,1,1988
Danko Cvjetićanin,Yugoslavia,0,1,0,1,1988
Vlade Divac,Serbia and Montenegro,0,1,0,1,1988
Toni Kukoč,Yugoslavia,0,1,0,1,1988
Željko Obradović,Serbia and Montenegro,0,1,0,1,1988
Žarko Paspalj,Serbia and Montenegro,0,1,0,1,1988
Dražen Petrović,Yugoslavia,0,1,0,1,1988
Dino Rađa,Yugoslavia,0,1,0,1,1988
Zdravko Radulović,Yugoslavia,0,1,0,1,1988
Stojko Vranković,Yugoslavia,0,1,0,1,1988
Jure Zdovc,Yugoslavia,0,1,0,1,1988
Nurmagomed Shanavazov,Soviet Union,0,1,0,1,1988
Ingo Spelly,Germany,0,1,0,1,1988
Michał Śliwiński,Soviet Union,0,1,0,1,1988
Sergey Kirsanov,Ukraine,0,1,0,1,1988
Aleksandr Motuzenko,Ukraine,0,1,0,1,1988
Jutta Niehaus,West Germany,0,1,0,1,1988
Nikolay Kovsh,Soviet Union,0,1,0,1,1988
Carsten Fischer,West Germany,0,1,0,1,1988
Volker Fried,West Germany,0,1,0,1,1988
Michael Hilgers,West Germany,0,1,0,1,1988
Andreas Keller,West Germany,0,1,0,1,1988
Michael Metz,West Germany,0,1,0,1,1988
Elmar Borrmann,West Germany,0,1,0,1,1988
Ulrich Schreck,West Germany,0,1,0,1,1988
Udo Wagner,Germany,0,1,0,1,1988
Thorsten Weidner,West Germany,0,1,0,1,1988
Andrey Alshan,Soviet Union,0,1,0,1,1988
Mikhail Burtsev,Soviet Union,0,1,0,1,1988
Sergey Koryazhkin,Soviet Union,0,1,0,1,1988
Sergey Mindirgasov,Soviet Union,0,1,0,1,1988
Georgy Pogosov,Ukraine,0,1,0,1,1988
Ralf Büchner,Germany,0,1,0,1,1988
Andreas Wecker,Germany,0,1,0,1,1988
Vladimir Shestakov,Soviet Union,0,1,0,1,1988
Henry Stöhr,Germany,0,1,0,1,1988
Detlef Kirchhoff,Germany,0,1,0,1,1988
Aleksandr Lukyanov,Soviet Union,0,1,0,1,1988
Inna Frolova,Ukraine,0,1,0,1,1988
Svitlana Maziy,Ukraine,0,1,0,1,1988
Irina Kalimbet,Ukraine,0,1,0,1,1988
Antonina Makhina-Dumcheva-Zelikovich,Soviet Union,0,1,0,1,1988
Veniamin But,Soviet Union,0,1,0,1,1988
Viktor Diduk,Soviet Union,0,1,0,1,1988
Aleksandr Dumchev,Soviet Union,0,1,0,1,1988
Pavel Gurkovsky,Ukraine,0,1,0,1,1988
Nikolay Komarov,Ukraine,0,1,0,1,1988
Viktor Omelyanovich,Ukraine,0,1,0,1,1988
Vasily Tikhonov,Soviet Union,0,1,0,1,1988
Andrey Vasilyev,Soviet Union,0,1,0,1,1988
Ralf Schumann,Germany,0,1,0,1,1988
Miloslav Bednařík,Czechoslovakia,0,1,0,1,1988
Patrick Kühl,Germany,0,1,0,1,1988
Raimundas Mažuolis,Soviet Union,0,1,0,1,1988
Yelena Dendeberova,Soviet Union,0,1,0,1,1988
Iurie Başcatov,Soviet Union,0,1,0,1,1988
Aleksey Borislavsky,Ukraine,0,1,0,1,1988
Vladimir Tkachenko,Ukraine,0,1,0,1,1988
Yaroslav Antonov,Soviet Union,0,1,0,1,1988
Yevgeny Krasilnikov,Soviet Union,0,1,0,1,1988
Andrey Kuznetsov,Soviet Union,0,1,0,1,1988
Valery Losev,Soviet Union,0,1,0,1,1988
Yury Panchenko,Ukraine,0,1,0,1,1988
Igor Runov,Soviet Union,0,1,0,1,1988
Yury Sapega,Soviet Union,0,1,0,1,1988
Vladimir Shkurikhin,Soviet Union,0,1,0,1,1988
Aleksandr Sorokolet,Ukraine,0,1,0,1,1988
Yury Cherednik,Soviet Union,0,1,0,1,1988
Raimonds Vilde,Soviet Union,0,1,0,1,1988
Vyacheslav Zaytsev,Soviet Union,0,1,0,1,1988
Israel Militosyan,Soviet Union,0,1,0,1,1988
Manfred Nerlinger,West Germany,0,1,0,1,1988
Ingo Steinhöfel,Germany,0,1,0,1,1988
Nail Mukhamedyarov,Uzbekistan,0,1,0,1,1988
Daulet Turlykhanov,Soviet Union,0,1,0,1,1988
Šaban Trstena,Yugoslavia,0,1,0,1,1988
Leri Khabelovi,Russian Federation,0,1,0,1,1988
Stepan Sargsyan,Soviet Union,0,1,0,1,1988
Adlan Varayev,Soviet Union,0,1,0,1,1988
Toomas Tõniste,Soviet Union,0,1,0,1,1988
Tõnu Tõniste,Soviet Union,0,1,0,1,1988
Jan Železný,Czechoslovakia,0,1,0,1,1988
Torsten Voss,Germany,0,1,0,1,1988
Kathrin Neimke,Germany,0,1,0,1,1988
Christine Wachtel,Germany,0,1,0,1,1988
Dieter Baumann,West Germany,0,1,0,1,1988
Romas Ubartas,Soviet Union,0,1,0,1,1988
Laimutė Baikauskaitė,Soviet Union,0,1,0,1,1988
Rodion Gataullin,Soviet Union,0,1,0,1,1988
Igor Lapshin,Soviet Union,0,1,0,1,1988
Christa Rothenburger-Luding,Germany,0,1,0,1,1988
André Wohllebe,Germany,0,0,2,2,1988
Andrey Shuvalov,Soviet Union,0,0,2,2,1988
Vadim Yaroshchuk,Ukraine,0,0,2,2,1988
Dmitry Volkov,Soviet Union,0,0,2,2,1988
Vladimir Yesheyev,Soviet Union,0,0,1,1,1988
Manuela Maleeva-Fragnière,Switzerland,0,0,1,1,1988
Milan Šrejber,Czechoslovakia,0,0,1,1,1988
Jasna Fazlić-Reed,United States,0,0,1,1,1988
Gordana Perkučin,Serbia,0,0,1,1,1988
Olesya Barel,Soviet Union,0,0,1,1,1988
Olga Buryakina,Soviet Union,0,0,1,1,1988
Irina Gerlits,Soviet Union,0,0,1,1,1988
Olga Yakovleva,Soviet Union,0,0,1,1,1988
Olga Yevkova,Soviet Union,0,0,1,1,1988
Yelena Khudashova,Soviet Union,0,0,1,1,1988
Aleksandra Leonova,Soviet Union,0,0,1,1,1988
Irina Minkh,Soviet Union,0,0,1,1,1988
Galina Savitskaya,Soviet Union,0,0,1,1,1988
Irina Sumnikova,Soviet Union,0,0,1,1,1988
Vitalija Tuomaitė,Soviet Union,0,0,1,1,1988
Nataliya Zasulskaya,Soviet Union,0,0,1,1,1988
Alex Miroshnichenko,Soviet Union,0,0,1,1,1988
Timofei Scriabin,Soviet Union,0,0,1,1,1988
Damir Škaro,Yugoslavia,0,0,1,1,1988
Martin Marinov,Bulgaria,0,0,1,1,1988
Kay Bluhm,Germany,0,0,1,1,1988
Anna Cox-Wood,Netherlands,0,0,1,1,1988
Laima Zilporytė,Soviet Union,0,0,1,1,1988
Bernd Dittert,Germany,0,0,1,1,1988
Marat Ganeyev,Soviet Union,0,0,1,1,1988
Wladimir Reznitschenko,Kazakhstan,0,0,1,1,1988
Pavel Kolobkov,Soviet Union,0,0,1,1,1988
Igor Tikhomirov,Russian Federation,0,0,1,1,1988
Mikhail Tishko,Ukraine,0,0,1,1,1988
Aleksandra Timoshenko,Ukraine,0,0,1,1,1988
Natalia Rusnatschenko,Soviet Union,0,0,1,1,1988
Alvaro Načinović,Yugoslavia,0,0,1,1,1988
Goran Perkovac,Yugoslavia,0,0,1,1,1988
Iztok Puc,Slovenia,0,0,1,1,1988
Zlatan Saračević,Yugoslavia,0,0,1,1,1988
Nataliya Anisimova,Soviet Union,0,0,1,1,1988
Marina Bazanova,Unified Team,0,0,1,1,1988
Tatjana Dschandschgawa,Russian Federation,0,0,1,1,1988
Tatyana Gorb,Ukraine,0,0,1,1,1988
Elina Guseva,Soviet Union,0,0,1,1,1988
Larisa Karlova,Ukraine,0,0,1,1,1988
Nataliya Lapitskaya,Soviet Union,0,0,1,1,1988
Svetlana Mankova,Ukraine,0,0,1,1,1988
Nataliya Mitryuk,Ukraine,0,0,1,1,1988
Nataliya Morskova,Soviet Union,0,0,1,1,1988
Yelena Nemashkalo,Ukraine,0,0,1,1,1988
Olga Semyonova,Ukraine,0,0,1,1,1988
Yevgeniya Tovstogan,Ukraine,0,0,1,1,1988
Zinaida Turchina,Ukraine,0,0,1,1,1988
Mirko Bašić,Yugoslavia,0,0,1,1,1988
Jožef Holpert,Yugoslavia,0,0,1,1,1988
Boris Jarak,Yugoslavia,0,0,1,1,1988
Slobodan Kuzmanovski,Yugoslavia,0,0,1,1,1988
Muhamed Memić,Yugoslavia,0,0,1,1,1988
Zlatko Portner,Yugoslavia,0,0,1,1,1988
Rolando Pušnik,Yugoslavia,0,0,1,1,1988
Momir Rnić,Yugoslavia,0,0,1,1,1988
Irfan Smajlagić,Yugoslavia,0,0,1,1,1988
Ermin Velić,Yugoslavia,0,0,1,1,1988
Veselin Vujović,Serbia,0,0,1,1,1988
Giorgi Tenadze,Soviet Union,0,0,1,1,1988
Amiran T'ot'ik'ashvili,Soviet Union,0,0,1,1,1988
Bashir Varayev,Soviet Union,0,0,1,1,1988
Grigory Verichev,Soviet Union,0,0,1,1,1988
Vaho Iagorashvili,Soviet Union,0,0,1,1,1988
Jens Köppen,Germany,0,0,1,1,1988
Sadik Mujkič,Yugoslavia,0,0,1,1,1988
Oleksandr Marchenko,Ukraine,0,0,1,1,1988
Vasily Yakusha,Soviet Union,0,0,1,1,1988
Bojan Prešern,Yugoslavia,0,0,1,1,1988
Ihar Basinski,Soviet Union,0,0,1,1,1988
Hans Riederer,West Germany,0,0,1,1,1988
Marina Dobrancheva-Logvinenko,Soviet Union,0,0,1,1,1988
Anna Malukhina,Soviet Union,0,0,1,1,1988
Hennadiy Avramenko,Ukraine,0,0,1,1,1988
Valentina Cherkasova,Soviet Union,0,0,1,1,1988
Kirill Ivanov,Soviet Union,0,0,1,1,1988
Dirk Richter,Germany,0,0,1,1,1988
Peter Sitt,West Germany,0,0,1,1,1988
Valery Lozik,Ukraine,0,0,1,1,1988
Konstantin Petrov,Soviet Union,0,0,1,1,1988
Sergey Zabolotnov,Uzbekistan,0,0,1,1,1988
Jon Emili Uriarte,Australia,0,0,1,1,1988
Dmitry Apanasenko,Soviet Union,0,0,1,1,1988
Viktor Berendyuga,Ukraine,0,0,1,1,1988
Mikheil Giorgadze,Soviet Union,0,0,1,1,1988
Yevgeny Grishin,Soviet Union,0,0,1,1,1988
Mikhail Ivanov,Soviet Union,0,0,1,1,1988
Aleksandr Kolotov,Soviet Union,0,0,1,1,1988
Sergey Kotenko,Soviet Union,0,0,1,1,1988
Serghei Marcoci,Soviet Union,0,0,1,1,1988
Nurlan Mendygaliyev,Soviet Union,0,0,1,1,1988
Giorgi Mshvenieradze,Soviet Union,0,0,1,1,1988
Sergey Naumov,Soviet Union,0,0,1,1,1988
Yevgeny Sharonov,Soviet Union,0,0,1,1,1988
Nikolay Smirnov,Ukraine,0,0,1,1,1988
Ronny Weller,Germany,0,0,1,1,1988
Martin Zawieja,West Germany,0,0,1,1,1988
Andreas Schröder,Germany,0,0,1,1,1988
Jozef Lohyňa,Slovakia,0,0,1,1,1988
Volodymyr Tohuzov,Ukraine,0,0,1,1,1988
Sergey Karamchakov,Soviet Union,0,0,1,1,1988
Vladimir Popov,Soviet Union,0,0,1,1,1988
Larisa Moskalenko,Ukraine,0,0,1,1,1988
Irina Chunikhovskaya,Ukraine,0,0,1,1,1988
Jüri Tamm,Soviet Union,0,0,1,1,1988
Grit Breuer,Germany,0,0,1,1,1988
Katrin Dörre-Heinig,Germany,0,0,1,1,1988
Hartwig Gauder,Germany,0,0,1,1,1988
Jens-Peter Herold,Germany,0,0,1,1,1988
Jörg Vaihinger,West Germany,0,0,1,1,1988
Galina Malchugina,Soviet Union,0,0,1,1,1988
Tamara Bykova,Soviet Union,0,0,1,1,1988
Galina Čisťakovová,Soviet Union,0,0,1,1,1988
Lyudmila Kondratyeva,Soviet Union,0,0,1,1,1988
Nataliya Pomoshchnikova-Voronova,Soviet Union,0,0,1,1,1988
Marina Zhirova,Soviet Union,0,0,1,1,1988
Yelena Zhupiyeva-Vyazova,Ukraine,0,0,1,1,1988
Grigory Yegorov,Soviet Union,0,0,1,1,1988
Aleksandr Kovalenko,Soviet Union,0,0,1,1,1988
Rudolf Povarnitsyn,Ukraine,0,0,1,1,1988
Vitali Shcherba,Unified Team,6,0,0,6,1992
Yevgeny Sadovy,Unified Team,3,0,0,3,1992
Aleksandr Popov,Unified Team,2,2,0,4,1992
Tatyana Gutsu,Unified Team,2,1,1,4,1992
Tatyana Lysenko,Unified Team,2,0,1,3,1992
Kay Bluhm,Germany,2,0,0,2,1992
Nicole Uphoff-Becker,West Germany,2,0,0,2,1992
Marina Dobrancheva-Logvinenko,Soviet Union,2,0,0,2,1992
Hryhoriy Misiutin,Unified Team,1,4,0,5,1992
Vlad Pyshnenko,Unified Team,1,2,0,3,1992
Anke Nothnagel-von Seck,Germany,1,1,0,2,1992
Ramona Portwich,Germany,1,1,0,2,1992
Birgit Fischer-Schmidt,Germany,1,1,0,2,1992
Ingo Spelly,Germany,1,1,0,2,1992
Veniamin Tayanovich,Unified Team,1,1,0,2,1992
Olga Bryzgina,Ukraine,1,1,0,2,1992
Liliya Nurutdinova,Unified Team,1,1,0,2,1992
Ihor Korobchinskyi,Unified Team,1,0,1,2,1992
Valeri Belenki,Germany,1,0,1,2,1992
Alena Rudkouskaya,Unified Team,1,0,1,2,1992
Gigi Fernandez,United States,1,0,0,1,1992
Andreas Tews,Germany,1,0,0,1,1992
Svetlana Antipova-Zaboluyeva,Unified Team,1,0,0,1,1992
Yelena Baranova,Unified Team,1,0,0,1,1992
Elen Bunatyants-Shakirova,Unified Team,1,0,0,1,1992
Irina Gerlits,Soviet Union,1,0,0,1,1992
Yelena Khudashova,Soviet Union,1,0,0,1,1992
Irina Minkh,Soviet Union,1,0,0,1,1992
Yelena Shvaybovich,Unified Team,1,0,0,1,1992
Irina Sumnikova,Soviet Union,1,0,0,1,1992
Maryna Tkachenko,Unified Team,1,0,0,1,1992
Yelena Tornikidu,Uzbekistan,1,0,0,1,1992
Nataliya Zasulskaya,Soviet Union,1,0,0,1,1992
Olena Zhyrko,Unified Team,1,0,0,1,1992
Dzmitry Douhalionok,Unified Team,1,0,0,1,1992
Aliaksandr Masiaikou,Unified Team,1,0,0,1,1992
Lukáš Pollert,Czechoslovakia,1,0,0,1,1992
Oliver Kegel,West Germany,1,0,0,1,1992
Thomas Reineck,West Germany,1,0,0,1,1992
André Wohllebe,Germany,1,0,0,1,1992
Monica Theodorescu,West Germany,1,0,0,1,1992
Ludger Beerbaum,West Germany,1,0,0,1,1992
Jos Lansink,Netherlands,1,0,0,1,1992
Petra Roßner,Germany,1,0,0,1,1992
Erika Salumäe,Soviet Union,1,0,0,1,1992
Bernd Dittert,Germany,1,0,0,1,1992
Michael Rich,West Germany,1,0,0,1,1992
Carsten Fischer,West Germany,1,0,0,1,1992
Volker Fried,West Germany,1,0,0,1,1992
Michael Hilgers,West Germany,1,0,0,1,1992
Andreas Keller,West Germany,1,0,0,1,1992
Michael Metz,West Germany,1,0,0,1,1992
Elmar Borrmann,West Germany,1,0,0,1,1992
Uwe Proske,Germany,1,0,0,1,1992
Wladimir Reznitschenko,Kazakhstan,1,0,0,1,1992
Arnd Schmitt,West Germany,1,0,0,1,1992
Ulrich Schreck,West Germany,1,0,0,1,1992
Udo Wagner,Germany,1,0,0,1,1992
Thorsten Weidner,West Germany,1,0,0,1,1992
Grigory Kiriyenko,Unified Team,1,0,0,1,1992
Stanislav Pozdnyakov,Unified Team,1,0,0,1,1992
Aleksandr Shirshov,Unified Team,1,0,0,1,1992
Vadym Huttsait,Unified Team,1,0,0,1,1992
Georgy Pogosov,Ukraine,1,0,0,1,1992
Sviatlana Bahinskaya,Soviet Union,1,0,0,1,1992
Roza Galiyeva,Unified Team,1,0,0,1,1992
Yelena Grudneva,Unified Team,1,0,0,1,1992
Aleksandra Timoshenko,Ukraine,1,0,0,1,1992
Oksana Chusovitina,Unified Team,1,0,0,1,1992
Aleksey Voropayev,Unified Team,1,0,0,1,1992
Rustam Sharipov,Unified Team,1,0,0,1,1992
Talant Duyshebayev,Russian Federation,1,0,0,1,1992
Valery Gopin,Soviet Union,1,0,0,1,1992
Oleg Grebnev,Unified Team,1,0,0,1,1992
Oleg Kiselyov,Unified Team,1,0,0,1,1992
Vasily Kudinov,Unified Team,1,0,0,1,1992
Andrey Lavrov,Soviet Union,1,0,0,1,1992
Andrey Barbashinsky,Unified Team,1,0,0,1,1992
Sergey Bebeshko,Unified Team,1,0,0,1,1992
Yury Gavrilov,Unified Team,1,0,0,1,1992
Mikhail Yakimovich,Unified Team,1,0,0,1,1992
Igor Chumak,Soviet Union,1,0,0,1,1992
Igor Vasilyev,Unified Team,1,0,0,1,1992
Nazim Hüseynov,Unified Team,1,0,0,1,1992
Davit Khakhaleishvili,Unified Team,1,0,0,1,1992
Kristina Mundt,Germany,1,0,0,1,1992
Birgit Peter,Germany,1,0,0,1,1992
Thomas Lange,Germany,1,0,0,1,1992
Hrachya Petikyan,Soviet Union,1,0,0,1,1992
Kanstantsin Lukaschyk,Unified Team,1,0,0,1,1992
Ralf Schumann,Germany,1,0,0,1,1992
Petr Hrdlička,Czechoslovakia,1,0,0,1,1992
Yury Fedkin,Unified Team,1,0,0,1,1992
Aleksey Kudryavtsev,Unified Team,1,0,0,1,1992
Dmitry Lepikov,Unified Team,1,0,0,1,1992
Yury Mukhin,Unified Team,1,0,0,1,1992
Israel Militosyan,Soviet Union,1,0,0,1,1992
Ronny Weller,Germany,1,0,0,1,1992
Akakios Kakiasvili,Greece,1,0,0,1,1992
Tudor Casapu,Unified Team,1,0,0,1,1992
Aliaksandr Kurlovich,Soviet Union,1,0,0,1,1992
Viktor Tregubov,Unified Team,1,0,0,1,1992
Maik Bullmann,Germany,1,0,0,1,1992
Oleg Kutscherenko,Ukraine,1,0,0,1,1992
Mnatsakan Iskandaryan,Russian Federation,1,0,0,1,1992
Leri Khabelovi,Russian Federation,1,0,0,1,1992
Makharbek Khadartsev,Soviet Union,1,0,0,1,1992
Aleksandr Karelin,Soviet Union,1,0,0,1,1992
Arsen Fadzayev,Soviet Union,1,0,0,1,1992
Mark McKoy,Canada,1,0,0,1,1992
Chen Yueling,United States,1,0,0,1,1992
Jan Železný,Czechoslovakia,1,0,0,1,1992
Robert Změlík,Czechoslovakia,1,0,0,1,1992
Heike Drechsler,Germany,1,0,0,1,1992
Heike Redetzky-Henkel,West Germany,1,0,0,1,1992
Silke Renk,Germany,1,0,0,1,1992
Dieter Baumann,West Germany,1,0,0,1,1992
Romas Ubartas,Soviet Union,1,0,0,1,1992
Valentina Yegorova,Unified Team,1,0,0,1,1992
Svetlana Krivelyova,Unified Team,1,0,0,1,1992
Yelena Romanova,Soviet Union,1,0,0,1,1992
Lyudmila Dzhigalova,Ukraine,1,0,0,1,1992
Olga Nazarova,Soviet Union,1,0,0,1,1992
Yelena Ruzina,Unified Team,1,0,0,1,1992
Marina Shmonina,Unified Team,1,0,0,1,1992
Andrey Abduvaliyev,Unified Team,1,0,0,1,1992
Andrey Perlov,Unified Team,1,0,0,1,1992
Maksim Tarasov,Unified Team,1,0,0,1,1992
Vladimir Selkov,Unified Team,0,2,0,2,1992
Pavlo Khnykin,Unified Team,0,2,0,2,1992
Andreas Wecker,Germany,0,1,2,3,1992
Daniela Hunger,Germany,0,1,2,3,1992
Herbert Blöcker,West Germany,0,1,1,2,1992
Pavel Kolobkov,Soviet Union,0,1,1,2,1992
Eduard Zenovka,Unified Team,0,1,1,2,1992
Irina Privalova,Unified Team,0,1,1,2,1992
Steffi Graf,West Germany,0,1,0,1,1992
Steffen Fetzner,West Germany,0,1,0,1,1992
Jörg Roßkopf,West Germany,0,1,0,1,1992
Jun Gao,United States,0,1,0,1,1992
Franjo Arapović,Yugoslavia,0,1,0,1,1992
Danko Cvjetićanin,Yugoslavia,0,1,0,1,1992
Toni Kukoč,Yugoslavia,0,1,0,1,1992
Dražen Petrović,Yugoslavia,0,1,0,1,1992
Dino Rađa,Yugoslavia,0,1,0,1,1992
Stojko Vranković,Yugoslavia,0,1,0,1,1992
Rostyslav Zaulychnyi,Unified Team,0,1,0,1,1992
Jiří Rohan,Czechoslovakia,0,1,0,1,1992
Miroslav Šimek,Czechoslovakia,0,1,0,1,1992
Christian Frederiksen,Norway,0,1,0,1,1992
Katrin Borchert,Germany,0,1,0,1,1992
Ivans Klementjevs,Soviet Union,0,1,0,1,1992
Michał Śliwiński,Soviet Union,0,1,0,1,1992
Lee Bodimeade,United States,0,1,0,1,1992
Christine Ferneck,West Germany,0,1,0,1,1992
Caren Jungjohann,West Germany,0,1,0,1,1992
Susanne Wollschläger,West Germany,0,1,0,1,1992
Anja Fichtel-Mauritz,West Germany,0,1,0,1,1992
Zita Funkenhauser,West Germany,0,1,0,1,1992
Monika Weber-Koszto,Romania,0,1,0,1,1992
Serhiy Holubytskyi,Unified Team,0,1,0,1,1992
Dmitry Svatkovsky,Unified Team,0,1,0,1,1992
Anatoly Starostin,Soviet Union,0,1,0,1,1992
"Václav Chalupa, Jr.",Czechoslovakia,0,1,0,1,1992
Inge Althoff-Schwerzmann,West Germany,0,1,0,1,1992
Ralf Brudel,Germany,0,1,0,1,1992
Hendrik Reiher,Germany,0,1,0,1,1992
Afanasijs Kuzmins,Soviet Union,0,1,0,1,1992
Anatoly Asrabayev,Unified Team,0,1,0,1,1992
Sergey Pyzhyanov,Soviet Union,0,1,0,1,1992
Jasna Šekarić,Serbia,0,1,0,1,1992
Irina Lashko,Russian Federation,0,1,0,1,1992
Vladislav Kulikov,Unified Team,0,1,0,1,1992
Yelena Miroshina,Soviet Union,0,1,0,1,1992
Iurie Başcatov,Soviet Union,0,1,0,1,1992
Vasily Ivanov,Unified Team,0,1,0,1,1992
Gennady Prigoda,Soviet Union,0,1,0,1,1992
Dmitry Volkov,Soviet Union,0,1,0,1,1992
Yevgeniya Artamonova-Estes,Unified Team,0,1,0,1,1992
Yelena Batukhtina-Tyurina,Unified Team,0,1,0,1,1992
Nataliya Morozova,Unified Team,0,1,0,1,1992
Marina Nikulina-Pankova,Soviet Union,0,1,0,1,1992
Valentina Ogiyenko,Soviet Union,0,1,0,1,1992
Svetlana Korytova,Soviet Union,0,1,0,1,1992
Jelena Ovchinnikova-Čebukina,Kazakhstan,0,1,0,1,1992
Irina Smirnova-Ilchenko,Soviet Union,0,1,0,1,1992
Nikolaj Pešalov,Croatia,0,1,0,1,1992
Sergey Syrtsov,Unified Team,0,1,0,1,1992
Tymur Taimazov,Unified Team,0,1,0,1,1992
Artur Akoyev,Unified Team,0,1,0,1,1992
Leonid Taranenko,Soviet Union,0,1,0,1,1992
Siarhei Smal,Unified Team,0,1,0,1,1992
Alfred Ter-Mkrtchyan,Germany,0,1,0,1,1992
Rifat Yildiz,West Germany,0,1,0,1,1992
Sergey Martynov,Unified Team,0,1,0,1,1992
İslam Duquçiyev,Russian Federation,0,1,0,1,1992
Elmadi Zhabrailov,Russian Federation,0,1,0,1,1992
Rod Davis,United States,0,1,0,1,1992
Natallia Shykalenka,Unified Team,0,1,0,1,1992
Ihar Astapkovich,Unified Team,0,1,0,1,1992
Alina Astafei,Romania,0,1,0,1,1992
Jürgen Schult,Germany,0,1,0,1,1992
Galina Malchugina,Soviet Union,0,1,0,1,1992
Yelena Nikolayeva,Unified Team,0,1,0,1,1992
Lyudmila Rogachova,Unified Team,0,1,0,1,1992
Marina Trandenkova,Unified Team,0,1,0,1,1992
Igor Trandenkov,Unified Team,0,1,0,1,1992
Inesa Kravets,Ukraine,0,1,0,1,1992
Irina Belova,Unified Team,0,1,0,1,1992
Olga Bogoslovskaya,Unified Team,0,1,0,1,1992
Tatyana Samolenko-Dorovskikh,Ukraine,0,1,0,1,1992
Sandra Farmer-Patrick,United States,0,1,0,1,1992
Sabine Bau,West Germany,0,1,0,1,1992
Aleksandr Popov,Unified Team,2,2,0,4,1996
Denis Pankratov,Unified Team,2,1,0,3,1996
Uli Kirchhoff,Ukraine,2,0,0,2,1996
Stanislav Pozdnyakov,Unified Team,2,0,0,2,1996
Ramona Portwich,Germany,1,1,0,2,1996
Birgit Fischer-Schmidt,Germany,1,1,0,2,1996
Kay Bluhm,Germany,1,1,0,2,1996
Rustam Sharipov,Unified Team,1,0,1,2,1996
Aleksandra Ivošev,Serbia,1,0,1,2,1996
Gigi Fernandez,United States,1,0,0,1,1996
Štěpánka Hilgertová,Czechoslovakia,1,0,0,1,1996
Thomas Reineck,West Germany,1,0,0,1,1996
Monica Theodorescu,West Germany,1,0,0,1,1996
Ludger Beerbaum,West Germany,1,0,0,1,1996
Phillip Dutton,United States,1,0,0,1,1996
Franke Sloothaak,West Germany,1,0,0,1,1996
Zulfiya Zabirova,Russian Federation,1,0,0,1,1996
Alyson Annan,Netherlands,1,0,0,1,1996
Grigory Kiriyenko,Unified Team,1,0,0,1,1996
Ilgar Mamedov,Soviet Union,1,0,0,1,1996
Dmitry Shevchenko,Unified Team,1,0,0,1,1996
Andreas Wecker,Germany,1,0,0,1,1996
Sergey Kharkov,Soviet Union,1,0,0,1,1996
Aleksey Voropayev,Unified Team,1,0,0,1,1996
Alvaro Načinović,Yugoslavia,1,0,0,1,1996
Goran Perkovac,Yugoslavia,1,0,0,1,1996
Iztok Puc,Slovenia,1,0,0,1,1996
Zlatan Saračević,Yugoslavia,1,0,0,1,1996
Irfan Smajlagić,Yugoslavia,1,0,0,1,1996
Udo Quellmalz,Germany,1,0,0,1,1996
Alex Parygin,Kazakhstan,1,0,0,1,1996
Katsiaryna Khadatovich-Karsten,Unified Team,1,0,0,1,1996
Jana Sorgers,Germany,1,0,0,1,1996
Ralf Schumann,Germany,1,0,0,1,1996
Boris Kokorev,Soviet Union,1,0,0,1,1996
Dmitry Sautin,Unified Team,1,0,0,1,1996
Akakios Kakiasvili,Greece,1,0,0,1,1996
Tymur Taimazov,Unified Team,1,0,0,1,1996
Armen Nazaryan,Bulgaria,1,0,0,1,1996
Aleksandr Karelin,Soviet Union,1,0,0,1,1996
Thomas Flach,Germany,1,0,0,1,1996
Bernd Jäkel,Germany,1,0,0,1,1996
Jochen Schümann,Germany,1,0,0,1,1996
Jan Železný,Czechoslovakia,1,0,0,1,1996
Yelena Nikolayeva,Unified Team,1,0,0,1,1996
Ludmila Narozhilenko-Engquist,Soviet Union,1,0,0,1,1996
Inesa Kravets,Ukraine,1,0,0,1,1996
Merlene Ottey-Page,Slovenia,0,2,1,3,1996
Jana Novotná,Czechoslovakia,0,1,1,2,1996
Marina Dobrancheva-Logvinenko,Soviet Union,0,1,1,2,1996
Vladislav Kulikov,Unified Team,0,1,1,2,1996
Mia Audina,Netherlands,0,1,0,1,1996
Chen Jing,People's Republic of China,0,1,0,1,1996
David Defiagbon,Nigeria,0,1,0,1,1996
Helena Suková,Czechoslovakia,0,1,0,1,1996
Miroslav Berić,Serbia and Montenegro,0,1,0,1,1996
Dejan Bodiroga,Serbia and Montenegro,0,1,0,1,1996
Predrag Danilović,Serbia and Montenegro,0,1,0,1,1996
Vlade Divac,Serbia and Montenegro,0,1,0,1,1996
Saša Đorđević,Serbia and Montenegro,0,1,0,1,1996
Nikola Lončar,Serbia and Montenegro,0,1,0,1,1996
Saša Obradović,Serbia and Montenegro,0,1,0,1,1996
Žarko Paspalj,Serbia and Montenegro,0,1,0,1,1996
Zelly Rebrača,Serbia and Montenegro,0,1,0,1,1996
Zoran Savić,Serbia and Montenegro,0,1,0,1,1996
Dejan Tomašević,Serbia and Montenegro,0,1,0,1,1996
Milenko Topić,Serbia and Montenegro,0,1,0,1,1996
Lukáš Pollert,Czechoslovakia,0,1,0,1,1996
Jiří Rohan,Czechoslovakia,0,1,0,1,1996
Miroslav Šimek,Czechoslovakia,0,1,0,1,1996
Ivans Klementjevs,Soviet Union,0,1,0,1,1996
Slavomír Kňazovický,Slovakia,0,1,0,1,1996
Victor Reneischi,Soviet Union,0,1,0,1,1996
Nicolae Juravschi,Romania,0,1,0,1,1996
Nikolay Kuznetsov,Unified Team,0,1,0,1,1996
Pavel Kolobkov,Soviet Union,0,1,0,1,1996
Valery Zakharevich,Unified Team,0,1,0,1,1996
Roza Galiyeva,Unified Team,0,1,0,1,1996
Yevgeniya Kuznetsova,Russian Federation,0,1,0,1,1996
Eduard Zenovka,Unified Team,0,1,0,1,1996
Roland Baar,West Germany,0,1,0,1,1996
Detlef Kirchhoff,Germany,0,1,0,1,1996
Inna Frolova,Ukraine,0,1,0,1,1996
Svitlana Maziy,Ukraine,0,1,0,1,1996
Olena Ronzhyna-Morozova,Unified Team,0,1,0,1,1996
Ihar Basinski,Soviet Union,0,1,0,1,1996
Emil Milev,United States,0,1,0,1,1996
Jan Hempel,Germany,0,1,0,1,1996
Irina Lashko,Russian Federation,0,1,0,1,1996
Vlad Pyshnenko,Unified Team,0,1,0,1,1996
Vladimir Selkov,Unified Team,0,1,0,1,1996
Konstantin Ushkov,Russian Federation,0,1,0,1,1996
Perica Bukić,Yugoslavia,0,1,0,1,1996
Dubravko Šimenc,Yugoslavia,0,1,0,1,1996
Ronny Weller,Germany,0,1,0,1,1996
Anatoly Khrapaty,Soviet Union,0,1,0,1,1996
Sergey Syrtsov,Unified Team,0,1,0,1,1996
Makharbek Khadartsev,Soviet Union,0,1,0,1,1996
Mitch Booth,Netherlands,0,1,0,1,1996
Georgy Shayduko,Soviet Union,0,1,0,1,1996
Fiona May,Italy,0,1,0,1,1996
Valentina Yegorova,Unified Team,0,1,0,1,1996
Igor Trandenkov,Unified Team,0,1,0,1,1996
Mikhail Shchennikov,Soviet Union,0,1,0,1,1996
Birgit Fischer-Schmidt,Germany,2,0,0,2,2000
Dmitry Sautin,Unified Team,1,1,2,4,2000
Irina Privalova,Unified Team,1,0,1,2,2000
Aleksandr Lebzyak,Unified Team,1,0,0,1,2000
Štěpánka Hilgertová,Czechoslovakia,1,0,0,1,2000
Josefa Idem-Guerrini,West Germany,1,0,0,1,2000
Ludger Beerbaum,West Germany,1,0,0,1,2000
Phillip Dutton,United States,1,0,0,1,2000
Vyacheslav Yekimov,Soviet Union,1,0,0,1,2000
Alyson Annan,Netherlands,1,0,0,1,2000
Oksana Yermakova,Russian Federation,1,0,0,1,2000
Pavel Kolobkov,Soviet Union,1,0,0,1,2000
Stanislav Pozdnyakov,Unified Team,1,0,0,1,2000
Vasily Kudinov,Unified Team,1,0,0,1,2000
Andrey Lavrov,Soviet Union,1,0,0,1,2000
Aleksandr Tuchkin,Soviet Union,1,0,0,1,2000
Dmitry Svatkovsky,Unified Team,1,0,0,1,2000
Katsiaryna Khadatovich-Karsten,Unified Team,1,0,0,1,2000
Rajmond Debevec,Yugoslavia,1,0,0,1,2000
Vera Ilyina,Unified Team,1,0,0,1,2000
Vladimir Batez,Serbia and Montenegro,1,0,0,1,2000
Andrija Gerić,Serbia and Montenegro,1,0,0,1,2000
Nikola Grbić,Serbia and Montenegro,1,0,0,1,2000
Vladimir Grbić,Serbia and Montenegro,1,0,0,1,2000
Slobodan Kovač,Serbia and Montenegro,1,0,0,1,2000
Đula Mešter,Serbia and Montenegro,1,0,0,1,2000
Goran Vujević,Serbia and Montenegro,1,0,0,1,2000
Nikolaj Pešalov,Croatia,1,0,0,1,2000
Akakios Kakiasvili,Greece,1,0,0,1,2000
Armen Nazaryan,Bulgaria,1,0,0,1,2000
Sagid Murtazaliyev,Ukraine,1,0,0,1,2000
Jenny Armstrong,New Zealand,1,0,0,1,2000
Elina Zverava,Soviet Union,1,0,0,1,2000
Jan Železný,Czechoslovakia,1,0,0,1,2000
Heike Drechsler,Germany,1,0,0,1,2000
Tony Gunawan,United States,1,0,0,1,2000
Tai Agüero,Italy,1,0,0,1,2000
Slobodan Boškan,Serbia and Montenegro,1,0,0,1,2000
Vasa Mijić,Serbia and Montenegro,1,0,0,1,2000
Ivan Miljković,Serbia and Montenegro,1,0,0,1,2000
Igor Vušurović,Serbia and Montenegro,1,0,0,1,2000
David Musuľbes,Slovakia,1,0,0,1,2000
Martina Moravcová,Czechoslovakia,0,2,0,2,2000
Ihar Basinski,Soviet Union,0,1,1,2,2000
Merlene Ottey-Page,Slovenia,0,1,1,2,2000
Oleg Moldovan,Soviet Union,0,1,0,1,2000
Svetlana Dyomina,Soviet Union,0,1,0,1,2000
Petr Málek,Czechoslovakia,0,1,0,1,2000
Jasna Šekarić,Serbia,0,1,0,1,2000
Aleksandr Popov,Unified Team,0,1,0,1,2000
Yevgeniya Artamonova-Estes,Unified Team,0,1,0,1,2000
Yelena Batukhtina-Tyurina,Unified Team,0,1,0,1,2000
Nataliya Morozova,Unified Team,0,1,0,1,2000
Ruslan Olikhver,Unified Team,0,1,0,1,2000
Konstantin Ushakov,Unified Team,0,1,0,1,2000
Dmitry Gorshkov,Unified Team,0,1,0,1,2000
Nikolay Kozlov,Unified Team,0,1,0,1,2000
Nikolay Maksimov,Russian Federation,0,1,0,1,2000
Dmitry Stratan,Ukraine,0,1,0,1,2000
Ronny Weller,Germany,0,1,0,1,2000
Aleksandr Karelin,Soviet Union,0,1,0,1,2000
Jochen Schümann,Germany,0,1,0,1,2000
Mirela Maniani-Tzelili,Greece,0,1,0,1,2000
Fiona May,Italy,0,1,0,1,2000
Glory Alozie,Spain,0,1,0,1,2000
Arsen Gitinov,Russian Federation,0,1,0,1,2000
David Saldadze,Uzbekistan,0,1,0,1,2000
Natasa Dusev-Janics,Serbia and Montenegro,2,0,0,2,2004
Birgit Fischer-Schmidt,Germany,1,1,0,2,2004
Vyacheslav Yekimov,Soviet Union,1,0,0,1,2004
Oksana Yermakova,Russian Federation,1,0,0,1,2004
Ralf Schumann,Germany,1,0,0,1,2004
Aleksey Alipov,Russian Olympic Committee,1,0,0,1,2004
István Gergely,Slovakia,1,0,0,1,2004
Aleksandr Kostoglod,Unified Team,0,1,1,2,2004
Mia Audina,Netherlands,0,1,0,1,2004
Josefa Idem-Guerrini,West Germany,0,1,0,1,2004
Katsiaryna Khadatovich-Karsten,Unified Team,0,1,0,1,2004
Jüri Jaanson,Soviet Union,0,1,0,1,2004
Jasna Šekarić,Serbia,0,1,0,1,2004
Vera Ilyina,Unified Team,0,1,0,1,2004
Yevgeniya Artamonova-Estes,Unified Team,0,1,0,1,2004
Yelena Batukhtina-Tyurina,Unified Team,0,1,0,1,2004
Viktor Jelenić,Serbia and Montenegro,0,1,0,1,2004
Aleksandar Šapić,Serbia and Montenegro,0,1,0,1,2004
Dejan Savić,Serbia and Montenegro,0,1,0,1,2004
Petar Trbojević,Serbia and Montenegro,0,1,0,1,2004
Vlada Vujasinović,Serbia and Montenegro,0,1,0,1,2004
Sergey Filimonov,Russian Federation,0,1,0,1,2004
Francis Obikwelu,Portugal,0,1,0,1,2004
Bernard Lagat,United States,0,1,0,1,2004
Mahamed Aryphadzhyeu,Belarus,0,1,0,1,2004
Jake Wetzel,United States,0,1,0,1,2004
Aleksandar Ćirić,Serbia and Montenegro,0,1,0,1,2004
Danilo Ikodinović,Serbia and Montenegro,0,1,0,1,2004
Gyuzel Manyurova,Russian Federation,0,1,0,1,2004
Vladimir Gojković,Serbia and Montenegro,0,1,0,1,2004
Predrag Jokić,Serbia and Montenegro,0,1,0,1,2004
Slobodan Nikić,Serbia and Montenegro,0,1,0,1,2004
Denis Šefik,Serbia,0,1,0,1,2004
Vanja Udovičić,Serbia and Montenegro,0,1,0,1,2004
Natasa Dusev-Janics,Serbia and Montenegro,1,1,0,2,2008
İnna Osipenko-Radomska,Ukraine,1,0,0,1,2008
Marilyn Agliotti,South Africa,1,0,0,1,2008
Jake Wetzel,United States,1,0,0,1,2008
István Gergely,Slovakia,1,0,0,1,2008
Matthias Steiner,Germany,1,0,0,1,2008
Svetlana Romashina,Russian Olympic Committee,1,0,0,1,2008
Josefa Idem-Guerrini,West Germany,0,1,0,1,2008
Aleksandr Kostoglod,Unified Team,0,1,0,1,2008
Oksana Chusovitina,Unified Team,0,1,0,1,2008
Jüri Jaanson,Soviet Union,0,1,0,1,2008
Ralf Schumann,Germany,0,1,0,1,2008
Dmitry Sautin,Unified Team,0,1,0,1,2008
Milorad Čavić,Serbia and Montenegro,0,1,0,1,2008
David Musuľbes,Slovakia,0,1,0,1,2008
Vencelas Dabaya,France,0,1,0,1,2008
Arsen Kasabijew,Poland,0,1,0,1,2008
Svetlana Romashina,Russian Olympic Committee,2,0,0,2,2012
Peter Charles,Ireland,1,0,0,1,2012
Siarhei Martynau,Soviet Union,1,0,0,1,2012
Marilyn Agliotti,South Africa,1,0,0,1,2012
Maksim Mikhaylov,Russian Olympic Committee,1,0,0,1,2012
Nataliya Vorobyova,Russian Olympic Committee,1,0,0,1,2012
Anastasiya Bliznyuk,Russian Olympic Committee,1,0,0,1,2012
Aleksandra Patskevich,Russian Olympic Committee,1,0,0,1,2012
Alla Shishkina,Russian Olympic Committee,1,0,0,1,2012
İnna Osipenko-Radomska,Ukraine,0,2,0,2,2012
Natasa Dusev-Janics,Serbia and Montenegro,0,1,1,2,2012
Denis Ablyazin,Russian Olympic Committee,0,1,1,2,2012
Pietro Figlioli,Italy,0,1,0,1,2012
Danijel Premuš,Italy,0,1,0,1,2012
Sofya Velikaya,Russian Olympic Committee,0,1,0,1,2012
Anastasiya Zuyeva-Fesikova,Russian Olympic Committee,0,1,0,1,2012
Dmitry Ushakov,Russian Olympic Committee,0,1,0,1,2012
Inna Deriglazova,Russian Olympic Committee,0,1,0,1,2012
Yevgeny Kuznetsov,Russian Olympic Committee,0,1,0,1,2012
Sally Kipyego,United States,0,1,0,1,2012
Larisa Korobeynikova,Russian Olympic Committee,0,1,0,1,2012
Svetlana Romashina,Russian Olympic Committee,2,0,0,2,2016
Sofya Velikaya,Russian Olympic Committee,1,1,0,2,2016
Fehaid Al-Deehani,Kuwait,1,0,0,1,2016
Davor Štefanek,Serbia and Montenegro,1,0,0,1,2016
Slobodan Nikić,Serbia and Montenegro,1,0,0,1,2016
Yelena Vesnina,Russian Olympic Committee,1,0,0,1,2016
Inna Deriglazova,Russian Olympic Committee,1,0,0,1,2016
Anastasiya Bliznyuk,Russian Olympic Committee,1,0,0,1,2016
Aleksandra Patskevich,Russian Olympic Committee,1,0,0,1,2016
Alla Shishkina,Russian Olympic Committee,1,0,0,1,2016
Anna Sedoykina,Russian Olympic Committee,1,0,0,1,2016
Majlinda Kelmendi,Kosovo,1,0,0,1,2016
Anna Sen,Russian Olympic Committee,1,0,0,1,2016
Anna Vyakhireva,Russian Olympic Committee,1,0,0,1,2016
Darya Dmitriyeva,Russian Olympic Committee,1,0,0,1,2016
Yekaterina Ilyina,Russian Olympic Committee,1,0,0,1,2016
Polina Kuznetsova,Russian Olympic Committee,1,0,0,1,2016
Viktoriya Kalinina,Russian Olympic Committee,1,0,0,1,2016
Vladlena Bobrovnikova,Russian Olympic Committee,1,0,0,1,2016
Anastasiya Maksimova,Russian Olympic Committee,1,0,0,1,2016
Anastasiya Tatareva,Russian Olympic Committee,1,0,0,1,2016
Mariya Shurochkina,Russian Olympic Committee,1,0,0,1,2016
Svetlana Kolesnichenko,Russian Olympic Committee,1,0,0,1,2016
Vlada Chigiryova,Russian Olympic Committee,1,0,0,1,2016
Nidzhat Rakhimov,Kazakhstan,1,0,0,1,2016
Abdulrashid Sadulayev,Russian Olympic Committee,1,0,0,1,2016
Denis Ablyazin,Russian Olympic Committee,0,2,1,3,2016
Yuliya Yefimova,Russian Olympic Committee,0,2,0,2,2016
David Belyavsky,Russian Olympic Committee,0,1,1,2,2016
Gyuzel Manyurova,Russian Federation,0,1,0,1,2016
Xavier García,Spain,0,1,0,1,2016
Nataliya Vorobyova,Russian Olympic Committee,0,1,0,1,2016
Kseniya Perova,Russian Olympic Committee,0,1,0,1,2016
Olga Zabelinskaya,Uzbekistan,0,1,0,1,2016
Nikolay Kuksenkov,Ukraine,0,1,0,1,2016
Orlando Ortega,Spain,0,1,0,1,2016
Daniýar Ismaýilow,Turkmenistan,0,1,0,1,2016
Valeriya Zholobova-Koblova,Russian Olympic Committee,0,1,0,1,2016
Anastasiya Voynova,Russian Olympic Committee,0,1,0,1,2016
Darya Shmelyova,Russian Olympic Committee,0,1,0,1,2016
Angelina Melnikova,Russian Olympic Committee,0,1,0,1,2016
Vitalina Batsarashkina,Russian Olympic Committee,0,1,0,1,2016
Nikita Nagorny,Russian Olympic Committee,0,1,0,1,2016
Sergey Kamensky,Russian Olympic Committee,0,1,0,1,2016
František Janda-Suk,Czechoslovakia,0,1,0,1,1900
Dan Carroll,United States,1,0,0,1,1908
Jaroslav Tuček,Czechoslovakia,0,0,1,1,1908
Mór Kóczán,Slovakia,0,0,1,1,1912
Dan Carroll,United States,1,0,0,1,1920
Ladislav Žemla,Czechoslovakia,0,0,1,1,1920
Stepas Butautas,Soviet Union,0,1,0,1,1952
Nikita Simonyan,Soviet Union,1,0,0,1,1956
Olga Fikotová-Connolly,United States,1,0,0,1,1956
Therese Zenz,West Germany,0,1,0,1,1956
Todor Veselinović,Yugoslavia,0,1,0,1,1956
Therese Zenz,West Germany,0,2,0,2,1960
Anatoly Kolesov,Soviet Union,1,0,0,1,1964
Đorđe Perišić,Yugoslavia,1,0,0,1,1968
Yury Selikhov,Unified Team,0,0,1,1,1968
Dragan Kićanović,Yugoslavia,0,1,0,1,1976
Terry Walsh,Netherlands,0,1,0,1,1976
Yelena Davydova,Soviet Union,2,1,0,3,1980
Anatoly Starostin,Unified Team,2,0,0,2,1980
Dragan Kićanović,Yugoslavia,1,0,0,1,1980
Yelena Khloptseva,Unified Team,1,0,0,1,1980
Yevgeny Sharonov,Unified Team,1,0,0,1,1980
Leonid Taranenko,Unified Team,1,0,0,1,1980
Jasna Kolar-Merdan,Yugoslavia,0,1,0,1,1980
Vesna Radović,Yugoslavia,0,1,0,1,1980
Antonina Makhina-Dumcheva-Zelikovich,Unified Team,0,1,0,1,1980
Gennady Kryuchkin,Unified Team,0,1,0,1,1980
Yury Pimenov,Unified Team,0,1,0,1,1980
Nikolay Pimenov,Unified Team,0,1,0,1,1980
Ratko Rudić,Serbia,0,1,0,1,1980
Yurik Sarkisyan,Soviet Union,0,1,0,1,1980
Aleksandr Belostenny,Unified Team,0,0,1,1,1980
Sos Hayrapetyan,Unified Team,0,0,1,1,1980
Viktor Deputatov,Unified Team,0,0,1,1,1980
Leonid Pavlovsky,Unified Team,0,0,1,1,1980
Sergey Pleshakov,Unified Team,0,0,1,1,1980
Vladimir Pleshakov,Unified Team,0,0,1,1,1980
Slavica Djukić,Yugoslavia,1,0,0,1,1984
Jasna Kolar-Merdan,Yugoslavia,1,0,0,1,1984
Svetlana Mugoša-Antić,Yugoslavia,1,0,0,1,1984
Zdravko Rađenović,Yugoslavia,1,0,0,1,1984
Veselin Vujović,Slovenia,1,0,0,1,1984
Dragan Andrić,Yugoslavia,1,0,0,1,1984
Igor Milanović,Yugoslavia,1,0,0,1,1984
Sviatlana Bahinskaya,Unified Team,2,1,1,4,1988
Nicolae Juravschi,Soviet Union,2,0,0,2,1988
Olga Bryzgina,Unified Team,2,0,0,2,1988
Nino Salukvadze,Unified Team,1,1,0,2,1988
Tatsiana Ledauskaya,Unified Team,1,1,0,2,1988
Jasna Šekarić,Serbia and Montenegro,1,0,1,2,1988
Olga Nazarova,Unified Team,1,0,1,2,1988
Tatyana Samolenko-Dorovskikh,Unified Team,1,0,1,2,1988
Aleksandr Belostenny,Unified Team,1,0,0,1,1988
Igors Miglinieks,Unified Team,1,0,0,1,1988
Valery Tikhonenko,Unified Team,1,0,0,1,1988
Aleksandr Volkov,Unified Team,1,0,0,1,1988
Aleksandr Kirichenko,Unified Team,1,0,0,1,1988
Dmitry Nelyubin,Unified Team,1,0,0,1,1988
Ilgar Mamedov,Unified Team,1,0,0,1,1988
Anvar Ibragimov,Unified Team,1,0,0,1,1988
Valery Gopin,Unified Team,1,0,0,1,1988
Andrey Lavrov,Unified Team,1,0,0,1,1988
Igor Chumak,Unified Team,1,0,0,1,1988
Iryna Shylava,Unified Team,1,0,0,1,1988
Goran Maksimović,Serbia and Montenegro,1,0,0,1,1988
Marina Nikulina-Pankova,Unified Team,1,0,0,1,1988
Valentina Ogiyenko,Unified Team,1,0,0,1,1988
Svetlana Korytova,Unified Team,1,0,0,1,1988
Jelena Ovchinnikova-Čebukina,Soviet Union,1,0,0,1,1988
Tatyana Sidorenko,Unified Team,1,0,0,1,1988
Irina Smirnova-Ilchenko,Unified Team,1,0,0,1,1988
Dragan Andrić,Yugoslavia,1,0,0,1,1988
Igor Milanović,Yugoslavia,1,0,0,1,1988
Aleksandar Šoštar,Yugoslavia,1,0,0,1,1988
Mirko Vičević,Yugoslavia,1,0,0,1,1988
Aliaksandr Kurlovich,Unified Team,1,0,0,1,1988
Makharbek Khadartsev,Unified Team,1,0,0,1,1988
Aleksandr Karelin,Unified Team,1,0,0,1,1988
Davit Gobejishvili,Unified Team,1,0,0,1,1988
Arsen Fadzayev,Unified Team,1,0,0,1,1988
Vitaly Savin,Unified Team,1,0,0,1,1988
Olga Bondarenko,Unified Team,1,0,0,1,1988
Lyudmila Dzhigalova,Unified Team,1,0,0,1,1988
Nataliya Lisovskaya,Unified Team,1,0,0,1,1988
Sergey Bubka,Unified Team,1,0,0,1,1988
Igor Nagayev,Unified Team,0,2,0,2,1988
Gennady Prigoda,Unified Team,0,1,2,3,1988
Ilija Lupulesku,Serbia and Montenegro,0,1,0,1,1988
Vlade Divac,Yugoslavia,0,1,0,1,1988
Željko Obradović,Yugoslavia,0,1,0,1,1988
Žarko Paspalj,Yugoslavia,0,1,0,1,1988
Michał Śliwiński,Ukraine,0,1,0,1,1988
Sergey Kirsanov,Unified Team,0,1,0,1,1988
Nikolay Kovsh,Unified Team,0,1,0,1,1988
Georgy Pogosov,Unified Team,0,1,0,1,1988
Inna Frolova,Unified Team,0,1,0,1,1988
Antonina Makhina-Dumcheva-Zelikovich,Unified Team,0,1,0,1,1988
Veniamin But,Unified Team,0,1,0,1,1988
Vasily Tikhonov,Unified Team,0,1,0,1,1988
Yelena Dendeberova,Unified Team,0,1,0,1,1988
Iurie Başcatov,Unified Team,0,1,0,1,1988
Yevgeny Krasilnikov,Unified Team,0,1,0,1,1988
Andrey Kuznetsov,Unified Team,0,1,0,1,1988
Igor Runov,Unified Team,0,1,0,1,1988
Yury Cherednik,Unified Team,0,1,0,1,1988
Israel Militosyan,Unified Team,0,1,0,1,1988
Daulet Turlykhanov,Unified Team,0,1,0,1,1988
Leri Khabelovi,Soviet Union,0,1,0,1,1988
Andrey Shuvalov,Unified Team,0,0,2,2,1988
Dmitry Volkov,Unified Team,0,0,2,2,1988
Vladimir Yesheyev,Unified Team,0,0,1,1,1988
Jasna Fazlić-Reed,Yugoslavia,0,0,1,1,1988
Gordana Perkučin,Yugoslavia,0,0,1,1,1988
Irina Gerlits,Unified Team,0,0,1,1,1988
Yelena Khudashova,Unified Team,0,0,1,1,1988
Irina Minkh,Unified Team,0,0,1,1,1988
Irina Sumnikova,Unified Team,0,0,1,1,1988
Nataliya Zasulskaya,Unified Team,0,0,1,1,1988
Wladimir Reznitschenko,Soviet Union,0,0,1,1,1988
Pavel Kolobkov,Unified Team,0,0,1,1,1988
Igor Tikhomirov,Soviet Union,0,0,1,1,1988
Aleksandra Timoshenko,Unified Team,0,0,1,1,1988
Natalia Rusnatschenko,Ukraine,0,0,1,1,1988
Iztok Puc,Yugoslavia,0,0,1,1,1988
Nataliya Anisimova,Unified Team,0,0,1,1,1988
Tatjana Dschandschgawa,Soviet Union,0,0,1,1,1988
Tatyana Gorb,Unified Team,0,0,1,1,1988
Elina Guseva,Unified Team,0,0,1,1,1988
Nataliya Morskova,Unified Team,0,0,1,1,1988
Veselin Vujović,Slovenia,0,0,1,1,1988
Vaho Iagorashvili,United States,0,0,1,1,1988
Marina Dobrancheva-Logvinenko,Unified Team,0,0,1,1,1988
Anna Malukhina,Unified Team,0,0,1,1,1988
Valentina Cherkasova,Unified Team,0,0,1,1,1988
Kirill Ivanov,Unified Team,0,0,1,1,1988
Dmitry Apanasenko,Unified Team,0,0,1,1,1988
Aleksandr Kolotov,Unified Team,0,0,1,1,1988
Serghei Marcoci,Unified Team,0,0,1,1,1988
Sergey Naumov,Unified Team,0,0,1,1,1988
Yevgeny Sharonov,Unified Team,0,0,1,1,1988
Volodymyr Tohuzov,Unified Team,0,0,1,1,1988
Larisa Moskalenko,Unified Team,0,0,1,1,1988
Galina Malchugina,Unified Team,0,0,1,1,1988
Galina Čisťakovová,Ukraine,0,0,1,1,1988
Yelena Zhupiyeva-Vyazova,Unified Team,0,0,1,1,1988
Aleksandr Kovalenko,Unified Team,0,0,1,1,1988
Marina Dobrancheva-Logvinenko,Unified Team,2,0,0,2,1992
Olga Bryzgina,Unified Team,1,1,0,2,1992
Valeri Belenki,Unified Team,1,0,1,2,1992
Irina Gerlits,Unified Team,1,0,0,1,1992
Yelena Khudashova,Unified Team,1,0,0,1,1992
Irina Minkh,Unified Team,1,0,0,1,1992
Irina Sumnikova,Unified Team,1,0,0,1,1992
Nataliya Zasulskaya,Unified Team,1,0,0,1,1992
Wladimir Reznitschenko,Soviet Union,1,0,0,1,1992
Georgy Pogosov,Unified Team,1,0,0,1,1992
Sviatlana Bahinskaya,Unified Team,1,0,0,1,1992
Roza Galiyeva,Uzbekistan,1,0,0,1,1992
Aleksandra Timoshenko,Unified Team,1,0,0,1,1992
Oksana Chusovitina,Uzbekistan,1,0,0,1,1992
Talant Duyshebayev,Spain,1,0,0,1,1992
Valery Gopin,Unified Team,1,0,0,1,1992
Andrey Lavrov,Unified Team,1,0,0,1,1992
Igor Chumak,Unified Team,1,0,0,1,1992
Hrachya Petikyan,Unified Team,1,0,0,1,1992
Israel Militosyan,Unified Team,1,0,0,1,1992
Akakios Kakiasvili,Unified Team,1,0,0,1,1992
Aliaksandr Kurlovich,Unified Team,1,0,0,1,1992
Oleg Kutscherenko,Unified Team,1,0,0,1,1992
Mnatsakan Iskandaryan,Unified Team,1,0,0,1,1992
Leri Khabelovi,Soviet Union,1,0,0,1,1992
Makharbek Khadartsev,Unified Team,1,0,0,1,1992
Aleksandr Karelin,Unified Team,1,0,0,1,1992
Arsen Fadzayev,Unified Team,1,0,0,1,1992
Yelena Romanova,Unified Team,1,0,0,1,1992
Lyudmila Dzhigalova,Unified Team,1,0,0,1,1992
Olga Nazarova,Unified Team,1,0,0,1,1992
Andrey Abduvaliyev,Uzbekistan,1,0,0,1,1992
Pavel Kolobkov,Unified Team,0,1,1,2,1992
Michał Śliwiński,Ukraine,0,1,0,1,1992
Anatoly Starostin,Unified Team,0,1,0,1,1992
Sergey Pyzhyanov,Unified Team,0,1,0,1,1992
Jasna Šekarić,Serbia and Montenegro,0,1,0,1,1992
Irina Lashko,Soviet Union,0,1,0,1,1992
Yelena Miroshina,Unified Team,0,1,0,1,1992
Iurie Başcatov,Unified Team,0,1,0,1,1992
Gennady Prigoda,Unified Team,0,1,0,1,1992
Dmitry Volkov,Unified Team,0,1,0,1,1992
Marina Nikulina-Pankova,Unified Team,0,1,0,1,1992
Valentina Ogiyenko,Unified Team,0,1,0,1,1992
Svetlana Korytova,Unified Team,0,1,0,1,1992
Jelena Ovchinnikova-Čebukina,Soviet Union,0,1,0,1,1992
Irina Smirnova-Ilchenko,Unified Team,0,1,0,1,1992
Leonid Taranenko,Unified Team,0,1,0,1,1992
Alfred Ter-Mkrtchyan,Unified Team,0,1,0,1,1992
İslam Duquçiyev,Unified Team,0,1,0,1,1992
Elmadi Zhabrailov,Unified Team,0,1,0,1,1992
Galina Malchugina,Unified Team,0,1,0,1,1992
Inesa Kravets,Unified Team,0,1,0,1,1992
Tatyana Samolenko-Dorovskikh,Unified Team,0,1,0,1,1992
Aleksandra Ivošev,Serbia and Montenegro,1,0,1,2,1996
Ilgar Mamedov,Unified Team,1,0,0,1,1996
Iztok Puc,Yugoslavia,1,0,0,1,1996
Boris Kokorev,Unified Team,1,0,0,1,1996
Akakios Kakiasvili,Unified Team,1,0,0,1,1996
Aleksandr Karelin,Unified Team,1,0,0,1,1996
Ludmila Narozhilenko-Engquist,Sweden,1,0,0,1,1996
Inesa Kravets,Unified Team,1,0,0,1,1996
Marina Dobrancheva-Logvinenko,Unified Team,0,1,1,2,1996
Vlade Divac,Yugoslavia,0,1,0,1,1996
Žarko Paspalj,Yugoslavia,0,1,0,1,1996
Nicolae Juravschi,Soviet Union,0,1,0,1,1996
Pavel Kolobkov,Unified Team,0,1,0,1,1996
Valery Zakharevich,Uzbekistan,0,1,0,1,1996
Roza Galiyeva,Uzbekistan,0,1,0,1,1996
Inna Frolova,Unified Team,0,1,0,1,1996
Irina Lashko,Soviet Union,0,1,0,1,1996
Makharbek Khadartsev,Unified Team,0,1,0,1,1996
Georgy Shayduko,Unified Team,0,1,0,1,1996
Mikhail Shchennikov,Unified Team,0,1,0,1,1996
Pavel Kolobkov,Unified Team,1,0,0,1,2000
Andrey Lavrov,Unified Team,1,0,0,1,2000
Akakios Kakiasvili,Unified Team,1,0,0,1,2000
Martina Moravcová,Slovakia,0,2,0,2,2000
Jasna Šekarić,Serbia and Montenegro,0,1,0,1,2000
Aleksandr Karelin,Unified Team,0,1,0,1,2000
Jasna Šekarić,Serbia and Montenegro,0,1,0,1,2004
Denis Šefik,Serbia and Montenegro,0,1,0,1,2004
Oksana Chusovitina,Uzbekistan,0,1,0,1,2008
Ratko Rudić,Yugoslavia,0,1,0,1,1980
Veselin Vujović,Yugoslavia,1,0,0,1,1984
Jasna Šekarić,Yugoslavia,1,0,1,2,1988
Goran Maksimović,Yugoslavia,1,0,0,1,1988
Jelena Ovchinnikova-Čebukina,Unified Team,1,0,0,1,1988
Makharbek Khadartsev,Uzbekistan,1,0,0,1,1988
Arsen Fadzayev,Uzbekistan,1,0,0,1,1988
Ilija Lupulesku,United States,0,1,0,1,1988
Michał Śliwiński,Unified Team,0,1,0,1,1988
Leri Khabelovi,Unified Team,0,1,0,1,1988
Tatjana Dschandschgawa,Unified Team,0,0,1,1,1988
Veselin Vujović,Yugoslavia,0,0,1,1,1988
Talant Duyshebayev,Unified Team,1,0,0,1,1992
Leri Khabelovi,Unified Team,1,0,0,1,1992
Makharbek Khadartsev,Uzbekistan,1,0,0,1,1992
Arsen Fadzayev,Uzbekistan,1,0,0,1,1992
Michał Śliwiński,Unified Team,0,1,0,1,1992
Jasna Šekarić,Yugoslavia,0,1,0,1,1992
Irina Lashko,Unified Team,0,1,0,1,1992
Jelena Ovchinnikova-Čebukina,Unified Team,0,1,0,1,1992
Ludmila Narozhilenko-Engquist,Unified Team,1,0,0,1,1996
Irina Lashko,Unified Team,0,1,0,1,1996
Makharbek Khadartsev,Uzbekistan,0,1,0,1,1996
Jasna Šekarić,Yugoslavia,0,1,0,1,2000
Jasna Šekarić,Yugoslavia,0,1,0,1,2004
Ilija Lupulesku,Yugoslavia,0,1,0,1,1988
